,loss,mae,mean_q,mean_eps,episode_reward,nb_episode_steps,nb_steps,episode,duration
0,0,0,0,0,165.0,604,604,0,1.4754929000000008
1, 0, 0, 0, 0, 30.0, 523, 1127, 1, 1.2794730000000012
2, 0, 0, 0, 0, 100.0, 714, 1841, 2, 2.026670700000002
3, 0, 0, 0, 0, 85.0, 641, 2482, 3, 1.8918286000000002
4, 0, 0, 0, 0, 225.0, 1429, 3911, 4, 3.818798400000002
5, 0, 0, 0, 0, 90.0, 445, 4356, 5, 1.170382
6, 0, 0, 0, 0, 75.0, 566, 4922, 6, 1.5819338000000016
7, 0, 0, 0, 0, 105.0, 670, 5592, 7, 2.2381555000000013
8, 0, 0, 0, 0, 30.0, 424, 6016, 8, 1.2493224000000005
9, 0, 0, 0, 0, 240.0, 808, 6824, 9, 2.2499353999999983
10, 0, 0, 0, 0, 135.0, 755, 7579, 10, 1.7664952000000014
11, 0, 0, 0, 0, 535.0, 1015, 8594, 11, 2.406739700000003
12, 0, 0, 0, 0, 490.0, 982, 9576, 12, 2.3283203999999955
13, 0, 0, 0, 0, 15.0, 460, 10036, 13, 1.1168745999999956
14, 0, 0, 0, 0, 315.0, 994, 11030, 14, 2.260126299999996
15, 0, 0, 0, 0, 425.0, 837, 11867, 15, 1.9378032999999988
16, 0, 0, 0, 0, 110.0, 734, 12601, 16, 1.8567296000000013
17, 0, 0, 0, 0, 65.0, 595, 13196, 17, 1.434660799999996
18, 0, 0, 0, 0, 110.0, 622, 13818, 18, 1.5012357999999963
19, 0, 0, 0, 0, 195.0, 856, 14674, 19, 2.0107327999999995
20, 0, 0, 0, 0, 150.0, 610, 15284, 20, 1.5414719000000048
21, 0, 0, 0, 0, 215.0, 896, 16180, 21, 2.4618876999999983
22, 0, 0, 0, 0, 210.0, 772, 16952, 22, 1.8617847999999952
23, 0, 0, 0, 0, 65.0, 493, 17445, 23, 1.294161299999999
24, 0, 0, 0, 0, 120.0, 739, 18184, 24, 1.8602996999999988
25, 0, 0, 0, 0, 345.0, 1205, 19389, 25, 3.022259400000003
26, 0, 0, 0, 0, 185.0, 491, 19880, 26, 1.2884235000000004
27, 0, 0, 0, 0, 105.0, 658, 20538, 27, 1.6566431000000037
28, 0, 0, 0, 0, 145.0, 768, 21306, 28, 1.9412258000000122
29, 0, 0, 0, 0, 100.0, 383, 21689, 29, 0.9671508999999929
30, 0, 0, 0, 0, 150.0, 460, 22149, 30, 1.1820756999999986
31, 0, 0, 0, 0, 145.0, 687, 22836, 31, 1.7505709999999937
32, 0, 0, 0, 0, 410.0, 1032, 23868, 32, 2.6825527999999963
33, 0, 0, 0, 0, 135.0, 784, 24652, 33, 1.992102200000005
34, 0, 0, 0, 0, 50.0, 673, 25325, 34, 1.7868461000000053
35, 0, 0, 0, 0, 140.0, 795, 26120, 35, 2.0428296999999986
36, 0, 0, 0, 0, 105.0, 608, 26728, 36, 1.5284573999999935
37, 0, 0, 0, 0, 30.0, 575, 27303, 37, 1.4681896999999964
38, 0, 0, 0, 0, 245.0, 798, 28101, 38, 2.0801672999999994
39, 0, 0, 0, 0, 110.0, 1069, 29170, 39, 2.7058363999999955
40, 0, 0, 0, 0, 80.0, 380, 29550, 40, 1.0434846999999934
41, 0, 0, 0, 0, 25.0, 453, 30003, 41, 1.127180199999998
42, 0, 0, 0, 0, 170.0, 1231, 31234, 42, 3.0705067999999898
43, 0, 0, 0, 0, 75.0, 446, 31680, 43, 1.1475752000000057
44, 0, 0, 0, 0, 185.0, 835, 32515, 44, 2.0832214999999934
45, 0, 0, 0, 0, 45.0, 636, 33151, 45, 1.6359216000000032
46, 0, 0, 0, 0, 215.0, 936, 34087, 46, 2.36237779999999
47, 0, 0, 0, 0, 100.0, 649, 34736, 47, 1.6412578999999994
48, 0, 0, 0, 0, 80.0, 502, 35238, 48, 1.191564100000008
49, 0, 0, 0, 0, 80.0, 460, 35698, 49, 1.154571500000003
50, 0, 0, 0, 0, 155.0, 689, 36387, 50, 1.6467542999999978
51, 0, 0, 0, 0, 30.0, 394, 36781, 51, 0.9484993000000088
52, 0, 0, 0, 0, 60.0, 627, 37408, 52, 1.464967999999999
53, 0, 0, 0, 0, 105.0, 677, 38085, 53, 1.5423411000000016
54, 0, 0, 0, 0, 135.0, 958, 39043, 54, 2.2165111000000053
55, 0, 0, 0, 0, 60.0, 429, 39472, 55, 1.1055013999999943
56, 0, 0, 0, 0, 35.0, 569, 40041, 56, 1.4794819999999902
57, 0, 0, 0, 0, 45.0, 405, 40446, 57, 0.9561487
58, 0, 0, 0, 0, 105.0, 532, 40978, 58, 1.2899375000000077
59, 0, 0, 0, 0, 80.0, 470, 41448, 59, 1.2915224999999992
60, 0, 0, 0, 0, 290.0, 1130, 42578, 60, 2.6488899999999944
61, 0, 0, 0, 0, 55.0, 402, 42980, 61, 0.991654699999998
62, 0, 0, 0, 0, 210.0, 766, 43746, 62, 1.8744161999999989
63, 0, 0, 0, 0, 80.0, 387, 44133, 63, 0.8981089000000111
64, 0, 0, 0, 0, 110.0, 551, 44684, 64, 1.3842009999999902
65, 0, 0, 0, 0, 445.0, 1543, 46227, 65, 3.471830099999991
66, 0, 0, 0, 0, 180.0, 674, 46901, 66, 1.5407795000000135
67, 0, 0, 0, 0, 75.0, 935, 47836, 67, 2.150858400000004
68, 0, 0, 0, 0, 80.0, 391, 48227, 68, 0.9178511000000071
69, 0, 0, 0, 0, 245.0, 838, 49065, 69, 1.8329601000000082
70, 0, 0, 0, 0, 160.0, 656, 49721, 70, 1.549149199999988
71, 0, 0, 0, 0, 195.0, 683, 50404, 71, 1.6530539999999974
72, 0, 0, 0, 0, 110.0, 550, 50954, 72, 1.2822604000000126
73, 0, 0, 0, 0, 140.0, 680, 51634, 73, 1.7017503000000147
74, 0, 0, 0, 0, 80.0, 478, 52112, 74, 1.1493459000000144
75, 0, 0, 0, 0, 355.0, 1052, 53164, 75, 2.665258300000005
76, 0, 0, 0, 0, 170.0, 679, 53843, 76, 1.583084499999984
77, 0, 0, 0, 0, 110.0, 563, 54406, 77, 1.3145476999999914
78, 0, 0, 0, 0, 110.0, 598, 55004, 78, 1.4683892999999841
79, 0, 0, 0, 0, 210.0, 818, 55822, 79, 1.896288999999996
80, 0, 0, 0, 0, 35.0, 472, 56294, 80, 1.1052039999999863
81, 0, 0, 0, 0, 35.0, 488, 56782, 81, 1.2980691999999863
82, 0, 0, 0, 0, 45.0, 524, 57306, 82, 1.2496935000000065
83, 0, 0, 0, 0, 240.0, 782, 58088, 83, 1.8012158000000227
84, 0, 0, 0, 0, 45.0, 586, 58674, 84, 1.4055330999999853
85, 0, 0, 0, 0, 135.0, 611, 59285, 85, 1.4188383999999985
86, 0, 0, 0, 0, 475.0, 1310, 60595, 86, 2.870733400000006
87, 0, 0, 0, 0, 95.0, 672, 61267, 87, 1.5371038000000112
88, 0, 0, 0, 0, 60.0, 608, 61875, 88, 1.376978400000013
89, 0, 0, 0, 0, 45.0, 542, 62417, 89, 1.2661271999999997
90, 0, 0, 0, 0, 110.0, 623, 63040, 90, 1.4422409999999957
91, 0, 0, 0, 0, 210.0, 678, 63718, 91, 1.5433212000000083
92, 0, 0, 0, 0, 135.0, 654, 64372, 92, 1.5127267000000018
93, 0, 0, 0, 0, 65.0, 567, 64939, 93, 1.310717000000011
94, 0, 0, 0, 0, 195.0, 883, 65822, 94, 2.007289500000013
95, 0, 0, 0, 0, 50.0, 630, 66452, 95, 1.4747753999999986
96, 0, 0, 0, 0, 155.0, 559, 67011, 96, 1.3059284999999932
97, 0, 0, 0, 0, 230.0, 1077, 68088, 97, 2.466555900000003
98, 0, 0, 0, 0, 125.0, 483, 68571, 98, 1.1242750000000115
99, 0, 0, 0, 0, 120.0, 598, 69169, 99, 1.375509199999982
100, 0, 0, 0, 0, 170.0, 622, 69791, 100, 1.498300200000017
101, 0, 0, 0, 0, 60.0, 386, 70177, 101, 0.9096923999999831
102, 0, 0, 0, 0, 155.0, 616, 70793, 102, 1.4403218999999865
103, 0, 0, 0, 0, 215.0, 930, 71723, 103, 2.154933800000009
104, 0, 0, 0, 0, 350.0, 997, 72720, 104, 2.2347779000000116
105, 0, 0, 0, 0, 190.0, 554, 73274, 105, 1.2887667999999906
106, 0, 0, 0, 0, 155.0, 487, 73761, 106, 1.1099763999999936
107, 0, 0, 0, 0, 65.0, 524, 74285, 107, 1.19764219999999
108, 0, 0, 0, 0, 110.0, 632, 74917, 108, 1.4610116000000062
109, 0, 0, 0, 0, 125.0, 520, 75437, 109, 1.1979326999999955
110, 0, 0, 0, 0, 105.0, 647, 76084, 110, 1.5023400999999978
111, 0, 0, 0, 0, 150.0, 652, 76736, 111, 1.52868509999999
112, 0, 0, 0, 0, 210.0, 515, 77251, 112, 1.2075379000000055
113, 0, 0, 0, 0, 25.0, 558, 77809, 113, 1.2895770000000084
114, 0, 0, 0, 0, 45.0, 406, 78215, 114, 0.9432579000000203
115, 0, 0, 0, 0, 290.0, 1136, 79351, 115, 2.538847000000004
116, 0, 0, 0, 0, 35.0, 567, 79918, 116, 1.3108203000000174
117, 0, 0, 0, 0, 445.0, 857, 80775, 117, 2.0470114000000024
118, 0, 0, 0, 0, 65.0, 685, 81460, 118, 1.6633606999999984
119, 0, 0, 0, 0, 335.0, 1208, 82668, 119, 3.163190500000013
120, 0, 0, 0, 0, 15.0, 374, 83042, 120, 0.8924073999999962
121, 0, 0, 0, 0, 75.0, 489, 83531, 121, 1.1258214000000066
122, 0, 0, 0, 0, 90.0, 480, 84011, 122, 1.2015923000000157
123, 0, 0, 0, 0, 185.0, 679, 84690, 123, 1.6331538999999964
124, 0, 0, 0, 0, 300.0, 1393, 86083, 124, 3.336753399999992
125, 0, 0, 0, 0, 30.0, 539, 86622, 125, 1.4902251000000035
126, 0, 0, 0, 0, 80.0, 639, 87261, 126, 1.7354806999999823
127, 0, 0, 0, 0, 545.0, 1708, 88969, 127, 3.934978699999988
128, 0, 0, 0, 0, 20.0, 567, 89536, 128, 1.3715898000000095
129, 0, 0, 0, 0, 65.0, 501, 90037, 129, 1.2222974000000022
130, 0, 0, 0, 0, 55.0, 384, 90421, 130, 0.9102417999999943
131, 0, 0, 0, 0, 140.0, 725, 91146, 131, 1.7571570000000065
132, 0, 0, 0, 0, 530.0, 1130, 92276, 132, 2.659520200000003
133, 0, 0, 0, 0, 160.0, 658, 92934, 133, 1.6890089000000046
134, 0, 0, 0, 0, 30.0, 428, 93362, 134, 1.0530654000000084
135, 0, 0, 0, 0, 150.0, 676, 94038, 135, 1.560207900000023
136, 0, 0, 0, 0, 115.0, 620, 94658, 136, 1.4632489999999905
137, 0, 0, 0, 0, 265.0, 1258, 95916, 137, 2.881270999999998
138, 0, 0, 0, 0, 105.0, 373, 96289, 138, 0.9445733999999959
139, 0, 0, 0, 0, 120.0, 621, 96910, 139, 1.4232639000000233
140, 0, 0, 0, 0, 80.0, 497, 97407, 140, 1.1474527999999964
141, 0, 0, 0, 0, 80.0, 386, 97793, 141, 0.9039903999999979
142, 0, 0, 0, 0, 210.0, 729, 98522, 142, 1.6821896999999808
143, 0, 0, 0, 0, 75.0, 515, 99037, 143, 1.1871638000000075
144, 321.53562524816493, 16.695042452969393, 34.2418913264851, 0.9099586000000001, 300.0, 1055, 100092, 144, 3.7350583999999856
145, 24.19939911365509, 25.011512290839242, 32.15015076870022, 0.9095009499999993, 440.0, 926, 101018, 145, 10.467983100000026
146, 12.492608276697306, 25.41855023457454, 30.908266479447043, 0.9087800500000005, 110.0, 676, 101694, 146, 7.729960099999971
147, 11.816567333316506, 25.4568438544823, 31.115554912563177, 0.9080425000000002, 260.0, 963, 102657, 147, 10.965461000000005
148, 12.815535616769665, 25.365130666769197, 30.871994102578856, 0.9073027, 60.0, 681, 103338, 148, 7.767468000000008
149, 11.228023335792088, 25.437892270891854, 30.98132497502751, 0.9067158999999995, 105.0, 623, 103961, 149, 7.229535499999997
150, 10.130532178342133, 25.355414841127562, 30.6591438995576, 0.9060516999999999, 150.0, 853, 104814, 150, 9.890752299999974
151, 10.693793653720446, 25.318693463993505, 30.675161197217978, 0.9053703999999998, 110.0, 661, 105475, 151, 7.63440159999999
152, 13.863139508182842, 25.26239811603288, 30.70588850150431, 0.9047737000000001, 140.0, 665, 106140, 152, 7.665558099999998
153, 10.590341124451369, 25.145592744213683, 30.33601422678503, 0.904294, 110.0, 401, 106541, 153, 4.67289310000001
154, 9.944203932909495, 25.301141556752086, 30.45091493549265, 0.9036941499999994, 210.0, 932, 107473, 154, 10.808206299999995
155, 9.892064279137236, 25.30222667347301, 30.58966868429473, 0.9029777500000002, 155.0, 660, 108133, 155, 7.772983500000009
156, 10.660059948433611, 25.226310357115324, 30.437462532789187, 0.9023815000000003, 60.0, 665, 108798, 156, 7.708672100000001
157, 9.958443565895726, 25.102507359005628, 30.332626039705954, 0.9018217000000002, 65.0, 579, 109377, 157, 6.749704100000031
158, 10.105998147914285, 25.291968968040063, 30.612595283106753, 0.9011336499999993, 155.0, 950, 110327, 158, 11.0692813
159, 8.577549006108354, 25.228097356351693, 30.65035231071606, 0.9005266000000002, 55.0, 399, 110726, 159, 4.741576299999963
160, 9.475073743770473, 25.31968398342765, 30.661889885274157, 0.9001571499999999, 60.0, 422, 111148, 160, 4.944085200000018
161, 8.108669244561877, 25.350246170588903, 30.684344338008337, 0.8996522499999998, 75.0, 700, 111848, 161, 8.163970000000006
162, 7.279677066027962, 25.26765951101836, 30.598046848107877, 0.8989925500000001, 180.0, 766, 112614, 162, 8.981848000000014
163, 8.01980399681876, 25.29245661695798, 30.70275817314784, 0.8983886499999996, 10.0, 576, 113190, 163, 6.666703199999972
164, 6.167066116812568, 25.261722463036552, 30.557896273995414, 0.8974202499999997, 330.0, 1576, 114766, 164, 18.327371400000004
165, 5.268682871691732, 25.238800585733415, 30.479903249310482, 0.8964217000000002, 120.0, 643, 115409, 165, 7.576056199999982
166, 5.481560482862203, 25.257466436469038, 30.523628013030343, 0.8957183499999997, 240.0, 920, 116329, 166, 10.83260789999997
167, 6.471789703774358, 25.17953069219476, 30.4826734301601, 0.8948489499999998, 270.0, 1012, 117341, 167, 11.958530999999994
168, 8.637357544266017, 25.26561311029755, 30.57320899625795, 0.8941392999999995, 45.0, 565, 117906, 168, 6.664205299999992
169, 6.597237517925605, 25.263621152595995, 30.61577022152233, 0.89346475, 210.0, 934, 118840, 169, 10.988232900000014
170, 5.436220489645916, 25.22931609127691, 30.456684180296183, 0.8927150499999994, 155.0, 732, 119572, 170, 8.711477300000013
171, 8.716447876261713, 25.353536091493755, 30.52339354525791, 0.8920251999999997, 180.0, 801, 120373, 171, 9.542880999999966
172, 10.226626597489828, 25.461581572793648, 30.727583839426398, 0.8913177999999999, 120.0, 771, 121144, 172, 9.109942199999978
173, 9.805183868881658, 25.420609246472658, 30.599338937313, 0.8907805000000001, 75.0, 423, 121567, 173, 5.079468399999996
174, 8.406362989993944, 25.389507526240937, 30.569572652529363, 0.8902616499999999, 180.0, 730, 122297, 174, 8.73651430000001
175, 10.793704131530458, 25.46487722519291, 30.642713443358854, 0.8896176999999998, 150.0, 701, 122998, 175, 8.353229499999998
176, 7.869736559820111, 25.39538409551845, 30.45259277746384, 0.8889697000000004, 155.0, 739, 123737, 176, 8.814807100000053
177, 10.061751572061176, 25.438788333215005, 30.630450664472974, 0.8882015500000003, 265.0, 968, 124705, 177, 11.571526699999936
178, 8.200718668179634, 25.45820751679249, 30.535460897592397, 0.88759045, 125.0, 390, 125095, 178, 4.778245600000105
179, 10.018606662750244, 25.3646349951073, 30.50583310038955, 0.8870261499999992, 235.0, 864, 125959, 179, 10.358591500000102
180, 7.985582776461976, 25.399946834467634, 30.449040823344944, 0.8863529500000006, 105.0, 632, 126591, 180, 7.628584500000102
181, 8.94768337570495, 25.447303138260732, 30.57240497328171, 0.8857922499999997, 125.0, 614, 127205, 181, 7.567097999999987
182, 9.68963785784585, 25.368973633902414, 30.492235854012627, 0.8853584500000001, 85.0, 350, 127555, 182, 4.271416699999918
183, 9.805652150555863, 25.39983425166052, 30.617432297800303, 0.8848666000000002, 155.0, 743, 128298, 183, 8.974131499999999
184, 9.640917365230731, 25.335961801410992, 30.525508520699766, 0.8841101499999992, 240.0, 938, 129236, 184, 11.405102700000043
185, 10.442193189469895, 25.456402497716468, 30.622330951218558, 0.8833244500000005, 155.0, 808, 130044, 185, 9.859671899999967
186, 7.887560661722606, 25.75039779762538, 31.117368321622994, 0.8827192000000001, 35.0, 537, 130581, 186, 6.542541000000028
187, 6.219210414555251, 25.76176168409275, 30.991136673393598, 0.8821342000000001, 155.0, 763, 131344, 187, 9.30983189999995
188, 6.355922062952356, 25.92739277958391, 31.15874922036167, 0.8815667499999996, 30.0, 498, 131842, 188, 6.153576499999986
189, 8.62434964137848, 25.826047049628365, 31.185481553125864, 0.8811644500000001, 60.0, 396, 132238, 189, 5.010789999999929
190, 4.8190779345110055, 25.80271498262882, 30.993859899044036, 0.8806982500000002, 120.0, 640, 132878, 190, 7.911762899999985
191, 5.731007345994468, 25.77190663946102, 31.07557683207982, 0.8799454000000003, 155.0, 1033, 133911, 191, 12.595262599999955
192, 6.00002808853523, 25.794977719021826, 31.076706556929757, 0.8793059500000002, 65.0, 388, 134299, 192, 4.748947199999975
193, 6.831957471411475, 25.857773725363927, 31.20992722288369, 0.8787366999999995, 170.0, 877, 135176, 193, 10.829772400000024
194, 7.354389713275341, 25.787443463930295, 31.14335119032259, 0.8779311999999999, 440.0, 913, 136089, 194, 11.157849499999998
195, 8.253636816105285, 25.838586371285576, 31.249675547612178, 0.8773470999999996, 35.0, 385, 136474, 195, 4.775630500000034
196, 4.907873185257934, 25.84617156343736, 31.072849807855384, 0.8768782000000005, 180.0, 657, 137131, 196, 8.199868199999969
197, 5.731581959015426, 25.739066760672078, 31.006207124137322, 0.8762738499999998, 180.0, 686, 137817, 197, 8.498230799999988
198, 5.1582938549162325, 25.76693854204083, 30.975267136233978, 0.8757302499999997, 5.0, 522, 138339, 198, 6.470786699999962
199, 5.121365261967503, 25.777474098774924, 31.066609115031227, 0.8751938499999997, 100.0, 670, 139009, 199, 8.291359499999999
200, 7.059775044765378, 25.83353766079607, 31.070606992749745, 0.8747096499999998, 75.0, 406, 139415, 200, 5.121652300000051
201, 7.466238001870752, 25.817803947220135, 31.140272694134087, 0.8742866500000003, 110.0, 534, 139949, 201, 6.659689099999923
202, 5.415388730618666, 25.09774928586795, 30.235588449371285, 0.8737813000000002, 55.0, 589, 140538, 202, 7.3057476999999835
203, 5.282340081777165, 24.978040162254782, 30.11288207100037, 0.8731796499999996, 110.0, 748, 141286, 203, 9.311480500000016
204, 7.9438798698282715, 25.01812101721932, 30.197856660958575, 0.8725239999999999, 140.0, 709, 141995, 204, 8.853598600000055
205, 6.539005276163814, 25.016812990010376, 30.164840865087793, 0.8719785999999998, 75.0, 503, 142498, 205, 6.354272100000003
206, 4.262998387626762, 24.958887229635952, 30.041177111796685, 0.8714737, 90.0, 619, 143117, 206, 7.756142300000079
207, 5.3738326403525996, 25.048103885475648, 30.163074143435978, 0.8707046499999999, 460.0, 1090, 144207, 207, 13.615618700000027
208, 5.1509426557355456, 24.98206735452016, 30.175506586498685, 0.8698901499999999, 180.0, 720, 144927, 208, 9.012518599999908
209, 7.837920184311772, 25.061559218655013, 30.283896547620213, 0.8692741000000003, 165.0, 649, 145576, 209, 8.15445139999997
210, 6.85130017398517, 24.985783050309365, 30.100018820528792, 0.8687709999999997, 25.0, 469, 146045, 210, 6.39529129999994
211, 4.023230872037767, 25.00394061954542, 30.06062781016032, 0.8681684500000003, 455.0, 870, 146915, 211, 11.214211800000044
212, 4.855993660749254, 24.98403001331479, 30.058905659747754, 0.8672832999999992, 175.0, 1097, 148012, 212, 13.789979800000083
213, 5.393377198141699, 25.00921538146711, 30.11541917543595, 0.8665795000000001, 125.0, 467, 148479, 213, 5.874714499999982
214, 4.2135345736347825, 24.983535695677578, 30.031554377886405, 0.8660304999999998, 355.0, 753, 149232, 214, 9.622239400000012
215, 5.641150622295611, 25.322363601618516, 30.524048976155072, 0.8651719, 535.0, 1155, 150387, 215, 14.519456900000023
216, 3.2931515191282545, 25.809019447269296, 31.025139806264622, 0.8644725999999997, 55.0, 399, 150786, 216, 5.0875531000000365
217, 3.572012011541882, 25.885000787130217, 31.134522711805733, 0.8640532, 75.0, 533, 151319, 217, 6.82398569999998
218, 3.8679467515180472, 25.828232516361386, 31.08323781112309, 0.8634529000000002, 185.0, 801, 152120, 218, 10.259868100000062
219, 4.542266611317624, 25.759790662347083, 31.072215112865482, 0.8627765500000004, 380.0, 702, 152822, 219, 8.967119499999967
220, 5.267503141975199, 25.8292016810007, 31.14471692234882, 0.8620389999999998, 415.0, 937, 153759, 220, 12.019912399999953
221, 3.712478128477514, 25.76306411024875, 30.93848119740571, 0.8614405, 110.0, 393, 154152, 221, 5.067893499999968
222, 4.43492433573127, 25.72169686929737, 30.94844437898282, 0.8609896000000004, 135.0, 609, 154761, 222, 7.793479599999955
223, 7.406086285320329, 25.815696582087764, 31.177822275514956, 0.86035105, 210.0, 810, 155571, 223, 10.541935499999909
224, 5.537675106247472, 25.782547267854522, 31.043364984383857, 0.8595523, 275.0, 965, 156536, 224, 13.233702400000084
225, 4.599762271557536, 25.710368641785212, 30.965039870568685, 0.8589164499999998, 60.0, 448, 156984, 225, 5.988766000000055
226, 6.317797818115854, 25.836516605381384, 31.182158603102916, 0.8583048999999997, 245.0, 911, 157895, 226, 11.871517400000016
227, 3.757991331835177, 25.86353018078892, 31.091419224121626, 0.8574814000000002, 410.0, 919, 158814, 227, 12.201487400000019
228, 4.635017318378283, 25.740911549846018, 31.00366544648418, 0.8567821000000001, 125.0, 635, 159449, 228, 7.991214500000069
229, 7.99900813125553, 25.63232239228756, 30.89801039219555, 0.8561673999999992, 155.0, 731, 160180, 229, 9.31883659999994
230, 7.155969456606136, 25.023035486539204, 30.156298332047044, 0.8554280500000001, 140.0, 912, 161092, 230, 11.765869400000042
231, 5.0586997850852855, 24.953645908131318, 30.099375102099252, 0.8548646499999997, 80.0, 340, 161432, 231, 4.402264299999956
232, 6.201572347277377, 24.94893609570978, 30.087814440515153, 0.8543980000000007, 105.0, 697, 162129, 232, 8.906874499999958
233, 4.304861239333761, 24.879609228550702, 29.959865725526242, 0.8536536999999997, 225.0, 957, 163086, 233, 12.455971699999964
234, 3.165866752025447, 25.00265541861329, 30.05054075506669, 0.8529386500000004, 110.0, 632, 163718, 234, 8.211508900000126
235, 5.278938384534335, 24.974049222152846, 30.106636579057813, 0.8523491500000002, 110.0, 678, 164396, 235, 8.744860600000038
236, 6.038931141616008, 24.976271045317343, 30.134413811044954, 0.8516516500000004, 230.0, 872, 165268, 236, 11.351760599999807
237, 4.1324339421777765, 24.899769184620084, 29.9619681820849, 0.8507349999999997, 295.0, 1165, 166433, 237, 14.971042399999988
238, 5.3175996096856, 25.013179128104394, 30.148664673971474, 0.8499655, 50.0, 545, 166978, 238, 7.058762000000115
239, 4.358986905341156, 24.945286846307834, 30.023763962262215, 0.8494282, 105.0, 649, 167627, 239, 8.507994900000085
240, 6.858097992234287, 24.92170607930138, 30.14731834275382, 0.8487581500000005, 180.0, 840, 168467, 240, 10.966428799999903
241, 3.603888370844511, 24.7945222960972, 29.831660312052257, 0.8480169999999998, 180.0, 807, 169274, 241, 10.494199700000081
242, 2.999651443479831, 24.88470858162561, 29.915803558821835, 0.8474212000000004, 110.0, 517, 169791, 242, 6.8378165999999965
243, 7.428205776124763, 24.995459735315407, 30.196990244354208, 0.8468452000000004, 210.0, 763, 170554, 243, 9.975003900000047
244, 4.521438391944941, 25.013839340209962, 30.1441786328484, 0.84611935, 225.0, 850, 171404, 244, 11.030918600000177
245, 4.600796797983628, 24.96871816592109, 30.062489668767256, 0.8454376, 95.0, 665, 172069, 245, 8.768926899999997
246, 3.974030970838471, 24.929869256368498, 29.998347543170425, 0.8447877999999995, 145.0, 779, 172848, 246, 10.289112999999816
247, 3.0426285663146455, 24.892652122284698, 29.97760834882963, 0.8441308000000006, 110.0, 681, 173529, 247, 8.904458599999998
248, 4.852510862191518, 25.00271611785889, 30.14067453511556, 0.8434868499999999, 240.0, 750, 174279, 248, 9.90422179999996
249, 4.456717314842448, 24.949322138167574, 30.04502472022545, 0.8429059000000002, 135.0, 541, 174820, 249, 7.167652000000089
250, 4.154917045010554, 24.96567960619093, 30.059424836485537, 0.8423406999999996, 155.0, 715, 175535, 250, 9.386088999999856
251, 3.5678960674313647, 24.937364989188342, 30.066268825427233, 0.8416053999999997, 295.0, 919, 176454, 251, 12.138322600000038
252, 5.166218214344268, 24.94283057006549, 30.11292091656628, 0.8409047499999999, 110.0, 638, 177092, 252, 8.58954349999999
253, 3.9646533666495922, 24.923428615993924, 30.002343224419487, 0.8403139000000005, 135.0, 675, 177767, 253, 9.06386079999993
254, 4.029896717442021, 24.939757418959108, 30.017749613278532, 0.83974735, 135.0, 584, 178351, 254, 7.869287199999917
255, 6.392708530313975, 24.975361161692646, 30.20641240998908, 0.8391398499999995, 160.0, 766, 179117, 255, 10.257403300000078
256, 4.516189695655845, 24.948448579123305, 30.05987397890358, 0.8386183000000003, 125.0, 393, 179510, 256, 5.252176500000132
257, 4.076914372495734, 25.047479674056337, 30.116068614708198, 0.83811385, 110.0, 728, 180238, 257, 9.690379500000063
258, 2.676634260956372, 25.24876190969877, 30.385588722585517, 0.8375455000000003, 125.0, 535, 180773, 258, 7.16612269999996
259, 5.5343589597153215, 25.21331192232528, 30.44169531408346, 0.8370662500000002, 160.0, 530, 181303, 259, 7.467865399999937
260, 5.272832149168454, 25.22011519244397, 30.39228957723901, 0.8363795499999992, 260.0, 996, 182299, 260, 13.851451599999791
261, 4.735350950596468, 25.26947433423696, 30.456318141529394, 0.8355736000000006, 155.0, 795, 183094, 261, 10.644359899999927
262, 5.041421267199048, 25.232722307692658, 30.418078987874004, 0.8347915000000002, 135.0, 943, 184037, 262, 12.72670979999998
263, 3.8360256066232656, 25.314750387816304, 30.483516924360156, 0.8338586499999995, 550.0, 1130, 185167, 263, 15.501434000000017
264, 4.601069194048751, 25.296795623889867, 30.505903264750604, 0.8328533500000004, 285.0, 1104, 186271, 264, 14.972572600000149
265, 3.9321448500454426, 25.328230113983153, 30.480916385650634, 0.8320865500000002, 125.0, 600, 186871, 265, 8.11326310000004
266, 7.538429607887409, 25.33960042917129, 30.57341705533826, 0.8315569000000003, 105.0, 577, 187448, 266, 7.860803200000191
267, 5.6293987586642755, 25.32841912616383, 30.577744317777228, 0.8307032499999993, 605.0, 1320, 188768, 267, 17.982940999999983
268, 3.2841942865725264, 25.255749132766976, 30.41938470351552, 0.8297002000000004, 235.0, 909, 189677, 268, 12.423352099999875
269, 6.300101424808855, 25.105592095596283, 30.34837580377828, 0.8290603000000004, 120.0, 513, 190190, 269, 7.086469999999963
270, 4.345884546261131, 24.67976992126737, 29.713157962725386, 0.8285266, 160.0, 673, 190863, 270, 9.211770099999967
271, 3.7372625183358967, 24.691762636943036, 29.738590766148395, 0.8279249499999994, 215.0, 664, 191527, 271, 9.176806199999874
272, 5.104856626628196, 24.640035274677313, 29.685957567099255, 0.8273962000000002, 65.0, 511, 192038, 272, 7.114295200000015
273, 6.452148326978146, 24.783479392764125, 29.966759764629863, 0.8269385499999998, 45.0, 506, 192544, 273, 6.937274600000137
274, 5.0758784934978625, 24.741786751419827, 29.836948890223958, 0.8263765000000004, 210.0, 743, 193287, 274, 10.182719199999838
275, 4.375472179923432, 24.708934100286854, 29.809456886129176, 0.8254922499999997, 440.0, 1222, 194509, 275, 16.926671599999963
276, 4.498338916534167, 24.651209674195616, 29.72189546630768, 0.82464175, 150.0, 668, 195177, 276, 9.189853599999878
277, 5.330006901964674, 24.81250255497274, 29.92533755097485, 0.8240270499999999, 210.0, 698, 195875, 277, 9.645572299999913
278, 5.475287999370784, 24.752779686089717, 29.913739603215998, 0.8234159500000005, 90.0, 660, 196535, 278, 9.22888510000007
279, 2.996877007982818, 24.693286761620545, 29.699515561346598, 0.8227989999999998, 110.0, 711, 197246, 279, 9.82600390000016
280, 5.4565748797290645, 24.748682657877605, 29.842441761316515, 0.8222670999999998, 35.0, 471, 197717, 280, 6.579631900000095
281, 2.963228027828752, 24.65574503336867, 29.68762654866258, 0.8218908999999998, 75.0, 365, 198082, 281, 5.084412800000109
282, 3.290875486752898, 24.675398021898257, 29.7225724170211, 0.8213752000000004, 155.0, 781, 198863, 282, 10.925768699999935
283, 6.482965300829771, 24.755213633179665, 29.855027327934902, 0.8208509500000004, 90.0, 384, 199247, 283, 5.424673900000016
284, 3.974433789580269, 24.72275122921024, 29.736956236847735, 0.8204239000000001, 210.0, 565, 199812, 284, 7.9753623999999945
285, 3.826090047191717, 24.698649195139993, 29.77958103568254, 0.8199441999999999, 30.0, 501, 200313, 285, 7.092181799999935
286, 2.932338348040535, 24.72412808655174, 29.751367595696905, 0.8193654999999994, 135.0, 785, 201098, 286, 11.036235299999817
287, 2.6711712631936138, 24.680921604758815, 29.70125304774234, 0.81884125, 55.0, 380, 201478, 287, 5.329053199999862
288, 4.998583842193681, 24.74079506553151, 29.869932646196233, 0.8183880999999997, 195.0, 627, 202105, 288, 8.775041299999884
289, 3.338318947685941, 24.67550687405026, 29.771516500567106, 0.8178049000000005, 75.0, 669, 202774, 289, 10.253314900000078
290, 3.919795356656811, 24.735037760036747, 29.780295569722245, 0.81720865, 120.0, 656, 203430, 290, 10.685055499999862
291, 5.181884073485414, 24.738286370116395, 29.850954221750236, 0.8165669499999996, 140.0, 770, 204200, 291, 11.248138900000185
292, 4.172194581570082, 24.738357822227275, 29.804609576988017, 0.8157979000000006, 215.0, 939, 205139, 292, 16.014875600000096
293, 3.51617350518335, 24.650260731414125, 29.655651344047797, 0.8150477500000005, 135.0, 728, 205867, 293, 11.251959399999805
294, 4.265601491981729, 24.651207480148667, 29.681045806806313, 0.8145451000000001, 80.0, 389, 206256, 294, 5.954587200000105
295, 5.186848662010323, 24.67989881464205, 29.73848875460823, 0.8140019499999994, 185.0, 818, 207074, 295, 12.800869499999862
296, 5.162099734765868, 24.686711615285567, 29.786595018448367, 0.8132851, 155.0, 775, 207849, 296, 11.236373000000185
297, 2.630465077091931, 24.66008423947657, 29.66762407155028, 0.8126982999999997, 110.0, 529, 208378, 297, 7.8737003999999615
298, 2.341790030631936, 24.66425708100036, 29.668456231281436, 0.8122145500000004, 55.0, 546, 208924, 298, 8.103877900000043
299, 4.220795069552934, 24.650069859164176, 29.749283262826864, 0.8115516999999998, 165.0, 927, 209851, 299, 14.326091200000064
300, 3.704390647272345, 24.71864143488732, 29.769094053477104, 0.8109001000000002, 80.0, 521, 210372, 300, 7.717759899999919
301, 4.837532113729552, 24.706088679829282, 29.84097584582972, 0.8102894500000007, 210.0, 836, 211208, 301, 12.189394100000072
302, 5.671005943353085, 24.662854662750803, 29.76897683040473, 0.8096427999999999, 120.0, 601, 211809, 302, 8.978221800000028
303, 6.612902665077698, 24.713429031199848, 29.719539375391285, 0.809173, 50.0, 443, 212252, 303, 6.836756299999934
304, 3.45428659282056, 24.69618874833784, 29.74500462117086, 0.8087378499999999, 90.0, 524, 212776, 304, 7.970564000000195
305, 5.129032758375009, 24.744942699599942, 29.87501300151342, 0.8081537499999994, 210.0, 774, 213550, 305, 11.388031499999897
306, 3.7041406311034186, 24.68714873383685, 29.721176027282468, 0.8075840500000001, 65.0, 492, 214042, 306, 7.1243429999999535
307, 3.783698708890916, 24.692408969940132, 29.758307658546137, 0.8071092999999997, 95.0, 563, 214605, 307, 8.308485399999881
308, 3.5907866217498214, 24.697786913136746, 29.760072627395548, 0.8066008000000005, 110.0, 567, 215172, 308, 8.237871999999925
309, 5.515523377242823, 24.649691133720932, 29.704550157591353, 0.8059586499999999, 180.0, 860, 216032, 309, 12.375564499999882
310, 2.5709896222926503, 24.678423597646315, 29.693094490849695, 0.8051846499999996, 215.0, 860, 216892, 310, 12.518253400000049
311, 3.2020063878444143, 24.735292178856398, 29.77023651214417, 0.8044219000000005, 150.0, 835, 217727, 311, 12.08123959999989
312, 3.278438572584512, 24.7123877262247, 29.765870927394122, 0.8037329500000004, 90.0, 696, 218423, 312, 10.157691099999965
313, 4.25887582561965, 24.717971050068137, 29.83476770723154, 0.8030840499999999, 210.0, 746, 219169, 313, 11.000521899999967
314, 4.343762792016451, 24.74554869333903, 29.816411766639124, 0.8025728499999999, 60.0, 390, 219559, 314, 5.681387500000028
315, 4.234443577734498, 24.758432959542056, 29.833062128367157, 0.80222005, 55.0, 394, 219953, 315, 6.160001700000066
316, 3.49993787810596, 24.639379170985002, 29.68882829379412, 0.8017673499999999, 110.0, 612, 220565, 316, 10.387460099999998
317, 3.3454407052896546, 24.665091272448816, 29.712682196434507, 0.8011747000000001, 145.0, 705, 221270, 317, 11.996137399999952
318, 3.560568098412004, 24.63528605024944, 29.654640147482702, 0.8005672000000003, 135.0, 645, 221915, 318, 9.883523299999979
319, 3.327509833075145, 24.66098638149123, 29.726348419881237, 0.7999295499999994, 210.0, 772, 222687, 319, 11.858393800000158
320, 3.5326609492474637, 24.643877253627146, 29.673337503774277, 0.7993103500000001, 90.0, 604, 223291, 320, 9.168169199999966
321, 3.5741472039930193, 24.568994969497492, 29.630924500695823, 0.7987833999999998, 125.0, 567, 223858, 321, 8.568478700000014
322, 5.636558013928445, 24.67225620456593, 29.814242219849596, 0.7982434000000004, 180.0, 633, 224491, 322, 9.603251600000021
323, 2.3535836003350696, 24.582973429698818, 29.58818230723703, 0.7976867500000001, 45.0, 604, 225095, 323, 9.182133199999953
324, 4.607865547505664, 24.626098776175304, 29.631459952959048, 0.7971395499999994, 105.0, 612, 225707, 324, 9.310187600000063
325, 5.127555087978344, 24.628832031866747, 29.735897115604605, 0.7965635500000002, 135.0, 668, 226375, 325, 10.177639799999952
326, 5.012072809439066, 24.620683938403463, 29.67870346113693, 0.7958759500000001, 105.0, 860, 227235, 326, 13.065212400000064
327, 4.467651989199009, 24.656442456280285, 29.722500440843895, 0.7949350000000001, 530.0, 1231, 228466, 327, 18.85592130000009
328, 5.777245299212373, 24.618243074681533, 29.63067613203292, 0.7941376, 120.0, 541, 229007, 328, 8.288896900000054
329, 5.662776692363074, 24.60709756342339, 29.64627283584401, 0.7936462000000002, 110.0, 551, 229558, 329, 8.399223799999845
330, 5.292340301507767, 24.66617093809618, 29.746487112606275, 0.7931075499999997, 120.0, 646, 230204, 330, 9.91984750000006
331, 2.0757328753438355, 24.569822934209085, 29.525674817165896, 0.7925081500000005, 110.0, 686, 230890, 331, 10.607527699999991
332, 3.8665284828165034, 24.669028322394965, 29.73335381122144, 0.7920181, 75.0, 403, 231293, 332, 6.221044299999903
333, 4.077661515723397, 24.653534831211804, 29.712979435050574, 0.7914668499999994, 150.0, 822, 232115, 333, 12.723532299999988
334, 5.346213049112898, 24.690154538296238, 29.793564016931782, 0.7906879000000004, 190.0, 909, 233024, 334, 14.049872299999834
335, 5.150995220512824, 24.66603502673513, 29.74639073549556, 0.7897402000000002, 365.0, 1197, 234221, 335, 18.95083580000005
336, 4.220956356664623, 24.587239534503613, 29.588277159066035, 0.7889144499999997, 110.0, 638, 234859, 336, 9.86515559999998
337, 4.709062810218099, 24.656056592451606, 29.681336572397118, 0.7881260499999996, 260.0, 1114, 235973, 337, 17.268516900000122
338, 8.25482185932268, 24.722537552895595, 29.872434994095933, 0.7873272999999994, 120.0, 661, 236634, 338, 10.477661600000374
339, 3.170704168993484, 24.604185164805752, 29.663051933994463, 0.7866748000000003, 205.0, 789, 237423, 339, 12.165479400000095
340, 2.5628547028982793, 24.650147022879622, 29.615447327521764, 0.7860726999999997, 210.0, 549, 237972, 340, 8.550810200000342
341, 4.730389898059181, 24.66645656505101, 29.724753530932144, 0.7853144499999997, 240.0, 1136, 239108, 341, 17.995942200000172
342, 2.587776421813988, 24.656302799898036, 29.647937927994075, 0.7845737499999996, 85.0, 510, 239618, 342, 7.951803499999642
343, 3.967251019212752, 24.787277639680585, 29.924457578149728, 0.7840999000000002, 120.0, 543, 240161, 343, 8.666386100000182
344, 5.410434510187975, 25.13250920889459, 30.29208129157283, 0.7835527000000001, 180.0, 673, 240834, 344, 10.562462500000038
345, 4.776963369252469, 25.124365408781014, 30.289717134013635, 0.7830027999999996, 155.0, 549, 241383, 345, 8.540614300000016
346, 4.364190579136653, 25.083886642609873, 30.21802524597414, 0.78230935, 230.0, 992, 242375, 346, 15.638322799999969
347, 3.6324170451754063, 25.072555740037448, 30.180656095498115, 0.7812172000000003, 215.0, 1435, 243810, 347, 22.59448599999996
348, 4.277431041893966, 25.155230730137927, 30.36705161662812, 0.7804022499999999, 75.0, 376, 244186, 348, 6.0505253999999695
349, 2.8615513262171866, 25.06233813506041, 30.178373785992775, 0.7797438999999994, 305.0, 1087, 245273, 349, 17.04070139999976
350, 5.376747684788461, 25.1346282266913, 30.31082740750472, 0.7789446999999997, 185.0, 689, 245962, 350, 11.073109800000111
351, 2.39428341597364, 25.152424674418782, 30.235925810885032, 0.7783390000000002, 115.0, 657, 246619, 351, 10.626361000000088
352, 3.1426920169202, 25.10593779470019, 30.234125157094372, 0.7776959499999998, 185.0, 772, 247391, 352, 12.26968880000004
353, 2.4697521979534147, 25.155714374199423, 30.281764061455515, 0.7771132000000004, 120.0, 523, 247914, 353, 8.427658899999642
354, 4.039534373030798, 25.048318305988953, 30.205832944667925, 0.7765295500000003, 185.0, 774, 248688, 354, 12.308071199999631
355, 2.512911061959583, 25.109108534417036, 30.21169652408268, 0.7758658000000002, 115.0, 701, 249389, 355, 11.299177500000042
356, 3.288690636960106, 25.119893544836888, 30.286569700965398, 0.7752659500000002, 110.0, 632, 250021, 356, 10.137020799999846
357, 3.3623043472568193, 25.86152388967829, 31.177050335013607, 0.7746926499999995, 185.0, 642, 250663, 357, 10.184967499999857
358, 4.678481028721347, 25.80936812685247, 31.105887782225135, 0.7740189999999998, 95.0, 855, 251518, 358, 13.82753159999993
359, 2.519049493187771, 25.817230171760926, 30.98971149242795, 0.7734555999999997, 45.0, 397, 251915, 359, 6.403177799999867
360, 3.909133224210269, 25.811787139641847, 31.116053111116653, 0.7730852500000002, 65.0, 426, 252341, 360, 6.848316399999931
361, 2.5033999565538707, 25.764586860956584, 30.94841886295502, 0.7725844000000002, 105.0, 687, 253028, 361, 11.019028499999877
362, 8.799639256410227, 25.943681829779813, 31.308299171854053, 0.7720470999999998, 60.0, 507, 253535, 362, 8.27793819999988
363, 3.389991248071661, 25.79048077832275, 30.994371234605385, 0.7715035000000002, 135.0, 701, 254236, 363, 11.221857900000032
364, 3.270804054631835, 25.81552175643157, 31.090434687386022, 0.7708555000000004, 155.0, 739, 254975, 364, 11.952628700000332
365, 4.9526617827772625, 25.849782688075702, 31.211572930314695, 0.7701805000000004, 155.0, 761, 255736, 365, 12.311774299999797
366, 6.8920172694004345, 25.908779250250923, 31.349742828394827, 0.7695707500000002, 120.0, 594, 256330, 366, 10.887066000000232
367, 2.3248784835335123, 25.772181342956454, 30.96650749939498, 0.7689942999999992, 95.0, 687, 257017, 367, 11.87813929999993
368, 4.0460238558254265, 25.81921365722444, 31.073829387872546, 0.7682967999999999, 225.0, 863, 257880, 368, 15.033993099999861
369, 7.352039752111272, 25.824029428166174, 31.250100209348272, 0.7675524999999997, 345.0, 791, 258671, 369, 13.514860300000237
370, 6.704759739193261, 25.844135384154477, 31.221086978912354, 0.76692115, 110.0, 612, 259283, 370, 10.939792000000125
371, 2.298244064616567, 25.758218866159485, 30.975302273096077, 0.7663820499999997, 110.0, 586, 259869, 371, 10.879274500000065
372, 4.175049729810604, 26.21433521499833, 31.633318818891638, 0.7657736500000001, 115.0, 766, 260635, 372, 14.060776900000292
373, 4.828948586573548, 26.24915267207883, 31.631096046118287, 0.7648975000000005, 535.0, 1181, 261816, 373, 22.583585299999868
374, 2.299140785805103, 26.279765652486372, 31.58963345678567, 0.7640987500000002, 45.0, 594, 262410, 374, 11.143569599999864
375, 5.343550205339746, 26.374689795331257, 31.844673928981873, 0.7636469499999998, 60.0, 410, 262820, 375, 7.393517700000302
376, 5.807457497175737, 26.313488681821056, 31.736985791338622, 0.7630925499999998, 200.0, 822, 263642, 376, 14.72008310000001
377, 3.8050256880750735, 26.30146135716448, 31.7167592894807, 0.7625071, 80.0, 479, 264121, 377, 8.40140859999974
378, 3.446506344205765, 26.211105448887157, 31.541074240197844, 0.7617457000000002, 395.0, 1213, 265334, 378, 23.274074800000108
379, 6.078197115208523, 26.285304321552495, 31.780993265301426, 0.7608609999999998, 135.0, 753, 266087, 379, 12.416603200000282
380, 2.2411288096405126, 26.215435993437673, 31.52458067735036, 0.76015495, 165.0, 816, 266903, 380, 13.858486699999958
381, 5.554126015746095, 26.32907427501383, 31.817204339585437, 0.7594970499999999, 120.0, 646, 267549, 381, 12.200440600000093
382, 4.5488190577199985, 26.25069845930595, 31.554697823769544, 0.7588999000000004, 105.0, 681, 268230, 382, 11.434064600000056
383, 2.5749408957623015, 26.227161560200667, 31.580698847992682, 0.7583518000000002, 120.0, 537, 268767, 383, 8.823193400000036
384, 5.6093879205944, 26.33300969711504, 31.801137744598936, 0.7577325999999993, 230.0, 839, 269606, 384, 14.827320900000359
385, 3.8599219362561903, 26.13327865851553, 31.475646949650947, 0.7569446500000003, 200.0, 912, 270518, 385, 16.037016799999947
386, 3.391212137682097, 26.09668846483584, 31.393645559038436, 0.7561940500000001, 55.0, 756, 271274, 386, 13.73106179999968
387, 3.7790072731170725, 26.06470224324158, 31.397464548988182, 0.75542725, 285.0, 948, 272222, 387, 17.62462779999987
388, 7.514406036950794, 26.051118994070812, 31.51240296457328, 0.75472525, 80.0, 612, 272834, 388, 11.953949900000225
389, 3.9040062599571566, 26.036706543920047, 31.284211974488827, 0.7542694000000002, 55.0, 401, 273235, 389, 7.464230999999927
390, 2.574805921115351, 26.106954065958657, 31.40866453833614, 0.7537716999999999, 210.0, 705, 273940, 390, 13.810615299999881
391, 4.834034695762439, 26.089735262635827, 31.45701229399529, 0.7532060500000003, 35.0, 552, 274492, 391, 10.701912800000173
392, 5.5725548263252165, 26.103330797963327, 31.476211526177146, 0.7526804500000001, 130.0, 616, 275108, 392, 11.002141999999822
393, 2.420891754754238, 26.066013512195358, 31.358241817295152, 0.7521350499999995, 105.0, 596, 275704, 393, 10.640453500000149
394, 2.415284993705389, 25.993764684074804, 31.258036543193615, 0.7515248499999999, 215.0, 760, 276464, 394, 14.085133600000063
395, 2.3153724445041663, 25.99157169886998, 31.282804207179858, 0.7508206, 185.0, 805, 277269, 395, 19.73379019999993
396, 3.6715320474254796, 26.057749154432763, 31.408135377278974, 0.7499575, 210.0, 1113, 278382, 396, 24.03063069999962
397, 2.9707631525747917, 26.086245088016284, 31.353917210709813, 0.74927305, 50.0, 408, 278790, 397, 8.516851299999871
398, 2.5344482236423804, 26.013621159231917, 31.301100513391326, 0.7486277499999998, 555.0, 1026, 279816, 398, 20.978748900000028
399, 5.2716785325390765, 25.952299585040695, 31.320420229779312, 0.7478388999999996, 150.0, 727, 280543, 399, 15.84955140000011
400, 3.4224670352887347, 25.973192549928353, 31.263680581257546, 0.7472017, 120.0, 689, 281232, 400, 12.504624400000012
401, 4.87443857999409, 26.072405949760885, 31.373403436997357, 0.7467386499999997, 25.0, 340, 281572, 401, 5.742232899999635
402, 5.422765365778434, 26.0266907738305, 31.414353532187192, 0.7462801000000001, 170.0, 679, 282251, 402, 11.36988429999974
403, 4.3982389022802275, 25.974386562486323, 31.299678562068138, 0.7456532500000002, 110.0, 714, 282965, 403, 12.034311699999762
404, 4.772899407328981, 25.958675120816086, 31.28803132158337, 0.7450943499999997, 60.0, 528, 283493, 404, 9.154216899999938
405, 4.1201318093696555, 25.82454113502287, 31.056172252374854, 0.7446974499999998, 35.0, 354, 283847, 405, 6.531314699999712
406, 5.494698411005796, 25.985392745660278, 31.380519925331583, 0.7443617500000002, 35.0, 392, 284239, 406, 6.861345599999822
407, 3.35283403717877, 25.967819191915606, 31.249880959005917, 0.7438334499999996, 155.0, 782, 285021, 407, 14.102687399999922
408, 2.463341409926648, 25.974478174756456, 31.242011086924094, 0.7432241500000002, 90.0, 572, 285593, 408, 10.782270700000026
409, 4.7285567619157645, 25.980877070675344, 31.295738646884253, 0.7425262000000005, 180.0, 979, 286572, 409, 17.699749800000063
410, 4.76127999658717, 25.95927289835612, 31.2734445699056, 0.7415794000000001, 320.0, 1125, 287697, 410, 20.332022799999777
411, 2.3163557057315955, 25.964335966591882, 31.233246066353537, 0.7408949499999998, 80.0, 396, 288093, 411, 6.74769839999999
412, 5.030447027715055, 25.965666403606615, 31.2838880080211, 0.7404679000000003, 90.0, 553, 288646, 412, 9.355968500000017
413, 5.450435236160473, 26.00369027660739, 31.371005404892788, 0.7400098, 75.0, 465, 289111, 413, 8.04890740000019
414, 6.965155801631983, 26.054148741079235, 31.419458166812746, 0.7395381999999995, 85.0, 583, 289694, 414, 10.124440699999923
415, 3.4199217656796628, 25.850081757632168, 31.083597020235928, 0.7387808500000002, 450.0, 1100, 290794, 415, 19.14199789999975
416, 4.523008045631286, 25.816551310941577, 31.131390750408173, 0.7378250499999991, 325.0, 1024, 291818, 416, 17.518523200000345
417, 4.746994629075406, 25.84883873443467, 31.1527422475516, 0.7368616000000006, 250.0, 1117, 292935, 417, 20.87928469999997
418, 3.5366884648799894, 25.861632038519634, 31.157680204438, 0.7360822, 85.0, 615, 293550, 418, 11.962271500000043
419, 7.934110675073039, 25.934476880548978, 31.298511347587834, 0.7355003499999998, 95.0, 678, 294228, 419, 12.639759700000013
420, 3.5001913953601846, 25.879071585587628, 31.147851442352053, 0.7349095000000003, 110.0, 635, 294863, 420, 11.676075500000024
421, 4.813459662865702, 25.835214125645624, 31.196820865977894, 0.73434655, 110.0, 616, 295479, 421, 11.354329499999949
422, 5.131853658037308, 25.851042418320034, 31.121273225110897, 0.7338411999999995, 30.0, 507, 295986, 422, 9.944872199999736
423, 3.249230770449245, 25.80923846053484, 31.06156706624602, 0.7333237000000001, 125.0, 643, 296629, 423, 12.327131800000188
424, 2.2931861995659646, 25.83153066839005, 31.03799023480993, 0.7328448999999999, 60.0, 421, 297050, 424, 8.329424000000017
425, 4.439047274483162, 25.813274534836033, 31.10981189090199, 0.7324966000000002, 50.0, 353, 297403, 425, 6.766989400000057
426, 2.1684314494381596, 25.85412301490055, 31.06520081524873, 0.7321586500000002, 50.0, 398, 297801, 426, 7.794771999999739
427, 2.57233844296888, 25.839880478064405, 31.05084472514801, 0.7315912000000003, 170.0, 863, 298664, 427, 17.551543400000355
428, 3.3402556049194074, 25.810163564171358, 31.092881769933854, 0.7308919, 120.0, 691, 299355, 428, 14.685045700000046
429, 3.445664347895579, 25.843447236289755, 31.11608932450501, 0.7302731500000001, 165.0, 684, 300039, 429, 14.848355000000083
430, 3.4737078901709277, 26.53692570486622, 31.96777145315159, 0.7294302999999991, 390.0, 1189, 301228, 430, 25.686022500000036
431, 6.588219296193085, 26.57723526886423, 32.01402891914113, 0.7286121999999999, 140.0, 629, 301857, 431, 13.762926399999742
432, 2.3717053831197483, 26.531107822951977, 31.917888714811156, 0.7279786000000003, 160.0, 779, 302636, 432, 17.176640900000166
433, 2.24521123377833, 26.503770218259678, 31.87990229567935, 0.7274395000000001, 85.0, 419, 303055, 433, 9.31134179999981
434, 2.3118930560922544, 26.49861768941817, 31.84609229238845, 0.7268360499999994, 215.0, 922, 303977, 434, 20.062306100000114
435, 5.427606158308849, 26.495707885598687, 31.96623891573341, 0.7261340500000002, 110.0, 638, 304615, 435, 13.346924699999818
436, 3.277923022208397, 26.55083665326568, 31.987675933049033, 0.7255422999999996, 135.0, 677, 305292, 436, 14.279225200000383
437, 2.591254808139801, 26.505540701293945, 31.858281134033202, 0.7249564000000004, 160.0, 625, 305917, 437, 13.685817900000075
438, 5.114827811233628, 26.61223074218283, 32.17917646185618, 0.7244398000000001, 80.0, 523, 306440, 438, 11.035196100000121
439, 3.1035582536231665, 26.536565016892, 31.9144873396825, 0.7237796499999993, 335.0, 944, 307384, 439, 21.078024699999787
440, 5.67624300411722, 26.545853638671083, 31.966527496917696, 0.7228693000000005, 310.0, 1079, 308463, 440, 22.690126999999848
441, 4.31675941798709, 26.63509639555758, 32.10789100419391, 0.7220669500000002, 155.0, 704, 309167, 441, 14.571472099999937
442, 2.4344678423754993, 26.54827725780453, 31.919644239770008, 0.7213986999999998, 175.0, 781, 309948, 442, 16.753753699999834
443, 2.489209731456674, 26.436757904806253, 31.775947707376364, 0.7208650000000001, 65.0, 405, 310353, 443, 8.315276499999982
444, 5.5254599273053415, 26.49460223935685, 31.986424558221515, 0.7203727000000003, 105.0, 689, 311042, 444, 13.864969300000212
445, 2.5242091911820923, 26.52061769115965, 31.8957716759215, 0.7196607999999999, 315.0, 893, 311935, 445, 18.85163160000002
446, 5.9718953037173605, 26.446802424188352, 31.909140624913007, 0.7188643000000002, 370.0, 877, 312812, 446, 19.021556300000157
447, 3.4140926495895974, 26.41274197452881, 31.755740025195227, 0.7179534999999994, 355.0, 1147, 313959, 447, 25.892193000000134
448, 4.042353072951626, 26.480154014849862, 31.896225812737768, 0.717058, 265.0, 843, 314802, 448, 17.804798299999675
449, 3.4261694589670557, 26.459369695621685, 31.817831111824425, 0.7163704000000001, 180.0, 685, 315487, 449, 14.744352200000321
450, 3.1641350037239513, 26.389411341495023, 31.77541472372148, 0.7157480499999996, 145.0, 698, 316185, 450, 14.655159599999934
451, 4.490754145106053, 26.471374500693614, 31.87764571856901, 0.7151225500000004, 155.0, 692, 316877, 451, 14.149188100000174
452, 3.181818706310958, 26.49323400036319, 31.919713761780287, 0.7144835499999999, 320.0, 728, 317605, 452, 15.160896399999729
453, 4.158770659643334, 26.452623104739498, 31.876350814026672, 0.7139827000000001, 80.0, 385, 317990, 453, 8.683210899999722
454, 4.559144899620446, 26.48824300003448, 31.86460290791956, 0.7133761000000001, 515.0, 963, 318953, 454, 21.3519067000002
455, 3.531554913411838, 26.443664394615187, 31.834295539674017, 0.7123766499999991, 190.0, 1258, 320211, 455, 26.68417249999993
456, 4.0242995405281095, 26.430646471910073, 31.88750501820739, 0.7116507999999998, 20.0, 355, 320566, 456, 7.735060099999828
457, 4.108452527546008, 26.42263886213524, 31.81775560086816, 0.7110064000000003, 265.0, 1077, 321643, 457, 23.336581300000034
458, 3.7085539893177915, 26.46291760373707, 31.809840793451986, 0.7103039499999999, 50.0, 484, 322127, 458, 10.762819799999761
459, 3.1162030384114194, 26.460473548304712, 31.79982847012348, 0.7096514499999997, 195.0, 966, 323093, 459, 20.423211400000127
460, 5.363954157909505, 26.576369786573043, 32.05891531076169, 0.7089057999999999, 150.0, 691, 323784, 460, 14.75313180000012
461, 2.4766654634039917, 26.431274661478007, 31.780166558499605, 0.70840405, 80.0, 424, 324208, 461, 9.715557100000296
462, 3.9730078739037022, 26.401966555632924, 31.811297285993515, 0.7078816, 180.0, 737, 324945, 462, 16.088088999999854
463, 2.314994198926648, 26.400402749171022, 31.729488779286868, 0.7073303499999997, 65.0, 488, 325433, 463, 11.319718900000225
464, 2.1548283736293135, 26.48595292657555, 31.859882663222695, 0.7068826, 85.0, 507, 325940, 464, 11.216262500000084
465, 5.069461123503578, 26.443758522346123, 31.87440600829836, 0.7063138000000004, 160.0, 757, 326697, 465, 17.037487800000235
466, 3.1822393525184856, 26.4460996610147, 31.824242607310968, 0.70558435, 190.0, 864, 327561, 466, 19.349999600000046
467, 3.077197742728093, 26.451863069449907, 31.830377106117993, 0.7048904500000001, 140.0, 678, 328239, 467, 14.878924300000108
468, 4.509276013792575, 26.508116195890967, 31.93846310198399, 0.7042941999999995, 115.0, 647, 328886, 468, 13.584923300000355
469, 2.2350026351720382, 26.38381707619247, 31.718769567984122, 0.7036749999999999, 170.0, 729, 329615, 469, 15.458088400000179
470, 6.076340237786014, 26.455177656154042, 31.959558142829188, 0.7031723499999999, 75.0, 388, 330003, 470, 9.011256200000389
471, 4.886653295939031, 26.5189168723178, 31.970959264416518, 0.7026202000000004, 210.0, 839, 330842, 471, 18.9701170000003
472, 2.3684301826189147, 26.48374461435614, 31.809500845146456, 0.7019325999999998, 215.0, 689, 331531, 472, 15.134441700000025
473, 5.288729447505378, 26.643545911491263, 32.069962128508756, 0.7013889999999998, 80.0, 519, 332050, 473, 11.688380600000073
474, 3.0217602808388224, 26.555560049609603, 31.922330098731496, 0.70086655, 105.0, 642, 332692, 474, 14.448179600000003
475, 1.9653417097739765, 26.518789291381836, 31.89572357357779, 0.7004250999999998, 30.0, 339, 333031, 475, 8.06371450000006
476, 3.5139933574864792, 26.579200936182374, 31.95420349350303, 0.6997483000000003, 520.0, 1165, 334196, 476, 25.415505300000405
477, 3.6440209328729125, 26.557196964536395, 31.952666020393373, 0.6989720499999998, 30.0, 560, 334756, 477, 12.443009100000381
478, 5.667439031819108, 26.579440602002013, 32.0995053984687, 0.6985387, 55.0, 403, 335159, 478, 8.982087299999876
479, 4.26655046180691, 26.537056588760727, 31.955839479061037, 0.6981814, 65.0, 391, 335550, 479, 8.660436500000287
480, 6.523331279118606, 26.59205751599006, 32.04542428142619, 0.6975761500000004, 210.0, 954, 336504, 480, 21.70875980000028
481, 4.247688428012642, 26.587700684865315, 32.024757688150466, 0.6968606500000003, 135.0, 636, 337140, 481, 14.220611100000042
482, 3.8862613852810397, 26.613626171052097, 32.00865746697607, 0.6962022999999998, 185.0, 827, 337967, 482, 19.286471399999755
483, 3.5631575276690093, 26.55339275494469, 31.935578131566185, 0.6955363000000004, 140.0, 653, 338620, 483, 15.156615699999747
484, 5.052071882376384, 26.604710354113823, 32.01005672605635, 0.6949351, 180.0, 683, 339303, 484, 16.01182589999962
485, 4.660914864460661, 26.557927959034114, 31.987116779657697, 0.6943627000000001, 180.0, 589, 339892, 485, 12.990901499999836
486, 2.3752181785562794, 26.521281404119982, 31.899801981497653, 0.693766, 165.0, 737, 340629, 486, 15.779895900000156
487, 4.085384704054244, 26.49101229042262, 31.89951470923024, 0.6929244999999992, 325.0, 1133, 341762, 487, 25.142924400000084
488, 4.952716000683573, 26.5292783600345, 31.97948092213487, 0.6921072999999999, 135.0, 683, 342445, 488, 15.578689099999792
489, 3.1068219312238603, 26.478403755596705, 31.83172690381809, 0.6914471500000003, 435.0, 784, 343229, 489, 18.053012000000308
490, 2.3389668900240985, 26.532342577905204, 31.901241812349358, 0.69076945, 200.0, 722, 343951, 490, 17.15894440000011
491, 5.872678744268715, 26.48323695217143, 31.950457047227346, 0.6902821, 50.0, 361, 344312, 491, 8.506419899999855
492, 5.726102821684945, 26.57120271253336, 32.10874970421117, 0.6899477499999999, 30.0, 382, 344694, 492, 8.918211299999712
493, 7.793259949713457, 26.63120168154357, 32.210986453197044, 0.6895013500000001, 120.0, 610, 345304, 493, 14.132856500000344
494, 4.101989957427948, 26.50194271973201, 31.92931902651884, 0.6888740499999997, 240.0, 784, 346088, 494, 17.151323800000682
495, 4.117357648255146, 26.51627190907796, 31.924817950532752, 0.68806495, 310.0, 1014, 347102, 495, 21.243481299999985
496, 3.5597054682253453, 26.51621780395508, 31.8566302481662, 0.6874083999999999, 110.0, 445, 347547, 496, 9.933399200000167
497, 1.998348206149923, 26.531456353388037, 31.902621945604125, 0.6869791000000001, 150.0, 509, 348056, 497, 11.557431399999587
498, 3.2842295604099023, 26.462580293461, 31.84523492584905, 0.6864454, 110.0, 677, 348733, 498, 15.040584800000033
499, 5.004599728455363, 26.50831776375336, 31.94014122489175, 0.6857902000000003, 225.0, 779, 349512, 499, 17.539219699999194
500, 3.3481670615135455, 26.475804227941175, 31.829425101186715, 0.6852101500000001, 90.0, 510, 350022, 500, 11.620639900000242
501, 3.7595014636323585, 26.41145208488656, 31.79512351160266, 0.6846039999999993, 220.0, 837, 350859, 501, 19.073388499999965
502, 4.167148456850031, 26.412344137827557, 31.823938374046808, 0.6840275500000002, 20.0, 444, 351303, 502, 10.119511099999727
503, 6.951254841255939, 26.525949324591686, 31.981277293404617, 0.6835091499999999, 110.0, 708, 352011, 503, 15.20254449999993
504, 3.325946044816308, 26.446697557329806, 31.78673263986364, 0.6828602500000004, 230.0, 734, 352745, 504, 15.781648600000153
505, 3.8971395306805703, 26.430694168527165, 31.815666081380595, 0.6820106499999997, 270.0, 1154, 353899, 505, 25.616985200000272
506, 3.5701751718933443, 26.491808605960095, 31.886701522582026, 0.6810431500000005, 270.0, 996, 354895, 506, 22.340115199999673
507, 3.464230087662571, 26.503121294609546, 31.884616959457286, 0.680284, 135.0, 691, 355586, 507, 15.607733699999699
508, 2.1390094775030324, 26.47508425759797, 31.83385415596537, 0.6797003500000002, 145.0, 606, 356192, 508, 13.854448999999477
509, 3.3044035186018297, 26.3638781497353, 31.761226229339478, 0.6792053499999997, 100.0, 494, 356686, 509, 11.413857900000039
510, 2.447267870119679, 26.47973496760797, 31.84806573062862, 0.6787868500000003, 10.0, 436, 357122, 510, 10.021994800000357
511, 5.163151856563019, 26.45122868195745, 31.884562854912446, 0.6782959000000002, 180.0, 655, 357777, 511, 14.407712600000195
512, 2.2441689286609083, 26.447897646378497, 31.827153567878568, 0.6777806499999997, 30.0, 490, 358267, 512, 10.758443499999885
513, 2.0721844483361056, 26.46705211421692, 31.831026313914258, 0.6773788000000001, 60.0, 403, 358670, 513, 8.852309199999581
514, 2.835522305366676, 26.447702258014967, 31.806778203804807, 0.6767506, 430.0, 993, 359663, 514, 22.498297099999945
515, 2.2755565452192235, 26.323001088070946, 31.612503741385495, 0.6760274499999999, 45.0, 614, 360277, 515, 14.343160100000205
516, 3.624286814673931, 26.3304722154124, 31.683630348406062, 0.675100450000001, 315.0, 1446, 361723, 516, 32.864206500000364
517, 3.8110721129695357, 26.287303705983078, 31.66029155986208, 0.6741199000000001, 455.0, 733, 362456, 517, 17.411160499999824
518, 5.196027114583912, 26.352628034805132, 31.738169487632998, 0.6732914499999992, 280.0, 1108, 363564, 518, 24.924805200000264
519, 3.159495601109708, 26.375735879682992, 31.730653233392236, 0.6724297000000001, 440.0, 807, 364371, 519, 18.090261199999986
520, 2.1058464886916575, 26.33546506133035, 31.68886596020137, 0.67187395, 30.0, 428, 364799, 520, 10.070865200000299
521, 5.043722051853757, 26.408052271561658, 31.811980114394814, 0.6713686000000001, 180.0, 695, 365494, 521, 16.204475800000182
522, 4.130880524368329, 26.392340399283732, 31.803965202352618, 0.6707300499999996, 105.0, 724, 366218, 522, 16.7806886999997
523, 7.159552064851826, 26.474506403455326, 31.951367230759452, 0.6700987000000003, 65.0, 679, 366897, 523, 15.793808700000227
524, 3.2468537156821276, 26.383684946279057, 31.720658930794137, 0.66951865, 160.0, 610, 367507, 524, 14.426974099999825
525, 2.071759775978855, 26.427041920529135, 31.762698726412616, 0.6690664, 50.0, 395, 367902, 525, 9.478266299999632
526, 3.113813870255241, 26.30293699356703, 31.665297216346865, 0.6685255000000001, 175.0, 807, 368709, 526, 18.74038130000008
527, 3.8456232336297465, 26.39039197343119, 31.78168351248409, 0.6679620999999998, 75.0, 445, 369154, 527, 10.133160999999745
528, 5.485344029877476, 26.415247051094486, 31.826054162464516, 0.6673699000000002, 200.0, 871, 370025, 528, 19.726365200000146
529, 4.806337077966741, 26.63424112335328, 32.16846910984285, 0.6667547500000001, 40.0, 496, 370521, 529, 11.730326299999433
530, 6.264202375391229, 26.687759778985928, 32.184817293587805, 0.6662601999999997, 145.0, 603, 371124, 530, 14.312677700000677
531, 2.656851107721659, 26.664898494469146, 32.05944213004473, 0.6655312, 390.0, 1017, 372141, 531, 23.668082700000014
532, 4.6443939164852015, 26.61123904450845, 32.01109270434762, 0.6648152499999997, 135.0, 574, 372715, 532, 13.785274900000331
533, 5.945616595631699, 26.69243505327764, 32.152262245600845, 0.6642482500000001, 110.0, 686, 373401, 533, 16.378600099999858
534, 7.1027568091464, 26.629234055598893, 32.17679128608856, 0.6637136499999997, 80.0, 502, 373903, 534, 12.158886100000018
535, 3.3426444732091007, 26.61938312185022, 31.97935287269001, 0.6630058000000003, 515.0, 1071, 374974, 535, 24.42552219999925
536, 4.8546599245565565, 26.7282144061091, 32.25550263951554, 0.6621737499999995, 185.0, 778, 375752, 536, 17.76049839999996
537, 4.557392542300366, 26.674895924880268, 32.06229535475832, 0.661429, 235.0, 877, 376629, 537, 21.129572499999995
538, 7.337863106827636, 26.64533491067953, 32.1300222712519, 0.6606482499999999, 210.0, 858, 377487, 538, 20.40237369999977
539, 4.262132906635738, 26.68805519685539, 32.09417155442656, 0.6598666000000001, 325.0, 879, 378366, 539, 21.22718689999965
540, 2.1236378520681933, 26.602289865519822, 31.99851704946237, 0.6591744999999998, 45.0, 659, 379025, 540, 15.911505400000351
541, 3.8057932378872046, 26.679638991280207, 32.091785224026474, 0.6585377500000003, 200.0, 756, 379781, 541, 17.95899079999981
542, 4.960644689917927, 26.58280205654156, 32.06369311324006, 0.6579014499999996, 120.0, 658, 380439, 542, 15.173368999999184
543, 3.8426373617866108, 26.483801220211944, 31.873361169820097, 0.6574347999999998, 30.0, 379, 380818, 543, 8.889445100000557
544, 4.2483857940915675, 26.496851184795823, 31.897632659367694, 0.6568101999999998, 290.0, 1009, 381827, 544, 23.5671997999998
545, 2.163920972496271, 26.478606447577477, 31.82108285029729, 0.6561833499999999, 80.0, 384, 382211, 545, 9.465221999999812
546, 2.180232427046938, 26.444599883991053, 31.76806205412301, 0.6558476500000001, 80.0, 362, 382573, 546, 8.919881599999826
547, 6.143349796158051, 26.573563441153496, 32.080604026394504, 0.6554615499999998, 75.0, 496, 383069, 547, 11.929295200000524
548, 5.4767584838933505, 26.557085277914517, 31.981851153328428, 0.6549067000000003, 240.0, 737, 383806, 548, 18.01812979999977
549, 3.3973310261171092, 26.51906068546256, 31.903293626005297, 0.6543131500000002, 130.0, 582, 384388, 549, 14.647433899999669
550, 5.644972051931902, 26.57501059874425, 32.05547298537729, 0.6537929499999996, 35.0, 574, 384962, 550, 15.081358399999772
551, 3.1645437706255874, 26.474667129885173, 31.855981501212252, 0.6532552000000003, 115.0, 621, 385583, 551, 15.725326400000085
552, 4.527208749055292, 26.549308816971788, 32.00189119999085, 0.6527404, 70.0, 523, 386106, 552, 13.286838699999862
553, 4.6477521765374, 26.52205634707496, 32.002283862885974, 0.6522687999999996, 20.0, 525, 386631, 553, 13.809976900000038
554, 4.220147313499563, 26.52060792042965, 31.922343381511393, 0.6516014500000001, 225.0, 958, 387589, 554, 20.834568799999943
555, 3.5591526815353007, 26.437906576986126, 31.82428227369145, 0.6510078999999999, 60.0, 361, 387950, 555, 8.531327799999417
556, 3.042754515610116, 26.53284399764967, 31.906862471279815, 0.650413, 245.0, 961, 388911, 556, 22.60260019999987
557, 4.453972577170195, 26.529746089080344, 31.975320112158006, 0.6494806000000001, 310.0, 1111, 390022, 557, 31.616117999999915
558, 3.8628053558503446, 26.668053654714242, 32.11434254309943, 0.6484383999999999, 210.0, 1205, 391227, 558, 32.797612899999876
559, 5.8403104886793615, 26.7135270671411, 32.22741772369905, 0.6477377499999999, 50.0, 352, 391579, 559, 8.958155600000282
560, 5.053228581305363, 26.735651621266076, 32.22242788308383, 0.6471793000000003, 410.0, 889, 392468, 560, 24.252984199999446
561, 4.714240209811103, 26.769871715289444, 32.332718671257815, 0.64653805, 110.0, 536, 393004, 561, 14.394590599999901
562, 5.009064237528422, 26.758163338308936, 32.242448321333875, 0.64589725, 180.0, 888, 393892, 562, 23.253774599999815
563, 4.1628456695457805, 26.731564554117494, 32.18463999268699, 0.6451790499999995, 155.0, 708, 394600, 563, 19.525021800000104
564, 4.139828032976659, 26.65155570543124, 32.04179424826348, 0.6445333000000001, 135.0, 727, 395327, 564, 19.198662000000695
565, 3.3189625759564696, 26.683551447732107, 32.091924271615994, 0.6439415499999995, 130.0, 588, 395915, 565, 14.973984100000052
566, 3.5399481692624373, 26.683667053436412, 32.116984702389814, 0.6432593500000001, 210.0, 928, 396843, 566, 24.28088680000019
567, 3.183263940862051, 26.686351702522565, 32.14509271831544, 0.6422936499999993, 375.0, 1218, 398061, 567, 32.31393889999981
568, 6.916863185200674, 26.780189371820708, 32.36317667676442, 0.64150435, 55.0, 536, 398597, 568, 14.71439250000003
569, 4.159976712433392, 26.68940359539212, 32.16285249470841, 0.6408721000000001, 155.0, 869, 399466, 569, 24.788293599999633
570, 2.124079194002927, 26.726278339062898, 32.100717839301964, 0.6401782, 90.0, 673, 400139, 570, 19.687912200000028
571, 2.9633778295906255, 26.726061562535563, 32.15644087184089, 0.6395432499999996, 240.0, 738, 400877, 571, 20.09312409999984
572, 3.9196684340721943, 26.773891842554487, 32.227898029365925, 0.6388993000000002, 185.0, 693, 401570, 572, 19.503451599999607
573, 6.706414461698828, 26.869281270610752, 32.37852513968055, 0.63810505, 275.0, 1072, 402642, 573, 29.79554150000058
574, 3.9730176282277134, 26.80315982242595, 32.228515964627604, 0.63730675, 140.0, 702, 403344, 574, 19.22483850000026
575, 2.902567452572543, 26.74984627033102, 32.14655831698714, 0.6366645999999999, 160.0, 725, 404069, 575, 20.471135999999206
576, 5.080845825465545, 26.819667274966562, 32.297624626042655, 0.6360449500000002, 65.0, 652, 404721, 576, 17.39938710000024
577, 4.705619243644835, 26.798586063170703, 32.25284691989709, 0.63519085, 395.0, 1246, 405967, 577, 32.68783379999968
578, 6.13215136214827, 26.871556715276036, 32.41866702245752, 0.6343250499999998, 170.0, 678, 406645, 578, 18.390183200000138
579, 3.1797321921639696, 26.783716008594183, 32.189848706653265, 0.6337400500000002, 115.0, 622, 407267, 579, 17.03170560000035
580, 4.9646029586775855, 26.87996575449606, 32.40041528771878, 0.6332275000000002, 40.0, 517, 407784, 580, 14.115950100000191
581, 4.852467297804523, 26.888298892591852, 32.352645207600425, 0.6327707499999997, 135.0, 498, 408282, 581, 14.107739500000207
582, 2.0831313506018794, 26.751085998227932, 32.170479944088314, 0.6322784500000003, 170.0, 596, 408878, 582, 16.7860455
583, 7.460641569254141, 26.882945449068277, 32.47000338694396, 0.6318478000000002, 75.0, 361, 409239, 583, 10.410657100000208
584, 4.229302796114244, 26.798547822921, 32.28555975697359, 0.6313010499999996, 255.0, 854, 410093, 584, 22.87709630000063
585, 2.10816545493546, 26.61759409223284, 31.98205724897839, 0.6307277499999999, 50.0, 420, 410513, 585, 11.437382699999944
586, 4.50366729562964, 26.774057988476322, 32.21185459218662, 0.6302656, 135.0, 607, 411120, 586, 16.37009820000003
587, 1.8710859875442296, 26.688355319107636, 32.02600237991236, 0.62970805, 55.0, 632, 411752, 587, 17.78000780000002
588, 1.9395016724946068, 26.710717131590524, 32.08559730120459, 0.6291217000000001, 90.0, 671, 412423, 588, 19.483715699999266
589, 2.333299992213908, 26.679295478906848, 32.061589513506206, 0.6285803499999998, 110.0, 532, 412955, 589, 14.969516000000112
590, 2.3436613303341276, 26.76734539711312, 32.18250915318319, 0.6281766999999999, 30.0, 365, 413320, 590, 10.357191000000057
591, 2.1676080572636423, 26.65771837810206, 32.012217544195224, 0.627841, 80.0, 381, 413701, 591, 10.410862700000507
592, 4.379251381000841, 26.7659406284457, 32.26693172750292, 0.6274081, 125.0, 581, 414282, 592, 16.221271200000047
593, 4.767717960878133, 26.712684923116537, 32.18568563159889, 0.6267907000000003, 170.0, 791, 415073, 593, 23.4943159000004
594, 9.192270188939732, 26.792445806554845, 32.3969063887725, 0.6262682500000002, 35.0, 370, 415443, 594, 10.553696700000728
595, 2.070574806950424, 26.73056249798469, 32.08683616710159, 0.6259109499999999, 20.0, 424, 415867, 595, 11.204744100000426
596, 3.347409494454954, 26.819760191674327, 32.26050357818603, 0.6254906499999998, 55.0, 510, 416377, 596, 13.897050300000046
597, 3.1754562554644865, 26.650271867922214, 32.05498013623257, 0.6249736, 170.0, 639, 417016, 597, 17.69086850000076
598, 2.4958266330202323, 26.767706783918236, 32.135934811372024, 0.6244988499999997, 110.0, 416, 417432, 598, 11.4563033000004
599, 4.91239361748137, 26.75274448202114, 32.23345133752534, 0.6239552500000002, 185.0, 792, 418224, 599, 22.506115099999988
600, 4.348506832967372, 26.705313548649826, 32.167955271185264, 0.6233360500000001, 65.0, 584, 418808, 600, 16.58744669999942
601, 4.041757263942582, 26.66481382910776, 32.08295470818706, 0.6226034499999993, 280.0, 1044, 419852, 601, 29.042099399999643
602, 3.277123098866674, 28.015958876505387, 33.6673530836175, 0.6218870500000002, 100.0, 548, 420400, 602, 15.188107600000876
603, 4.449209480209751, 28.512107872814866, 34.35713344360731, 0.6212781999999997, 335.0, 805, 421205, 603, 22.554553800000576
604, 5.279529380914696, 28.403129419091368, 34.215721192828354, 0.62055865, 180.0, 794, 421999, 604, 22.53148489999967
605, 5.908817110583186, 28.460278792167777, 34.33965701131678, 0.6199601499999998, 120.0, 536, 422535, 605, 14.943858799999362
606, 3.511034185986764, 28.373184879828916, 34.091407080179316, 0.6194611000000001, 80.0, 573, 423108, 606, 16.23067219999939
607, 3.621985158193879, 28.369865537993384, 34.13678994300444, 0.6188328999999998, 125.0, 823, 423931, 607, 23.34254510000028
608, 3.50319148491995, 28.39109583087996, 34.18238571391386, 0.6182330500000002, 65.0, 510, 424441, 608, 14.41354499999943
609, 3.422353837725419, 28.445215334016797, 34.1872098756134, 0.6177511000000001, 180.0, 561, 425002, 609, 14.885359199999584
610, 3.4483788000093623, 28.34608112626122, 34.087501388615365, 0.6170796999999993, 285.0, 931, 425933, 610, 26.449151200000415
611, 4.023199495123296, 28.46942189940016, 34.307800718755004, 0.6164632000000002, 90.0, 439, 426372, 611, 13.554856399999153
612, 3.449362652133918, 28.40332633713775, 34.23426251062947, 0.6160131999999998, 120.0, 561, 426933, 612, 17.003336600000694
613, 3.877447177688053, 28.414408145914642, 34.20007451487555, 0.6152509000000004, 265.0, 1133, 428066, 613, 33.44157539999924
614, 7.12658906251017, 28.48723050536213, 34.391986381990094, 0.6144345999999996, 355.0, 681, 428747, 614, 19.342659699999786
615, 3.9722648667302103, 28.414551439710483, 34.16966333571513, 0.6137749000000002, 350.0, 785, 429532, 615, 21.338863400000264
616, 3.497385250569999, 28.558692734742998, 34.36575900314897, 0.6130215999999998, 235.0, 889, 430421, 616, 24.68959790000008
617, 4.521439248263467, 28.819543622964677, 34.65357637848278, 0.61233085, 125.0, 646, 431067, 617, 18.72682040000018
618, 3.6858227906688565, 28.803733432854965, 34.64874220249375, 0.6118587999999999, 30.0, 403, 431470, 618, 11.51912380000067
619, 4.104155244917023, 28.809696322702532, 34.63625305008858, 0.6113277999999999, 215.0, 777, 432247, 619, 22.25065110000014
620, 3.9004119503431274, 28.793292825872246, 34.64280986904652, 0.6106168000000001, 135.0, 803, 433050, 620, 23.037072199999784
621, 5.362999994045138, 28.800420447366978, 34.690216373214525, 0.6100831000000002, 45.0, 383, 433433, 621, 11.032721600000514
622, 5.223803223789769, 28.91692434470317, 34.767918864313394, 0.6095984500000002, 195.0, 694, 434127, 622, 19.12343249999958
623, 3.6451150035026902, 28.77642141359761, 34.63407724270844, 0.6086520999999994, 440.0, 1409, 435536, 623, 39.12149700000009
624, 5.355719518820984, 28.808270317297012, 34.667134793802575, 0.60773635, 385.0, 626, 436162, 624, 17.719587100000354
625, 2.2233891676908577, 28.796770762577438, 34.57456164646968, 0.6072976, 75.0, 349, 436511, 625, 10.026709500000834
626, 5.484181717199622, 28.79873029513994, 34.676001897168234, 0.6068498500000001, 80.0, 646, 437157, 626, 18.79453579999972
627, 2.1826111772516428, 28.856103449059813, 34.677269532376485, 0.6062238999999999, 95.0, 745, 437902, 627, 21.873277200000302
628, 4.854725239671608, 28.78168893773505, 34.67878825207974, 0.6054656500000002, 300.0, 940, 438842, 628, 26.131643099999565
629, 5.958808927544927, 28.810576889951154, 34.73433262569309, 0.6046515999999996, 130.0, 869, 439711, 629, 24.90289380000013
630, 2.91201189101324, 28.548075942029634, 34.324140612211345, 0.6038686000000001, 260.0, 871, 440582, 630, 25.2421233999994
631, 3.7878232746474487, 28.33149086688198, 34.084644096719344, 0.6033173499999999, 5.0, 354, 440936, 631, 10.250057600000218
632, 2.3679116156339646, 28.31752707519531, 34.009155249023436, 0.6028768, 15.0, 625, 441561, 632, 18.502404799999567
633, 4.257821941655708, 28.46958671297346, 34.295518821811086, 0.6023057500000002, 125.0, 644, 442205, 633, 19.1666510999994
634, 3.7008259118304534, 28.4108571804271, 34.130102036420034, 0.6018246999999998, 35.0, 425, 442630, 634, 12.597267799999827
635, 4.09343648590526, 28.449487392718975, 34.22835618837132, 0.6013234000000003, 165.0, 689, 443319, 635, 19.47315720000006
636, 3.8492549721018543, 28.48538146189281, 34.31500141790935, 0.6005093499999997, 240.0, 1120, 444439, 636, 32.0857216000004
637, 4.486358217587058, 28.373979365313943, 34.13954458251856, 0.5997222999999999, 140.0, 629, 445068, 637, 18.558632400000533
638, 3.320517634432162, 28.426109313964844, 34.228996095349714, 0.59916025, 125.0, 620, 445688, 638, 18.79076789999999
639, 5.746931779809097, 28.476940613472145, 34.377077145109546, 0.5985779500000004, 105.0, 674, 446362, 639, 19.83722940000007
640, 2.0531052999180397, 28.27675309077302, 33.94648760225236, 0.5980888000000001, 35.0, 413, 446775, 640, 12.30015590000039
641, 2.800938691011602, 28.412646058904645, 34.16932654061598, 0.5974659999999995, 395.0, 971, 447746, 641, 27.556404899999507
642, 4.399919714413437, 28.46755364361931, 34.253585588158884, 0.5967307000000001, 105.0, 663, 448409, 642, 18.51574040000014
643, 2.3831983715050167, 28.431254062023793, 34.14076681451483, 0.5962685499999998, 55.0, 364, 448773, 643, 10.940550399999665
644, 2.4150120864426565, 28.438205549403097, 34.15923535080485, 0.5957150500000004, 210.0, 866, 449639, 644, 25.618247999999767
645, 4.864725118707501, 28.391350641437604, 34.174106878392834, 0.5948663499999997, 280.0, 1020, 450659, 645, 30.840762100000575
646, 3.7144006233702713, 28.364825073132018, 34.14367263670002, 0.59415805, 120.0, 554, 451213, 646, 16.715969300000324
647, 3.2241022478965466, 28.29415521936403, 33.9939190469137, 0.5935950999999999, 310.0, 697, 451910, 647, 20.70171389999996
648, 3.8004331077519353, 28.414026731757332, 34.20445112014526, 0.5928881500000004, 190.0, 874, 452784, 648, 25.365801400000237
649, 4.315403813672937, 28.365323744517276, 34.13414854877288, 0.5922054999999999, 75.0, 643, 453427, 649, 19.44445629999973
650, 5.261285497284966, 28.425576245343244, 34.26051256862687, 0.5915516500000002, 155.0, 810, 454237, 650, 24.91811879999932
651, 5.467296173511614, 28.42810776668229, 34.21915323746028, 0.5908217499999999, 220.0, 812, 455049, 651, 25.27430380000078
652, 2.1308050246026955, 28.38994715841193, 34.08928231189125, 0.59028535, 65.0, 380, 455429, 652, 11.5930429
653, 2.2286641973965238, 28.352623330484523, 34.031473646069514, 0.5899325499999998, 90.0, 404, 455833, 653, 12.562442999999803
654, 3.9663107556486175, 28.46510378991518, 34.26464912754264, 0.5892656499999999, 335.0, 1078, 456911, 654, 30.942645099999936
655, 3.7699365545931744, 28.434256834526586, 34.25983653220956, 0.5883863500000001, 180.0, 876, 457787, 655, 26.480239299999994
656, 3.0029091107737838, 28.364369073621774, 34.126789751727436, 0.5876676999999996, 155.0, 721, 458508, 656, 21.74028929999986
657, 2.2199706468541343, 28.381084281168167, 34.14196054798782, 0.5870606500000001, 180.0, 628, 459136, 657, 19.018609200000355
658, 2.1149414377028015, 28.41561258862644, 34.164546067077566, 0.5864058999999997, 150.0, 827, 459963, 658, 25.366262599999573
659, 3.144804433407607, 28.429198495370372, 34.22808167634187, 0.5857300000000002, 95.0, 675, 460638, 659, 19.935554499999853
660, 3.636929997466923, 28.50356317584434, 34.30785327439897, 0.5850257499999997, 220.0, 890, 461528, 660, 25.99896170000011
661, 3.842830833064284, 28.504383686935494, 34.25462230449284, 0.5843233000000001, 175.0, 671, 462199, 661, 20.66331530000025
662, 4.168952200448513, 28.525524630737305, 34.33377900085449, 0.5837400999999999, 130.0, 625, 462824, 662, 19.238469500000065
663, 5.190751553000179, 28.640019620726484, 34.43359513416661, 0.5832504999999999, 95.0, 463, 463287, 663, 14.438619800000197
664, 3.0666771951752403, 28.539712613704157, 34.320869034411864, 0.58267495, 210.0, 816, 464103, 664, 28.48521339999934
665, 3.710819849002929, 28.52522895086379, 34.33085464840843, 0.5820714999999996, 95.0, 525, 464628, 665, 17.94726559999981
666, 2.456034025253823, 28.473397337940135, 34.17811052670032, 0.5815612000000001, 80.0, 609, 465237, 666, 19.375050499999816
667, 2.229318575019364, 28.48344088476787, 34.26284714696288, 0.5809442499999999, 245.0, 762, 465999, 667, 28.32589370000005
668, 2.449123684726246, 28.404258513188623, 34.167122594602816, 0.58043755, 55.0, 364, 466363, 668, 11.62948299999971
669, 5.67604346997977, 28.52064701372212, 34.366457383047624, 0.5801031999999998, 20.0, 379, 466742, 669, 11.537387899999885
670, 2.0999597517956228, 28.499020019352525, 34.273097771327635, 0.5796252999999999, 135.0, 683, 467425, 670, 20.47226850000061
671, 2.5686321267465932, 28.506364726311507, 34.28223136945956, 0.5787730000000004, 335.0, 1211, 468636, 671, 36.10962649999965
672, 3.741138057736995, 28.512250015482678, 34.364742197247715, 0.5778293499999995, 245.0, 886, 469522, 672, 24.857483700000557
673, 3.800120575673249, 28.69957921030736, 34.58568572998047, 0.5771003500000002, 170.0, 734, 470256, 673, 18.781196199999613
674, 6.3351175241738025, 29.179700836033735, 35.15456946562488, 0.5764914999999997, 85.0, 619, 470875, 674, 15.745732499999576
675, 4.149725933250537, 29.043682490187646, 34.987073595561675, 0.5757310000000002, 320.0, 1071, 471946, 675, 27.73962290000054
676, 4.267411856326312, 29.055112717917602, 34.97237317990034, 0.5749506999999996, 95.0, 663, 472609, 676, 21.36303350000071
677, 6.605589666960124, 29.109349145185227, 35.06929674724604, 0.5743841499999999, 195.0, 596, 473205, 677, 19.048474700000043
678, 3.292725838203922, 29.065175313029798, 34.933236914439455, 0.57385, 90.0, 591, 473796, 678, 17.74198030000025
679, 2.146826771210046, 28.95519300475525, 34.789411988540294, 0.5732339500000003, 185.0, 778, 474574, 679, 24.99888210000063
680, 3.330015500186611, 29.069138588878396, 34.968015164305264, 0.5725652499999999, 150.0, 708, 475282, 680, 23.434114200000295
681, 2.35156022718849, 29.05254112824761, 34.909065284072916, 0.5718803500000001, 115.0, 814, 476096, 681, 23.191738600000463
682, 4.303025457955232, 29.028245307088792, 34.95823189812565, 0.5709745000000002, 335.0, 1199, 477295, 682, 30.315739399999984
683, 4.395715994554669, 28.973479501524967, 34.85293563728902, 0.5702841999999998, 15.0, 335, 477630, 683, 8.777443900000435
684, 3.5120425362735985, 29.088722911834715, 34.99801398086548, 0.56990845, 75.0, 500, 478130, 684, 11.36472169999979
685, 3.6005061646272916, 29.105753211646462, 35.009912380878305, 0.569004399999999, 230.0, 1509, 479639, 685, 34.37115629999971
686, 3.7741383976070617, 28.868714866837905, 34.75244644591113, 0.5678096499999999, 460.0, 1146, 480785, 686, 26.03068970000004
687, 2.2967789720701903, 28.72811215472874, 34.53412679773598, 0.5670145000000001, 150.0, 621, 481406, 687, 14.31600729999991
688, 4.130767358902921, 28.72751061828731, 34.60779204636063, 0.5662697499999998, 300.0, 1034, 482440, 688, 23.6463619999995
689, 2.3385593520362438, 28.67559807624346, 34.45741161063865, 0.5654399499999998, 195.0, 810, 483250, 689, 18.812085699999443
690, 3.306149398543404, 28.67594892012693, 34.475910421206486, 0.5647789000000003, 55.0, 659, 483909, 690, 15.123191499999848
691, 7.164524945117879, 28.764051036867546, 34.735927529261154, 0.5639594499999998, 590.0, 1162, 485071, 691, 26.444913799999995
692, 2.1942141996738354, 28.729355568308467, 34.512615892384616, 0.5632358499999999, 45.0, 446, 485517, 692, 10.425352600000224
693, 4.474467975042156, 28.736577657751134, 34.59788728318773, 0.56253565, 390.0, 1110, 486627, 693, 27.637034100000164
694, 4.9774938190301645, 28.715151532182414, 34.63466953999788, 0.5618507499999997, 105.0, 412, 487039, 694, 10.478662800000166
695, 2.119723491712252, 28.612318115452982, 34.39454013638647, 0.5615083, 45.0, 349, 487388, 695, 8.986184800000046
696, 2.103137443126891, 28.681391407672624, 34.46352369265449, 0.5611716999999997, 25.0, 399, 487787, 696, 9.971631399999751
697, 4.898591910475839, 28.64483626906523, 34.485151978915106, 0.5607675999999999, 95.0, 499, 488286, 697, 12.983987399999933
698, 5.960491142977408, 28.735104880647032, 34.579883445998625, 0.5600921500000003, 235.0, 1002, 489288, 698, 25.009649900000113
699, 5.635499661928488, 28.81694657760182, 34.71685199241795, 0.5593123000000003, 195.0, 731, 490019, 699, 18.51860510000006
700, 4.794367610461889, 29.331050065255933, 35.33318673026177, 0.55876015, 35.0, 496, 490515, 700, 13.030011599999852
701, 2.8629265168411586, 29.289504754452306, 35.18538697220897, 0.5582421999999997, 135.0, 655, 491170, 701, 16.582181599999785
702, 5.139973117099547, 29.228759795469717, 35.210764867313216, 0.5576311000000002, 135.0, 703, 491873, 702, 17.81937150000067
703, 4.381071111071026, 29.309532516130567, 35.270617846553534, 0.5568031, 185.0, 1137, 493010, 703, 28.619360800000322
704, 3.529808807473033, 29.21683978828001, 35.14388245008725, 0.55587565, 220.0, 924, 493934, 704, 23.374856500000533
705, 2.2063584117911015, 29.255475591676834, 35.14138681002614, 0.5551619499999998, 205.0, 662, 494596, 705, 17.080789300000106
706, 2.3537640891408125, 29.289921979353014, 35.17772556311613, 0.5546071000000001, 110.0, 571, 495167, 706, 14.65583930000048
707, 3.7188463684707718, 29.274514118279743, 35.246256671931945, 0.5537656, 500.0, 1299, 496466, 707, 32.600422500000604
708, 5.495349134264653, 29.304497306997124, 35.25290941797997, 0.5527454499999997, 320.0, 968, 497434, 708, 25.485299699999814
709, 3.180046075032958, 29.31023889906863, 35.2448576582239, 0.5519926000000002, 180.0, 705, 498139, 709, 17.85996510000041
710, 2.2953811395174464, 29.273751897260176, 35.1651365106756, 0.55145755, 50.0, 484, 498623, 710, 12.439962799999194
711, 3.3006000665245696, 29.357484111687402, 35.33593724393599, 0.5509782999999999, 55.0, 581, 499204, 711, 14.944086200001038
712, 2.266290722457853, 29.225552970265124, 35.11885029548284, 0.5503465000000001, 190.0, 823, 500027, 712, 21.324772199999643
713, 7.031646007846399, 29.137322117554817, 35.178927421569824, 0.5496782499999996, 135.0, 662, 500689, 713, 16.98766550000073
714, 3.8434436475459615, 29.14351660695242, 35.03597706941823, 0.5491994499999998, 85.0, 402, 501091, 714, 10.493437400000403
715, 3.4318387799218217, 29.04254206348617, 34.89021515547696, 0.5485154500000001, 325.0, 1118, 502209, 715, 28.930345599999782
716, 2.1090468411108496, 28.936295934738293, 34.76625217849242, 0.5478579999999998, 60.0, 343, 502552, 716, 9.093636100000367
717, 4.98818096729382, 29.11412933083854, 35.06984353030887, 0.5473936, 95.0, 689, 503241, 717, 17.637455600000976
718, 4.668681523562232, 29.025372896660084, 34.96134393426436, 0.5468346999999998, 125.0, 553, 503794, 718, 14.438680999999633
719, 3.681115890341379, 29.025585786094258, 34.9115398075072, 0.5462083, 380.0, 839, 504633, 719, 22.010195700000622
720, 3.143376912600424, 29.04901559053499, 34.925032288151684, 0.5455332999999996, 105.0, 661, 505294, 720, 17.05341480000061
721, 5.614178071333604, 29.132990205938167, 35.05798977591775, 0.5449883499999999, 50.0, 550, 505844, 721, 14.284643900000447
722, 2.064070348917259, 29.00002100777491, 34.87931295168602, 0.5445815500000001, 15.0, 354, 506198, 722, 9.549768500000937
723, 3.077421615276314, 28.98026936080763, 34.855523289860905, 0.5441391999999997, 40.0, 629, 506827, 723, 16.46530619999976
724, 4.207220706887105, 29.07562437394086, 35.00212568619672, 0.5434736500000001, 335.0, 850, 507677, 724, 21.978357400001187
725, 3.9068776343512654, 29.093609061755036, 34.98181546242315, 0.5429115999999999, 45.0, 399, 508076, 725, 10.556589800000438
726, 2.995235903816461, 29.023742752504848, 34.89416093435003, 0.5421727000000003, 640.0, 1243, 509319, 726, 32.2816739000009
727, 3.35121250691497, 29.08261742934682, 34.993483645204364, 0.5414067999999997, 80.0, 459, 509778, 727, 12.184413300001324
728, 3.459734808818164, 29.070090232604, 34.9425927280901, 0.5409761500000001, 95.0, 498, 510276, 728, 13.135262399999192
729, 6.560398661674788, 29.2375225516466, 35.237334324763374, 0.5405648500000002, 25.0, 416, 510692, 729, 10.993094299999939
730, 3.26734573238067, 29.231125528606455, 35.17203096414904, 0.5400702999999998, 145.0, 683, 511375, 730, 18.295943699999043
731, 2.182526051083873, 29.11798911391597, 34.962540305141125, 0.5395172500000001, 90.0, 546, 511921, 731, 14.266934199999014
732, 2.066068327546652, 29.103177867616925, 34.98931361266545, 0.5390195500000001, 70.0, 560, 512481, 732, 14.726767299998755
733, 4.206323431755914, 29.193730695550364, 35.182450353536375, 0.5383386999999996, 245.0, 953, 513434, 733, 24.811373999998978
734, 4.548044623452109, 29.14449603462344, 35.05521076179909, 0.5372227000000005, 600.0, 1527, 514961, 734, 39.59913930000039
735, 4.121538555880653, 29.213588947632964, 35.173673001158164, 0.5360972500000001, 305.0, 974, 515935, 735, 25.585298100000728
736, 3.4847374330119196, 29.16163094484461, 35.09442258040464, 0.5354569, 65.0, 449, 516384, 736, 12.107379899998705
737, 3.33420996990274, 29.140395904989802, 35.08884771758435, 0.5350253500000001, 55.0, 510, 516894, 737, 13.674210700000913
738, 4.347268139378619, 29.217116848269203, 35.17385946240341, 0.5344367499999999, 265.0, 798, 517692, 738, 21.315320800000336
739, 2.8583236522972584, 29.14444492151449, 35.04582401422354, 0.5337500500000002, 165.0, 728, 518420, 739, 19.82392760000039
740, 4.961763879903189, 29.22792460524191, 35.25787436417707, 0.5331366999999998, 70.0, 635, 519055, 740, 16.928526699999566
741, 3.423602750170089, 29.15506600576734, 35.11364131503635, 0.5326241499999999, 160.0, 504, 519559, 741, 13.558590200000253
742, 3.37549042931458, 29.209006054437953, 35.16849805061821, 0.5321332000000001, 55.0, 587, 520146, 742, 15.688063499999771
743, 3.5343699025587725, 29.40310180847423, 35.409150455438976, 0.5314383999999995, 215.0, 957, 521103, 743, 25.656095899999855
744, 4.140947473299897, 29.471623080480086, 35.45561841247689, 0.5305852000000001, 155.0, 939, 522042, 744, 24.9782309000002
745, 2.291842609901256, 29.38582589525256, 35.30623735999762, 0.5298759999999998, 125.0, 637, 522679, 745, 16.988919199999145
746, 3.441223315014853, 29.471914813262245, 35.43058980016056, 0.5290367500000004, 415.0, 1228, 523907, 746, 32.46376329999839
747, 6.710205058014746, 29.47274560174026, 35.50750008006554, 0.5281655500000002, 120.0, 708, 524615, 747, 19.03957470000023
748, 3.541559248688115, 29.432831389635737, 35.35561363155421, 0.527635, 70.0, 471, 525086, 748, 13.054240700001174
749, 3.1757349195338516, 29.490858397543917, 35.45848071902129, 0.5268159999999994, 400.0, 1349, 526435, 749, 35.64476409999952
750, 3.9509990330771054, 29.452229399884658, 35.43220740363947, 0.5258610999999995, 70.0, 773, 527208, 750, 20.99016429999938
751, 4.181040291519214, 29.45739628871282, 35.44428414106369, 0.52534045, 30.0, 384, 527592, 751, 10.576603600000453
752, 3.841352536694871, 29.448949315812854, 35.39485339588589, 0.52500565, 85.0, 360, 527952, 752, 9.96211620000031
753, 6.572176473724306, 29.540277507655233, 35.61535375907874, 0.5244237999999996, 310.0, 933, 528885, 753, 24.997434700000667
754, 2.498916052202595, 29.51803870911294, 35.41765252580034, 0.5238347499999998, 65.0, 376, 529261, 754, 10.43208550000054
755, 4.123080347594735, 29.369941545320344, 35.37855697608925, 0.5232159999999998, 345.0, 999, 530260, 755, 27.021160599999348
756, 3.194552655374289, 29.342448623736804, 35.28402720902703, 0.5224213000000002, 260.0, 767, 531027, 756, 20.77958050000052
757, 4.18632478916645, 29.394522201538084, 35.34473005676269, 0.5219073999999999, 20.0, 375, 531402, 757, 10.533860800000184
758, 2.0670177383840262, 29.269218702344585, 35.20834644611936, 0.5214353499999997, 105.0, 674, 532076, 758, 18.360853700000007
759, 3.6895833557749436, 29.50693694769899, 35.5152635271217, 0.520948, 45.0, 409, 532485, 759, 11.416333299999678
760, 2.3911162735827, 29.400727016954537, 35.329964722782734, 0.5205772, 65.0, 415, 532900, 760, 11.432219199999963
761, 2.2638155010380867, 29.381713989649693, 35.30310869599613, 0.5201100999999998, 185.0, 623, 533523, 761, 17.008346900000106
762, 2.177222564816475, 29.306605154817756, 35.25591051578522, 0.5196713499999999, 50.0, 352, 533875, 762, 10.01932300000044
763, 7.2584929964995935, 29.54764340653211, 35.6399516961262, 0.5193379, 65.0, 389, 534264, 763, 10.930438900000809
764, 3.182347572160348, 29.383273172443065, 35.340612026932114, 0.5188302999999996, 140.0, 739, 535003, 764, 20.079823100000795
765, 2.361585546005106, 29.322125602014285, 35.215250560215544, 0.5181922, 135.0, 679, 535682, 765, 18.606696699998793
766, 4.433119230011617, 29.399955532447805, 35.36631980510105, 0.5174595999999996, 105.0, 949, 536631, 766, 25.843885500000397
767, 4.342562065335136, 29.40006790096091, 35.37965139403673, 0.5165046999999999, 285.0, 1173, 537804, 767, 31.73788450000029
768, 6.878981893367572, 29.357627349141044, 35.34866062119777, 0.5157455499999999, 45.0, 514, 538318, 768, 14.531193600001643
769, 3.519455803081254, 29.340964333364898, 35.28977272889325, 0.5152735, 180.0, 535, 538853, 769, 14.859762600000977
770, 1.977791297781248, 29.288274653425454, 35.18515513286818, 0.5146173999999996, 565.0, 923, 539776, 770, 25.486045199999353
771, 4.332766967714497, 29.532099490979046, 35.53155898835215, 0.5137984, 335.0, 897, 540673, 771, 24.54443159999937
772, 2.0218375296546864, 29.54336283399285, 35.51520744452557, 0.5131548999999999, 105.0, 533, 541206, 772, 14.855458800000633
773, 2.1673247182897746, 29.509853593234357, 35.4389711812212, 0.51273235, 85.0, 406, 541612, 773, 11.46975190000012
774, 3.115709320078179, 29.6597901051092, 35.682941182587854, 0.5121208, 200.0, 953, 542565, 774, 26.29391129999931
775, 7.118783987686923, 29.745452074426936, 35.86603130240905, 0.5115025000000001, 10.0, 421, 542986, 775, 11.871274399998583
776, 4.156560577492587, 29.656867933376752, 35.67482650409293, 0.51089815, 435.0, 922, 543908, 776, 25.65435830000024
777, 4.528552807224471, 29.703846988223848, 35.726772898719425, 0.5103320499999998, 25.0, 336, 544244, 777, 9.608595400000922
778, 4.132314195156271, 29.675325426896183, 35.72168512164422, 0.5098708000000002, 240.0, 689, 544933, 778, 19.15432569999939
779, 3.0042641097131897, 29.619610183037164, 35.591315251682886, 0.5092471, 155.0, 697, 545630, 779, 19.41618229999949
780, 2.106434490965664, 29.577081127468936, 35.536678463526115, 0.5084506000000004, 400.0, 1073, 546703, 780, 29.608446499998536
781, 2.413616699459105, 29.66475669227352, 35.65095085185357, 0.5077184499999998, 100.0, 554, 547257, 781, 15.545513299999584
782, 3.413443274143196, 29.47055447533017, 35.44009367806571, 0.5072329, 50.0, 525, 547782, 782, 14.795484899999792
783, 2.2971348073638853, 29.595039649087873, 35.55096723212571, 0.5068319500000003, 55.0, 366, 548148, 783, 10.386400400000639
784, 3.938684488143617, 29.590993437410393, 35.62455748455016, 0.5065048, 55.0, 361, 548509, 784, 10.327791300000172
785, 4.322703300953469, 29.672582266297244, 35.746621398211644, 0.5060538999999996, 120.0, 641, 549150, 785, 17.709668800000145
786, 4.94805374297364, 29.636109560771835, 35.70564420142713, 0.5054590000000002, 200.0, 681, 549831, 786, 19.004489199998716
787, 3.4998149963557945, 29.656796760128852, 35.661277211698376, 0.5049131499999999, 105.0, 532, 550363, 787, 15.033158500000354
788, 3.146427724075139, 29.741217387759168, 35.757690082425654, 0.5043425500000002, 215.0, 736, 551099, 788, 21.989981400000033
789, 3.5810013344524516, 29.802890072600768, 35.84779122217428, 0.5034367000000002, 470.0, 1277, 552376, 789, 35.914533799999845
790, 3.923171998195806, 29.843139657962336, 35.88949269212587, 0.5025016, 175.0, 801, 553177, 790, 22.772919700000784
791, 4.559908886384364, 29.881235685125187, 35.99064723905644, 0.5016222999999996, 410.0, 1153, 554330, 791, 32.35709979999956
792, 5.320186381547002, 29.848277911917, 35.93950000947624, 0.5008339, 95.0, 599, 554929, 792, 17.29928259999906
793, 4.006003277475724, 29.90680855618677, 35.96856618351784, 0.5000585500000004, 220.0, 1124, 556053, 793, 31.91115600000012
794, 2.0673781353795215, 29.80020601294982, 35.80947869256906, 0.4990545999999995, 260.0, 1107, 557160, 794, 31.185885599999892
795, 4.058892531485954, 29.863738680887298, 35.98197913593545, 0.49827790000000016, 90.0, 619, 557779, 795, 17.88640409999971
796, 2.7210513077343683, 29.784953904151916, 35.81387854984828, 0.4974953499999999, 320.0, 1120, 558899, 796, 32.060161499999595
797, 3.8398631760159905, 29.933281467737775, 36.0210796934835, 0.4965908499999999, 325.0, 890, 559789, 797, 25.87314409999999
798, 3.4423240443237013, 29.708687862618696, 35.73213434322349, 0.49577365000000023, 315.0, 926, 560715, 798, 26.68662890000087
799, 3.7030132791631662, 29.648449307152795, 35.71079994590289, 0.49518910000000005, 30.0, 373, 561088, 799, 10.96627289999924
800, 2.2517147774376522, 29.50783714356461, 35.47720282019638, 0.4947444999999999, 175.0, 615, 561703, 800, 17.7803985999999
801, 3.500103029431051, 29.599288553431414, 35.60094177738637, 0.4937846499999999, 575.0, 1518, 563221, 801, 42.89487040000131
802, 4.588703514899312, 29.66945636540196, 35.73830106380493, 0.4926007000000001, 495.0, 1113, 564334, 802, 32.044945100000405
803, 2.1690303112550007, 29.667833918365986, 35.63098596077597, 0.49193695000000004, 30.0, 362, 564696, 803, 10.617752699999983
804, 4.839622281015008, 29.762472433703287, 35.81865177268074, 0.49147165, 185.0, 672, 565368, 804, 19.42179120000037
805, 2.040047712057181, 29.56525747955081, 35.54065615574833, 0.4907138499999996, 255.0, 1012, 566380, 805, 28.94186719999925
806, 1.7759811710653186, 29.614135659130326, 35.632504719783135, 0.4899690999999999, 165.0, 643, 567023, 806, 18.72226060000139
807, 4.796790407772946, 29.710263486115828, 35.76824500042459, 0.4891622499999997, 300.0, 1150, 568173, 807, 33.10862249999991
808, 4.452722898027, 29.661266566153603, 35.720091134579754, 0.4879989999999996, 360.0, 1435, 569608, 808, 41.27758039999935
809, 3.756960096862718, 29.824057430064183, 35.88038602524255, 0.48659275000000046, 830.0, 1690, 571298, 809, 50.12799470000027
810, 4.310794516008789, 29.89037041451053, 35.9428935352202, 0.4855402000000001, 75.0, 649, 571947, 810, 22.336933700000372
811, 3.4767276598069503, 29.989239504865107, 36.07688241332542, 0.4849533999999999, 110.0, 655, 572602, 811, 22.984512400000312
812, 2.1195227547868853, 29.893581215292215, 35.90950134024024, 0.4844282499999999, 110.0, 512, 573114, 812, 15.932773100001214
813, 3.2128191223754103, 29.859311923317037, 35.90819459531383, 0.4836029499999999, 580.0, 1322, 574436, 813, 39.97004610000113
814, 4.119711070645893, 29.954488234573535, 36.0310638031263, 0.4828478500000001, 50.0, 356, 574792, 814, 11.217027300001064
815, 2.7942167017590047, 29.795854697695155, 35.82330931498621, 0.4822425999999996, 355.0, 989, 575781, 815, 30.62354310000046
816, 4.98832072467113, 29.984153687686664, 36.12968424724357, 0.48139615, 200.0, 892, 576673, 816, 27.24673989999974
817, 6.939524251489324, 29.994832840411117, 36.17006552729625, 0.48076345000000015, 95.0, 514, 577187, 817, 16.734863400000904
818, 4.7348871615533605, 29.934390414051894, 36.03471597229562, 0.4802369499999999, 105.0, 656, 577843, 818, 23.99270350000006
819, 3.4574736588430115, 29.99028039172413, 36.12910523065707, 0.4797203499999999, 40.0, 492, 578335, 819, 15.505205899999055
820, 3.6165829616072385, 29.87939679933631, 35.92770414352417, 0.4792919500000001, 45.0, 460, 578795, 820, 14.077791799998522
821, 4.5386193435869275, 29.94048159831279, 36.06191233594445, 0.47861875000000004, 315.0, 1036, 579831, 821, 31.934722600000896
822, 1.994935893944387, 30.06379905377088, 36.13697472987712, 0.4778766999999999, 125.0, 613, 580444, 822, 19.427130000000034
823, 2.9723630815674933, 30.196177796050385, 36.28391244750479, 0.47721474999999997, 315.0, 858, 581302, 823, 27.335186700000122
824, 3.8046690393323543, 30.171159399041223, 36.32233124297129, 0.47662974999999996, 90.0, 442, 581744, 824, 13.913952400000198
825, 3.099405667840827, 30.218768326649673, 36.32394362259466, 0.4761217000000001, 165.0, 687, 582431, 825, 21.52606559999913
826, 4.856922131067118, 30.261921882629395, 36.44693932352187, 0.47524374999999996, 395.0, 1264, 583695, 826, 39.22019200000068
827, 3.0692756811086728, 30.258604963454243, 36.38992882572956, 0.4742447500000001, 200.0, 956, 584651, 827, 29.811480099999244
828, 4.553949820377478, 30.130704614592762, 36.24130266468699, 0.47344555000000027, 80.0, 820, 585471, 828, 25.81482270000015
829, 2.3678443904468733, 30.241470705910665, 36.37330253247669, 0.4729113999999999, 85.0, 367, 585838, 829, 11.741549000000305
830, 4.089165640308669, 30.218441545963287, 36.365496120954816, 0.4724726499999996, 65.0, 608, 586446, 830, 19.054461399999127
831, 3.651775451891212, 30.283757155487027, 36.44545633170581, 0.4717801000000001, 250.0, 931, 587377, 831, 29.915003300000535
832, 3.564076057960063, 30.28222028206675, 36.43362408809648, 0.4707585999999994, 500.0, 1339, 588716, 832, 41.64176810000026
833, 4.890116560743256, 30.20026984611341, 36.400314493546865, 0.4697123499999997, 310.0, 986, 589702, 833, 31.246685899999648
834, 4.5464742884906855, 30.395014204545454, 36.59796292669123, 0.46864989999999995, 565.0, 1375, 591077, 834, 43.24697269999888
835, 6.513952336823031, 30.528271910932904, 36.762103423360344, 0.4677418000000001, 110.0, 643, 591720, 835, 22.219908600000053
836, 1.9980542068710414, 30.498293155577123, 36.61241888999939, 0.46730485000000005, 40.0, 328, 592048, 836, 12.659889500000645
837, 4.007448339420274, 30.46164473298749, 36.65695976857262, 0.4668539499999997, 110.0, 674, 592722, 837, 26.92982529999972
838, 5.177803317830839, 30.544221371063305, 36.7251218018543, 0.4661663500000001, 105.0, 854, 593576, 838, 29.922267399999328
839, 4.368895123653502, 30.48449727703381, 36.63683365948627, 0.46547064999999976, 105.0, 692, 594268, 839, 22.226488000000245
840, 3.1735599569757196, 30.513414755989523, 36.71368799209595, 0.46485325, 185.0, 680, 594948, 840, 23.033934600000066
841, 5.698924650952871, 30.46163992403712, 36.69960425016506, 0.46437219999999996, 70.0, 389, 595337, 841, 13.062959700000647
842, 3.7390252599349387, 30.369403090843786, 36.516931162125026, 0.4640216499999998, 75.0, 390, 595727, 842, 13.129691599999205
843, 3.3735689358890166, 30.46475611543569, 36.59173983389387, 0.46359729999999993, 145.0, 553, 596280, 843, 18.33556630000021
844, 4.313792109059165, 30.48170242193622, 36.67103827108366, 0.46320040000000007, 35.0, 329, 596609, 844, 11.051110599999447
845, 4.766470593002499, 30.486232582648196, 36.70816969991329, 0.4626941499999998, 245.0, 796, 597405, 845, 26.053927400000248
846, 5.709705351734733, 30.455254649216275, 36.6817272969012, 0.4617635500000003, 455.0, 1272, 598677, 846, 42.377007799999774
847, 3.288796032029748, 30.39293147788063, 36.58515536672309, 0.4609058500000002, 125.0, 634, 599311, 847, 21.42187449999983
848, 3.27314552257424, 30.4453003431274, 36.578726573798896, 0.46036045000000014, 170.0, 578, 599889, 848, 19.67440220000026
849, 2.082963197665426, 30.707303674706132, 36.89031154665596, 0.4598924499999998, 55.0, 462, 600351, 849, 16.06660759999977
850, 4.201331044644776, 30.90496655774735, 37.192913388885295, 0.45921610000000024, 370.0, 1041, 601392, 850, 35.320470799999384
851, 5.034287979905835, 30.849861403790914, 37.16425940176336, 0.4584524499999998, 115.0, 656, 602048, 851, 19.56607769999937
852, 3.221637136949145, 30.698207314532738, 36.916494784147844, 0.4578985, 35.0, 575, 602623, 852, 16.783228899999813
853, 3.590221818188826, 30.818979085286458, 37.07519816080729, 0.45720099999999986, 245.0, 975, 603598, 853, 28.690271499999653
854, 4.759348955608778, 30.86687421683435, 37.16100976161665, 0.4562038000000002, 440.0, 1241, 604839, 854, 36.04946829999972
855, 3.0293526869419094, 30.85656391345054, 37.075840476605535, 0.45527005000000026, 215.0, 834, 605673, 855, 24.277698600000804
856, 3.577065605599925, 30.850224340986657, 37.05817035059259, 0.45468010000000014, 100.0, 477, 606150, 856, 14.183996400000979
857, 3.043224604790275, 30.895237084981556, 37.11618416502669, 0.4541324499999996, 120.0, 740, 606890, 857, 21.648249300000316
858, 2.193966938362474, 30.68787354659251, 36.90962666897313, 0.45336114999999994, 490.0, 974, 607864, 858, 29.46073660000002
859, 5.280972036378533, 30.862209623704576, 37.163113215579045, 0.45252144999999994, 180.0, 892, 608756, 859, 27.608748900000137
860, 2.4044314216416662, 31.022923242927778, 37.26689619593101, 0.45193825000000004, 25.0, 404, 609160, 860, 12.812815499999488
861, 4.482120720324236, 30.921407980634676, 37.247583244020575, 0.4514846499999999, 165.0, 604, 609764, 861, 19.10874039999908
862, 7.99439510849816, 31.106598856151756, 37.46727920465449, 0.4510072, 115.0, 457, 610221, 862, 14.412918599999102
863, 3.957864747593733, 31.32268743113876, 37.65284497378801, 0.45046990000000015, 175.0, 737, 610958, 863, 23.086281900001268
864, 5.035054772040295, 31.364211830683324, 37.76896590159276, 0.44951995000000006, 410.0, 1374, 612332, 864, 42.8661301000011
865, 5.04388327319371, 31.319351858841745, 37.690983906796106, 0.4484741499999995, 230.0, 950, 613282, 865, 29.61514940000052
866, 3.1136427668612554, 31.297525865658976, 37.63568167318283, 0.4478077, 95.0, 531, 613813, 866, 16.886226599999645
867, 3.2877712258374068, 31.31671401280076, 37.65849830855185, 0.4473275499999999, 35.0, 536, 614349, 867, 16.80317079999986
868, 3.2770376734234192, 31.355871801118592, 37.69898209442963, 0.44675335000000016, 145.0, 740, 615089, 868, 23.275166100000206
869, 3.9445855165548744, 31.29432908474411, 37.5823013242437, 0.4462574500000001, 55.0, 362, 615451, 869, 11.741326700001082
870, 3.3245871869429036, 31.406303000936703, 37.79078609700105, 0.44587404999999986, 50.0, 490, 615941, 870, 15.7504785000001
871, 2.926883754869433, 31.37106119457044, 37.744535938062164, 0.4453115500000002, 125.0, 760, 616701, 871, 23.779243099999803
872, 2.324444793155405, 31.339111289930283, 37.66483006578811, 0.4446099999999999, 340.0, 799, 617500, 872, 25.818546700000297
873, 5.469766193453004, 31.425321214339313, 37.79878394743975, 0.44406684999999985, 70.0, 408, 617908, 873, 13.053694399999586
874, 5.270433037023166, 31.470151387288897, 37.95696397313101, 0.44358265, 145.0, 668, 618576, 874, 21.081255499999315
875, 5.1506286505808205, 31.30078296864595, 37.62652769045199, 0.4429863999999999, 100.0, 657, 619233, 875, 21.140232900001138
876, 4.460186632908359, 31.421387317133885, 37.756202281022276, 0.4425301, 25.0, 357, 619590, 876, 11.48058989999845
877, 3.943282875720234, 31.329146535623643, 37.67506345680782, 0.4420670500000001, 80.0, 672, 620262, 877, 21.40806370000064
878, 2.023279989259926, 31.15661177323691, 37.40574840564824, 0.44158554999999977, 65.0, 398, 620660, 878, 12.77530470000056
879, 5.458663357009769, 31.367128666316237, 37.76921685239608, 0.44111754999999986, 85.0, 642, 621302, 879, 20.721929200000886
880, 4.43573934391454, 31.412899538377307, 37.78460474096801, 0.4404646, 220.0, 809, 622111, 880, 25.66575069999999
881, 3.3507993479904075, 31.349672017953335, 37.69718682154631, 0.4395389500000002, 320.0, 1248, 623359, 881, 39.32140040000013
882, 3.6755307310812673, 31.381810829020214, 37.731202348023885, 0.43839864999999995, 540.0, 1286, 624645, 882, 40.838159599999926
883, 5.661544502424774, 31.380657029677067, 37.752737920819925, 0.43730919999999956, 295.0, 1135, 625780, 883, 36.00972980000006
884, 4.188510615559787, 31.39520711521972, 37.7325421481147, 0.4365023500000001, 105.0, 658, 626438, 884, 21.194519200000286
885, 4.2509238540746, 31.3417233067076, 37.73643738839425, 0.4359240999999998, 145.0, 627, 627065, 885, 20.216648300000088
886, 4.373827232180331, 31.38026353495569, 37.73235321346241, 0.43535709999999994, 120.0, 633, 627698, 886, 20.482955299999958
887, 7.10234454345838, 31.414143275000587, 37.854841094711716, 0.4347540999999999, 115.0, 707, 628405, 887, 22.801071500000035
888, 3.6471739418220106, 31.384727691802407, 37.735345728816014, 0.4340746000000002, 210.0, 803, 629208, 888, 25.826356400000805
889, 7.1265713347506425, 31.336680480412074, 37.825327040657164, 0.43348645, 50.0, 504, 629712, 889, 16.710086500001125
890, 3.5361784973257295, 31.460880976496515, 37.83573904913825, 0.4328434, 215.0, 925, 630637, 890, 29.753957800001444
891, 4.110743403944379, 31.53614698715063, 37.9413076338281, 0.43196005, 250.0, 1038, 631675, 891, 33.22820759999922
892, 4.042840564336914, 31.60630177784633, 38.01731352706056, 0.43097815000000017, 380.0, 1144, 632819, 892, 37.17094850000103
893, 7.136018546198883, 31.66925966328588, 38.2451742285845, 0.4301762499999999, 25.0, 638, 633457, 893, 20.760513399998672
894, 2.137681663565382, 31.41435472311588, 37.76088857556706, 0.4296609999999998, 5.0, 507, 633964, 894, 16.66012799999953
895, 3.0777818409025817, 31.646499701741288, 38.0216994344163, 0.42906654999999977, 185.0, 814, 634778, 895, 26.33509409999897
896, 2.917422558035771, 31.600905638474686, 37.98287330992257, 0.42826735000000016, 230.0, 962, 635740, 896, 30.996947899999213
897, 3.4555020936495895, 31.706869956139442, 38.12061650888784, 0.42738399999999965, 230.0, 1001, 636741, 897, 32.53362399999969
898, 2.3834108756105437, 31.603732003809505, 37.97689814587352, 0.42639129999999986, 385.0, 1205, 637946, 898, 39.43788769999992
899, 5.401058003375858, 31.578625956893244, 37.973195994094816, 0.42565600000000003, 20.0, 429, 638375, 899, 14.123117999999522
900, 3.49863720025245, 31.541858487603026, 37.95244581452384, 0.4252501000000002, 50.0, 473, 638848, 900, 15.622952199999418
901, 2.2363710636725656, 31.596262492206556, 37.98867663859619, 0.42473169999999977, 155.0, 679, 639527, 901, 22.370988800001214
902, 2.328503428423743, 31.14731260535683, 37.413312004739325, 0.4239824500000001, 160.0, 986, 640513, 902, 32.07191899999998
903, 5.957299220117287, 30.94328439422927, 37.2755716533561, 0.42336684999999996, 15.0, 382, 640895, 903, 12.666204600000128
904, 3.129346049397376, 30.91022092843702, 37.137821148533625, 0.4228795000000002, 175.0, 701, 641596, 904, 22.99725579999904
905, 2.594369150707918, 30.934872976710484, 37.17187958461331, 0.4218751000000001, 310.0, 1531, 643127, 905, 49.510564400001385
906, 4.35909802116835, 30.995280196347576, 37.30983247907143, 0.42072894999999993, 425.0, 1016, 644143, 906, 33.303281600001355
907, 6.462815166968052, 31.006666873325813, 37.34516755219932, 0.41979025000000014, 520.0, 1070, 645213, 907, 35.11956849999842
908, 3.6336051890925973, 30.947795867919922, 37.15993801586812, 0.4190931999999998, 50.0, 479, 645692, 908, 16.049242500001128
909, 3.862512378342805, 30.967276536946155, 37.209811211403284, 0.4183210000000001, 310.0, 1237, 646929, 909, 40.648036700000375
910, 2.100276490190515, 30.922817023731024, 37.12449144434046, 0.41744844999999986, 130.0, 702, 647631, 910, 23.49252610000076
911, 5.384540294516174, 31.03189859904495, 37.383402380288814, 0.41676535, 280.0, 816, 648447, 911, 27.37108939999962
912, 2.1486256783477433, 30.908900608078707, 37.135725039318515, 0.41596794999999986, 315.0, 956, 649403, 912, 31.71589590000076
913, 5.749698766590477, 31.005413260059804, 37.326277983401795, 0.4152106000000001, 420.0, 727, 650130, 913, 24.123841700000412
914, 3.336728367461608, 30.916806787344125, 37.120436920752894, 0.41459095, 160.0, 650, 650780, 914, 22.58214550000048
915, 7.875952788012128, 31.112727323720154, 37.641949967935055, 0.41413869999999986, 45.0, 355, 651135, 915, 13.272035599999072
916, 3.676268221483781, 31.029924026880508, 37.328105703500604, 0.41354019999999975, 145.0, 975, 652110, 916, 48.051474199999575
917, 5.908947956287998, 30.990971521399487, 37.331422871556775, 0.41278824999999997, 155.0, 696, 652806, 917, 38.281347399999504
918, 6.974099100646514, 31.073302568870577, 37.41089366622902, 0.4121730999999998, 90.0, 671, 653477, 918, 34.457859400001325
919, 3.0025508275645674, 30.995425677229168, 37.24123366251808, 0.41156604999999996, 185.0, 678, 654155, 919, 32.370429700000386
920, 5.070898684727322, 31.014248858260284, 37.30771220888999, 0.4110526, 60.0, 463, 654618, 920, 22.073742200000197
921, 2.2929257522869566, 31.056969199552725, 37.265532649363884, 0.4103483499999999, 320.0, 1102, 655720, 921, 55.59370709999894
922, 2.3234832411408424, 30.895264595031737, 37.13793821716309, 0.40962745000000006, 130.0, 500, 656220, 922, 21.984574000000066
923, 5.364224893399329, 31.114479242101652, 37.43819607871577, 0.40902939999999977, 225.0, 829, 657049, 923, 36.03821059999973
924, 3.3235933162246973, 31.00949987629116, 37.31827067368783, 0.40838815000000006, 55.0, 596, 657645, 924, 25.8136386999995
925, 3.6445692533173655, 31.068233840766993, 37.32983584588349, 0.40768929999999953, 205.0, 957, 658602, 925, 41.83854490000158
926, 5.610537349287861, 31.140098503917418, 37.48524542472868, 0.4069045, 130.0, 787, 659389, 926, 33.81829330000073
927, 4.892985799337955, 31.016472869223737, 37.31138047563269, 0.4063388499999998, 50.0, 470, 659859, 927, 21.62562910000088
928, 3.123963638888986, 31.32475792794982, 37.6472197197178, 0.40560670000000004, 510.0, 1157, 661016, 928, 56.96285450000141
929, 5.85705149013334, 31.376877095881564, 37.78307059253806, 0.40479760000000004, 140.0, 641, 661657, 929, 29.135092700000314
930, 5.333764915593153, 31.47293650887229, 37.88372135004722, 0.4039646499999999, 545.0, 1210, 662867, 930, 53.56731370000125
931, 4.02743945766071, 31.433269516988233, 37.771208156238906, 0.40326175000000003, 80.0, 352, 663219, 931, 14.772579299999052
932, 3.1934264433423905, 31.411515822355774, 37.72320030658181, 0.40263354999999995, 560.0, 1044, 664263, 932, 44.22962069999994
933, 3.2384537187157365, 31.31847864163073, 37.69750254063667, 0.40187935, 100.0, 632, 664895, 933, 32.441712100000586
934, 2.2179303544449107, 31.517771180367237, 37.83700765926597, 0.40131865000000017, 95.0, 614, 665509, 934, 30.222733299999163
935, 5.340937359445689, 31.405543085490688, 37.8005039878249, 0.40076019999999984, 95.0, 627, 666136, 935, 30.06771470000058
936, 2.4047298501763077, 31.333511929453156, 37.661800282482254, 0.40025934999999996, 85.0, 486, 666622, 936, 23.460958099998606
937, 3.822716674586057, 31.559233038986005, 37.92637719732721, 0.39959469999999986, 365.0, 991, 667613, 937, 47.92767710000044
938, 2.5182582707153673, 31.39111713425843, 37.708156046600564, 0.3988350999999999, 160.0, 697, 668310, 938, 33.49536359999911
939, 2.10678664751743, 31.376431663133946, 37.717450760958485, 0.3982136499999999, 95.0, 684, 668994, 939, 31.08905169999889
940, 6.0093813320191165, 31.433247635045003, 37.85175967321831, 0.39760029999999996, 375.0, 679, 669673, 940, 31.91942949999975
941, 3.727807693472765, 31.45841452218954, 37.83712644715911, 0.39692395, 160.0, 824, 670497, 941, 40.44585459999871
942, 2.1598110407946427, 31.49538867644271, 37.831497966079546, 0.39634570000000013, 120.0, 461, 670958, 942, 22.642463500000304
943, 4.168617819746335, 31.517989621154882, 37.90723977081395, 0.3955685499999999, 325.0, 1266, 672224, 943, 58.559518600000956
944, 4.577572342020513, 31.63994889160754, 38.050992307777115, 0.3945853000000002, 435.0, 919, 673143, 944, 42.960947799998394
945, 4.597463866052985, 31.454300633005293, 37.83942535121735, 0.3938144499999997, 185.0, 794, 673937, 945, 36.98334999999861
946, 2.449442661196745, 31.606794687479486, 37.944045738412555, 0.39318939999999986, 40.0, 595, 674532, 946, 28.83150729999943
947, 4.828892648692888, 31.506404381531937, 37.928699926229626, 0.39268765, 85.0, 520, 675052, 947, 28.26407720000134
948, 2.1877831506751093, 31.70976211866524, 38.10939344551405, 0.39227049999999986, 50.0, 407, 675459, 948, 18.730430600000545
949, 6.850827960772686, 31.581566198130858, 38.040615361457, 0.39178045, 195.0, 682, 676141, 949, 36.502646100001584
950, 4.676657115565243, 31.57429325558062, 37.961576544720195, 0.39123549999999996, 50.0, 529, 676670, 950, 24.760573800000202
951, 2.506638365288301, 31.478578414706234, 37.77095887937598, 0.39083455, 75.0, 362, 677032, 951, 16.824778799998967
952, 3.335589301287201, 31.453734782027606, 37.78347259212986, 0.39038229999999985, 130.0, 643, 677675, 952, 30.067648599999302
953, 4.395046947181553, 31.437186304260702, 37.82137865879957, 0.38984815, 60.0, 544, 678219, 953, 24.21295470000041
954, 2.5213958425481966, 31.55329917000129, 37.913695874267354, 0.3893612500000001, 25.0, 538, 678757, 954, 25.21819460000006
955, 3.9948942709167388, 31.576392219553924, 37.99589063437714, 0.3887910999999999, 85.0, 729, 679486, 955, 34.599047800000335
956, 3.5927235177334618, 31.59593349531585, 38.00899858661727, 0.38823354999999987, 10.0, 510, 679996, 956, 25.05592340000112
957, 3.7511586917778943, 31.38759342144754, 37.733522546166455, 0.38761750000000017, 245.0, 859, 680855, 957, 40.93819690000055
958, 4.526523322812261, 31.40790827074765, 37.76321052685708, 0.3867201999999997, 380.0, 1135, 681990, 958, 52.642005300000164
959, 2.5040747447514238, 31.43142967224121, 37.75099530632113, 0.38602719999999985, 70.0, 405, 682395, 959, 19.401132900000448
960, 2.4717844499683173, 31.3690545770972, 37.67931863284163, 0.3854300499999998, 235.0, 922, 683317, 960, 43.71846900000128
961, 2.668490126440788, 31.454819839743166, 37.79500365487842, 0.38478249999999986, 125.0, 517, 683834, 961, 25.00982120000117
962, 5.056146764887892, 31.38431571107922, 37.78052099184556, 0.38431224999999997, 155.0, 528, 684362, 962, 25.393122100000255
963, 4.822520844069656, 31.52161119249132, 37.94396943539237, 0.3836089, 215.0, 1035, 685397, 963, 49.56460089999928
964, 5.778657932675909, 31.464501802640655, 37.83015829836703, 0.3827187999999999, 185.0, 943, 686340, 964, 43.905488700000205
965, 2.7341104926802293, 31.47860575756848, 37.82594353489622, 0.38183815000000004, 305.0, 1014, 687354, 965, 39.135443200000736
966, 3.120319222336141, 31.38924973058039, 37.72713749804054, 0.3807657999999999, 470.0, 1369, 688723, 966, 62.08820240000023
967, 3.49164386351977, 31.524811709293758, 37.91815469525399, 0.3797253999999997, 295.0, 943, 689666, 967, 45.32707639999899
968, 3.1538807295393174, 31.666478694849026, 38.056524417923406, 0.37896669999999993, 185.0, 743, 690409, 968, 35.6259218999985
969, 3.494303380976499, 31.732821216052887, 38.167197733288816, 0.37819539999999957, 340.0, 971, 691380, 969, 46.859152600000016
970, 2.149226675502865, 31.779930420038177, 38.1495630450365, 0.3774632500000001, 165.0, 656, 692036, 970, 31.850640299999213
971, 5.486859370155011, 31.726766353517068, 38.186540596128445, 0.37671084999999976, 320.0, 1016, 693052, 971, 48.810959800001
972, 3.063712276478976, 31.770400058640515, 38.16986386338187, 0.37591300000000016, 185.0, 757, 693809, 972, 35.96747190000133
973, 3.3804560026111323, 31.718707023192344, 38.12619459505141, 0.37513945000000004, 120.0, 962, 694771, 973, 47.69078609999997
974, 4.5116774397300885, 31.9871405638732, 38.55630471398523, 0.37455669999999996, 50.0, 333, 695104, 974, 17.26026769999953
975, 4.779224482172736, 31.87314919625395, 38.34373563520124, 0.37406889999999976, 170.0, 751, 695855, 975, 38.699487599998974
976, 4.413871030342123, 31.700916080634368, 38.1314701640905, 0.3733543, 260.0, 837, 696692, 976, 43.90033290000065
977, 3.1201902352183697, 31.872147082133466, 38.2889607992517, 0.37260414999999975, 180.0, 830, 697522, 977, 41.52847109999857
978, 3.554970612782135, 31.754867014792488, 38.15314867577945, 0.3717433, 275.0, 1083, 698605, 978, 51.79678580000109
979, 3.078912789579562, 31.737539535700147, 38.16480072443489, 0.3709468000000001, 170.0, 687, 699292, 979, 33.65559529999882
980, 4.277268552459603, 31.8409273873928, 38.303834022477616, 0.37032805000000013, 80.0, 688, 699980, 980, 34.07240719999936
981, 2.977367558332034, 31.37558056313397, 37.72275988038603, 0.3696323499999998, 290.0, 858, 700838, 981, 42.978383499999836
982, 2.050620521850716, 31.388067003388137, 37.68852358328207, 0.3688669000000001, 185.0, 843, 701681, 982, 41.27600209999946
983, 3.6849327070079325, 31.447938228030235, 37.81721538345647, 0.3680888500000002, 245.0, 886, 702567, 983, 42.510593099999824
984, 5.872351949321635, 31.480376453836968, 37.91648032509671, 0.367435, 70.0, 567, 703134, 984, 27.3991115000008
985, 3.485650918111205, 31.428785826365154, 37.78828980339898, 0.3667748499999999, 185.0, 900, 704034, 985, 43.68041400000038
986, 2.4781578820928667, 31.48429512916934, 37.82370348923079, 0.36619300000000005, 55.0, 393, 704427, 986, 19.983950199999526
987, 4.174744863489156, 31.580740651776715, 38.037467179060684, 0.3658627, 35.0, 341, 704768, 987, 17.11853340000016
988, 4.955683061112162, 31.53591832794469, 37.95321952726688, 0.36526690000000034, 270.0, 983, 705751, 988, 48.41557909999938
989, 5.44329234854655, 31.5553803342454, 37.97700660279457, 0.36465535, 40.0, 376, 706127, 989, 19.148686300000918
990, 6.3727504872705465, 31.434065180060305, 37.86779964117356, 0.36419454999999984, 145.0, 648, 706775, 990, 32.015314899999794
991, 4.146755151800923, 31.46586779124701, 37.84578946241692, 0.3636014499999998, 165.0, 670, 707445, 991, 32.652746199999456
992, 7.265355952283857, 31.548422055803865, 37.971726486802766, 0.36289719999999975, 165.0, 895, 708340, 992, 44.02388539999993
993, 3.973644723704628, 31.499847344546616, 37.857944124725925, 0.3623293000000001, 70.0, 367, 708707, 993, 17.72652360000029
994, 8.653252637195282, 31.405723718496468, 37.86828778910841, 0.36190090000000014, 100.0, 585, 709292, 994, 29.051052400000117
995, 5.042932456692982, 31.370944635083443, 37.734228753377096, 0.36092934999999976, 210.0, 1574, 710866, 995, 77.6503004999995
996, 3.583234540759177, 31.237603916601145, 37.553823904000716, 0.35980074999999995, 365.0, 934, 711800, 996, 46.25587169999926
997, 6.519197414918192, 31.172008043048027, 37.49675880629441, 0.35922385, 55.0, 348, 712148, 997, 17.639298500000223
998, 2.3913899470067954, 31.223092148888785, 37.514037555118776, 0.3586856499999998, 230.0, 848, 712996, 998, 42.19339409999884
999, 4.164927236835264, 31.15339585251387, 37.459967887377104, 0.35786575, 210.0, 974, 713970, 999, 49.8428571000004
1000, 3.778793890037978, 31.270045064530283, 37.62239847543105, 0.35704584999999983, 225.0, 848, 714818, 1000, 42.48201870000048
1001, 2.3270557393894187, 31.1374988115412, 37.395566821373635, 0.35646939999999977, 50.0, 433, 715251, 1001, 21.578416300000754
1002, 3.0779378350123787, 31.12544119715879, 37.3867319718733, 0.3559896999999999, 75.0, 633, 715884, 1002, 31.274233899999672
1003, 6.634052218812885, 31.29214432538846, 37.654756595562034, 0.35549695, 55.0, 462, 716346, 1003, 23.395334199998615
1004, 2.223794879011658, 31.188849964920355, 37.40712002345494, 0.35493625, 60.0, 784, 717130, 1004, 39.96626070000093
1005, 2.955022220453744, 31.1647010344423, 37.44182131755248, 0.3541195, 300.0, 1031, 718161, 1005, 52.182166900000084
1006, 2.930213553092822, 31.245892457608825, 37.54601769623933, 0.35316954999999994, 185.0, 1080, 719241, 1006, 55.26892660000158
1007, 3.29349350514264, 31.305150910029337, 37.65429287589818, 0.35205984999999995, 310.0, 1386, 720627, 1007, 65.41814129999875
1008, 3.6680605340957517, 31.423603490891903, 37.81236866283316, 0.3510100000000001, 300.0, 947, 721574, 1008, 40.30592759999854
1009, 3.4864358707970005, 31.42360053628178, 37.769858092308894, 0.35007939999999965, 285.0, 1121, 722695, 1009, 57.01046409999981
1010, 3.821649902944898, 31.40924184601586, 37.78719419187254, 0.34917535000000005, 325.0, 888, 723583, 1010, 45.871504700000514
1011, 4.9655948553556275, 31.46474602781696, 37.895859949873305, 0.3485570500000001, 25.0, 486, 724069, 1011, 24.578933300001154
1012, 3.6779631507568733, 31.425513975081905, 37.768708875102384, 0.34807329999999986, 50.0, 589, 724658, 1012, 30.781169699999737
1013, 3.06246384231791, 31.471961643947893, 37.828365386977694, 0.34734429999999966, 245.0, 1031, 725689, 1013, 49.931904699998995
1014, 3.8725801547602985, 31.36834850618916, 37.70804710212391, 0.3464897499999999, 420.0, 868, 726557, 1014, 41.29631840000002
1015, 3.5647903776433303, 31.49921479163232, 37.84977017026959, 0.3458912499999999, 25.0, 462, 727019, 1015, 21.78035639999871
1016, 4.3135316240027395, 31.480926850829462, 37.86307858939123, 0.34550515000000004, 75.0, 396, 727415, 1016, 18.821954500002903
1017, 4.5865999355393345, 31.56857249786078, 37.976060921271554, 0.3449134000000001, 150.0, 919, 728334, 1017, 43.364514300003066
1018, 2.2819572974927724, 31.399643490314485, 37.73682799816132, 0.34413984999999997, 470.0, 800, 729134, 1018, 39.85423549999905
1019, 4.8283288154900825, 31.583791804673083, 38.01934290890718, 0.3434216499999999, 90.0, 796, 729930, 1019, 41.34293350000007
1020, 6.918744913561911, 31.284837090469665, 37.66489725859873, 0.3425693500000001, 410.0, 1098, 731028, 1020, 56.704090500003076
1021, 5.770475112783819, 31.481201138244167, 37.98511040060586, 0.3418965999999999, 110.0, 397, 731425, 1021, 21.245051999998395
1022, 3.6227372409275143, 31.282273579669255, 37.56990006149456, 0.34155054999999995, 50.0, 372, 731797, 1022, 20.00296789999993
1023, 4.8656973175477845, 31.189838122958918, 37.511823356831485, 0.3411464499999999, 95.0, 526, 732323, 1023, 27.543603599999187
1024, 5.209427598868107, 31.278051559867727, 37.62175200157559, 0.34051689999999984, 275.0, 873, 733196, 1024, 45.09159820000059
1025, 3.215409826753395, 31.20457781927926, 37.461623262677875, 0.3398090499999999, 155.0, 700, 733896, 1025, 36.2889714999983
1026, 4.703745709129966, 31.296912867323798, 37.66966614926369, 0.3391349499999999, 245.0, 798, 734694, 1026, 42.8778650000022
1027, 4.229636673741271, 31.163451525331276, 37.45058762076442, 0.33848244999999993, 100.0, 652, 735346, 1027, 34.65263810000033
1028, 3.510458352284111, 31.155504761320174, 37.428114623734444, 0.33795145, 80.0, 528, 735874, 1028, 28.48685900000055
1029, 2.2327426241929915, 31.142920710058775, 37.41723118108862, 0.3374078499999999, 70.0, 680, 736554, 1029, 35.496903200000816
1030, 5.537355422759227, 31.271850436368435, 37.61768874847632, 0.33647634999999987, 490.0, 1390, 737944, 1030, 71.78656030000275
1031, 6.199545172197413, 31.24999099860162, 37.634730865618934, 0.33555744999999987, 140.0, 652, 738596, 1031, 34.74448969999867
1032, 2.5395177579550836, 31.171102561626487, 37.42174980120348, 0.33510519999999994, 45.0, 353, 738949, 1032, 18.854151800002
1033, 5.623773377291601, 31.18102896673463, 37.540033678565955, 0.3345147999999998, 165.0, 959, 739908, 1033, 50.15797150000071
1034, 3.460055632040115, 31.054788062486395, 37.31153112079135, 0.33379660000000005, 135.0, 637, 740545, 1034, 33.59578709999914
1035, 4.669062935601581, 30.980982199582186, 37.247006726698444, 0.3330149499999999, 105.0, 1100, 741645, 1035, 57.2995987999966
1036, 4.760119891276752, 31.100808915224942, 37.36375460841439, 0.3321239499999999, 140.0, 880, 742525, 1036, 46.5817320999995
1037, 4.019421410460515, 31.027402749688644, 37.28152310814402, 0.3312523, 340.0, 1057, 743582, 1037, 55.14201350000076
1038, 6.410259177866056, 30.946895249356928, 37.26740753724403, 0.33055839999999986, 30.0, 485, 744067, 1038, 26.232647200002248
1039, 4.253842286719513, 30.994216055184648, 37.27769221699403, 0.330049, 130.0, 647, 744714, 1039, 36.87074230000144
1040, 3.0750192502293916, 30.949006372143607, 37.22392772274767, 0.32934565000000005, 290.0, 916, 745630, 1040, 45.72641300000032
1041, 3.5898158456434905, 30.90068952789007, 37.173730992615106, 0.32870440000000006, 85.0, 509, 746139, 1041, 26.062607699997898
1042, 6.248363948753234, 31.037102319947145, 37.38439920035397, 0.32815405000000014, 145.0, 714, 746853, 1042, 36.84196680000241
1043, 3.557821840673607, 31.109677716085812, 37.37707638177346, 0.3273184000000001, 345.0, 1143, 747996, 1043, 59.04768680000052
1044, 3.5855672405441363, 30.945118938173568, 37.14701767194839, 0.32657724999999993, 105.0, 504, 748500, 1044, 26.447628399997484
1045, 5.138625271604093, 31.111019375680506, 37.43022426882923, 0.3261155500000002, 145.0, 522, 749022, 1045, 27.728371699999116
1046, 2.464812404414018, 31.1537433013916, 37.402289306640625, 0.32571189999999994, 85.0, 375, 749397, 1046, 19.670860499998525
1047, 3.00531258384841, 31.211779129214403, 37.51572735328985, 0.32510034999999987, 320.0, 984, 750381, 1047, 50.43832939999993
1048, 3.4382117609843355, 31.532064129162386, 37.893189964955944, 0.324424, 70.0, 519, 750900, 1048, 27.265195799998764
1049, 6.152955110332844, 31.636759624817973, 38.15316776134803, 0.32391010000000003, 95.0, 623, 751523, 1049, 32.53897230000075
1050, 4.127619974921807, 31.545309580794168, 37.90704506909082, 0.3232373500000001, 320.0, 872, 752395, 1050, 44.49434520000068
1051, 5.005905969754291, 31.7436468764763, 38.15956279258866, 0.32234634999999995, 325.0, 1108, 753503, 1051, 55.887011700000585
1052, 3.5947579065039896, 31.40526198973316, 37.74105282234089, 0.32161420000000007, 105.0, 519, 754022, 1052, 27.185022599998774
1053, 3.857238357359669, 31.662236245363985, 38.07231192135456, 0.3209878, 240.0, 873, 754895, 1053, 44.436583200000314
1054, 5.590244261715463, 31.592142120240226, 38.03213253727666, 0.32042484999999993, 80.0, 378, 755273, 1054, 19.70909390000088
1055, 3.016577041432971, 31.609930983043853, 38.011487750617825, 0.31992399999999993, 170.0, 735, 756008, 1055, 38.941939500000444
1056, 4.333014321542973, 31.57118761341676, 38.00956846901734, 0.3192948999999999, 215.0, 663, 756671, 1056, 33.735150200001954
1057, 7.699064751566604, 31.66466181172571, 38.13047208400131, 0.31876299999999996, 95.0, 519, 757190, 1057, 26.09611269999732
1058, 3.5911136142288647, 31.62516028881073, 38.05043023427327, 0.31831344999999994, 105.0, 480, 757670, 1058, 24.73329880000165
1059, 3.7288701734903804, 31.651311241935478, 38.032590356796824, 0.31758175000000005, 220.0, 1146, 758816, 1059, 58.26947320000181
1060, 3.61476442758729, 31.590710434732557, 37.98268882427656, 0.3164616999999996, 485.0, 1343, 760159, 1060, 69.162960200003
1061, 3.5605539306788376, 32.26825030958149, 38.77824416362064, 0.3155378500000001, 360.0, 710, 760869, 1061, 36.76814420000301
1062, 5.115554621013813, 32.149224293848384, 38.67208417646724, 0.3147049000000001, 510.0, 1141, 762010, 1062, 58.38268980000066
1063, 4.065025014562645, 32.189705157348286, 38.69180838631354, 0.31387734999999994, 145.0, 698, 762708, 1063, 36.278716499997245
1064, 4.102363773262537, 32.20641870689099, 38.70880090622675, 0.31327029999999995, 145.0, 651, 763359, 1064, 34.064373199998954
1065, 2.5511165111330314, 32.08683243556995, 38.48830830398484, 0.31279645, 5.0, 402, 763761, 1065, 20.952721899997414
1066, 4.695620474731907, 32.14985093314324, 38.69390539379071, 0.3122636499999999, 145.0, 782, 764543, 1066, 40.32464499999696
1067, 3.258763290352838, 32.21080600568109, 38.698530434415105, 0.31125699999999995, 200.0, 1455, 765998, 1067, 74.94802250000066
1068, 6.068094177957459, 32.09894684922723, 38.641078039760636, 0.31021614999999997, 175.0, 858, 766856, 1068, 45.013264600002
1069, 5.508007102035066, 32.128129942015505, 38.684826191180925, 0.30957894999999996, 160.0, 558, 767414, 1069, 30.238332599998103
1070, 3.852583380872523, 32.23837235783667, 38.76915936361062, 0.3087568000000001, 350.0, 1269, 768683, 1070, 66.6134544000015
1071, 6.011025142158425, 32.18634142935525, 38.663137495767124, 0.3079706499999999, 45.0, 478, 769161, 1071, 25.949554499999067
1072, 4.627912407125926, 32.28543530770068, 38.859224517390416, 0.30737394999999984, 110.0, 848, 770009, 1072, 43.566413000000466
1073, 2.149369392490704, 31.950897723862973, 38.32560436662233, 0.30677229999999994, 90.0, 489, 770498, 1073, 27.258472299999994
1074, 3.7875449330608957, 31.813839882775678, 38.21366337666346, 0.3060599500000001, 430.0, 1094, 771592, 1074, 49.934159100001125
1075, 3.0212246041726227, 31.941316825061588, 38.39453545191779, 0.3051198999999997, 395.0, 995, 772587, 1075, 37.45695030000206
1076, 4.174386142748679, 31.851381442610474, 38.317672082730326, 0.3043855, 95.0, 637, 773224, 1076, 24.175554899997223
1077, 4.853477173101237, 31.935143936118546, 38.41256370109297, 0.3037437999999999, 240.0, 789, 774013, 1077, 30.08085989999745
1078, 2.412991237816379, 31.915924135343296, 38.30192484217366, 0.30310299999999984, 175.0, 635, 774648, 1078, 24.012982200001716
1079, 1.8011955782123235, 31.56697444639344, 37.9458420905514, 0.30266200000000004, 35.0, 345, 774993, 1079, 13.216906099998596
1080, 3.9603586521104117, 31.893927354901752, 38.3500083745083, 0.3020252500000002, 375.0, 1070, 776063, 1080, 41.766751099999965
1081, 5.4584037900046845, 31.87240349184769, 38.39738985357697, 0.3011900499999999, 250.0, 786, 776849, 1081, 32.671787800001766
1082, 5.32194140504072, 31.920102081945885, 38.36916629553025, 0.30025270000000004, 495.0, 1297, 778146, 1082, 54.28147000000172
1083, 2.2969378139216796, 31.838647314181603, 38.22293512205731, 0.2993099500000001, 225.0, 798, 778944, 1083, 35.27059130000271
1084, 4.8407643002796386, 31.830595890501552, 38.27288479083817, 0.29875150000000006, 55.0, 443, 779387, 1084, 18.119760399997176
1085, 4.122663097654503, 31.895219575430136, 38.39074081760522, 0.2982690999999999, 90.0, 629, 780016, 1085, 28.27142559999993
1086, 3.517272498458624, 31.189965833829145, 37.48675323846772, 0.29752884999999996, 415.0, 1016, 781032, 1086, 65.70667669999966
1087, 2.32958382578491, 31.193443648819766, 37.43960279837337, 0.2968389999999999, 35.0, 517, 781549, 1087, 38.9573390000005
1088, 3.6937322756275535, 31.21728052954743, 37.52041286316471, 0.2963579499999999, 105.0, 552, 782101, 1088, 38.769937900000514
1089, 3.796683934791491, 31.149006908711502, 37.444672171239226, 0.29570770000000013, 215.0, 893, 782994, 1089, 51.683330599997134
1090, 2.8874562406452107, 31.15702792145017, 37.411735697388124, 0.29479420000000006, 275.0, 1137, 784131, 1090, 64.17276409999977
1091, 7.426782622746246, 31.33712582610653, 37.752338945397774, 0.2939958999999998, 95.0, 637, 784768, 1091, 35.2670154999978
1092, 4.988179037937144, 31.250452177295127, 37.55787839716615, 0.29306394999999996, 460.0, 1434, 786202, 1092, 80.65895509999973
1093, 6.445394481138035, 31.26671096006054, 37.7409685052977, 0.29227194999999995, 50.0, 326, 786528, 1093, 19.951593099998718
1094, 2.1737994924715447, 31.193715900569767, 37.452657438366025, 0.29174409999999995, 180.0, 847, 787375, 1094, 43.728813500001706
1095, 6.950028130188672, 31.204661613653514, 37.578641688809626, 0.29098179999999996, 200.0, 847, 788222, 1095, 40.45256370000061
1096, 2.311371329914907, 31.241276252940434, 37.51108962957309, 0.29010475, 325.0, 1102, 789324, 1096, 53.30694890000086
1097, 2.46437185376851, 31.057067919585663, 37.28872937671209, 0.2891840499999999, 185.0, 944, 790268, 1097, 45.45140140000149
1098, 4.7474711211120235, 31.00202188029218, 37.29950925129563, 0.2882768499999998, 385.0, 1072, 791340, 1098, 51.05830150000111
1099, 3.2976169782632123, 30.97695809732812, 37.20675649875548, 0.28744390000000014, 350.0, 779, 792119, 1099, 39.18217509999886
1100, 4.638587885074891, 31.087527069678675, 37.37449275970459, 0.28650835000000024, 385.0, 1300, 793419, 1100, 57.397547500000655
1101, 5.622378131391497, 31.03202720160957, 37.30582689737773, 0.2856236499999999, 155.0, 666, 794085, 1101, 33.34305210000093
1102, 3.191379129490815, 31.078526250521342, 37.34227666258812, 0.28489194999999984, 410.0, 960, 795045, 1102, 45.910920199999964
1103, 3.316109129244926, 31.12702445651813, 37.377951620971544, 0.2840463999999999, 140.0, 919, 795964, 1103, 41.61858159999974
1104, 4.336141558261733, 31.017687660177753, 37.29880744262063, 0.2831986, 305.0, 965, 796929, 1104, 50.05050279999705
1105, 2.5718063014350174, 31.086019395685383, 37.33666660845201, 0.28242190000000006, 470.0, 761, 797690, 1105, 38.57825040000171
1106, 4.639201597026967, 31.15733541490873, 37.469909728060244, 0.28169380000000005, 230.0, 857, 798547, 1106, 42.88381410000147
1107, 4.62521025431352, 31.11993716237971, 37.395776043682375, 0.2808698500000001, 335.0, 974, 799521, 1107, 47.46697579999818
1108, 4.164425007401229, 31.129694782086272, 37.402529627529546, 0.2797079499999998, 490.0, 1608, 801129, 1108, 82.49089979999917
1109, 4.369827370827333, 30.886300331195287, 37.13401425340637, 0.2785959999999999, 140.0, 863, 801992, 1109, 45.69638009999835
1110, 5.264014808076899, 30.888582009077073, 37.138085556030276, 0.2779196499999999, 80.0, 640, 802632, 1110, 28.925740299997415
1111, 5.15480086120053, 31.008107821606693, 37.26125098861937, 0.2773206999999999, 145.0, 691, 803323, 1111, 34.163878999999724
1112, 3.689278695780028, 30.839285454758777, 37.019932159340144, 0.27676359999999994, 85.0, 547, 803870, 1112, 24.608209600002738
1113, 4.335895491558259, 31.066146774526022, 37.34994886257897, 0.27622405000000005, 155.0, 652, 804522, 1113, 30.812335700000403
1114, 5.55021225269393, 30.965198072414953, 37.19062619996302, 0.27560619999999986, 125.0, 721, 805243, 1114, 34.72391079999943
1115, 4.402133447426135, 30.97167428735387, 37.231774406914106, 0.2748178, 315.0, 1031, 806274, 1115, 50.07911519999834
1116, 4.588381967032259, 30.94974147679318, 37.22195051280211, 0.2739295000000001, 285.0, 943, 807217, 1116, 41.138903400002164
1117, 5.220967197819398, 30.941190461012035, 37.18852725395789, 0.27303714999999984, 255.0, 1040, 808257, 1117, 44.16478030000144
1118, 3.2953791276946505, 30.969584578662257, 37.211525156127564, 0.2722707999999999, 75.0, 663, 808920, 1118, 28.265451300001587
1119, 3.749213120321574, 31.04965777892445, 37.324190537944105, 0.2715305499999998, 135.0, 982, 809902, 1119, 43.550006599998596
1120, 2.334811420269945, 31.018008481200468, 37.29043282402886, 0.2707767999999998, 210.0, 693, 810595, 1120, 30.48678999999902
1121, 3.1416710706427695, 30.936639864742755, 37.17385461032391, 0.2698889499999999, 270.0, 1280, 811875, 1121, 54.74452949999977
1122, 3.4264599819187147, 31.119331279681745, 37.40558299653849, 0.2689597, 145.0, 785, 812660, 1122, 33.481053799998335
1123, 3.8544246034640253, 31.004533331321948, 37.24223381389271, 0.26830945, 135.0, 660, 813320, 1123, 28.297783400001208
1124, 5.255827927571571, 31.091303571255622, 37.412579051034896, 0.2677118500000001, 85.0, 668, 813988, 1124, 29.422834999997576
1125, 6.68566648600072, 31.036891171312707, 37.38542790407539, 0.2670112, 190.0, 889, 814877, 1125, 41.79559009999866
1126, 4.843307251450964, 30.97172052355913, 37.22819879421821, 0.2662367500000001, 290.0, 832, 815709, 1126, 38.09051779999936
1127, 3.671597583620457, 30.993717928252153, 37.30425778986734, 0.26567424999999995, 50.0, 418, 816127, 1127, 18.87578779999967
1128, 4.751787080351202, 31.154399929262016, 37.44718385311112, 0.26512749999999985, 140.0, 797, 816924, 1128, 35.030020400001376
1129, 6.800103759379696, 31.06584629086282, 37.35306565538585, 0.2644560999999998, 65.0, 695, 817619, 1129, 30.991729899997154
1130, 3.5333391566542103, 31.03774059963765, 37.28888573234749, 0.2635857999999999, 300.0, 1239, 818858, 1130, 54.76547990000108
1131, 3.390559663600994, 31.11995442983564, 37.43140200275019, 0.26271639999999996, 180.0, 693, 819551, 1131, 35.437888600001315
1132, 4.832840279540076, 31.18110712005682, 37.455066429503866, 0.26199145, 490.0, 918, 820469, 1132, 47.86255439999877
1133, 5.837102453556774, 31.247950404430423, 37.56757384629052, 0.2611332999999999, 225.0, 989, 821458, 1133, 42.65979899999729
1134, 2.5939507657301286, 31.13452345957398, 37.39941451483564, 0.26046055, 90.0, 506, 821964, 1134, 24.459856400000717
1135, 3.7130144597203643, 31.21585868947163, 37.508436212860026, 0.2597104, 320.0, 1161, 823125, 1135, 62.00585290000163
1136, 5.779376872949266, 31.261395540099212, 37.564109291776944, 0.2587221999999999, 325.0, 1035, 824160, 1136, 49.18375449999803
1137, 4.160862358976464, 31.27810150659326, 37.56756805890612, 0.25776774999999996, 285.0, 1086, 825246, 1137, 55.093776000001526
1138, 6.284128168326377, 31.30267961300797, 37.63641772437934, 0.2570999499999999, 70.0, 398, 825644, 1138, 18.43408670000281
1139, 4.64911345771142, 31.309833414877208, 37.65508272624252, 0.25637544999999995, 420.0, 1212, 826856, 1139, 61.81752469999992
1140, 3.9157014969721673, 31.314784656359453, 37.64874975700078, 0.2553728499999999, 225.0, 1016, 827872, 1140, 46.6388838999992
1141, 5.948528554447623, 31.257450856358172, 37.66565857163395, 0.25446744999999993, 455.0, 996, 828868, 1141, 45.39742869999827
1142, 2.7089170042473154, 31.245201211709244, 37.50262676752531, 0.25373845, 180.0, 624, 829492, 1142, 29.894252800000686
1143, 3.411449521922685, 31.178939947168878, 37.463089362611164, 0.25303464999999997, 240.0, 940, 830432, 1143, 43.038344399999914
1144, 3.6082682854605075, 31.1201377712419, 37.4025253821016, 0.25221610000000005, 275.0, 879, 831311, 1144, 39.428640000001906
1145, 5.373194567487881, 31.17154315513366, 37.47479683378606, 0.2514141999999999, 65.0, 903, 832214, 1145, 40.85402030000114
1146, 5.04269291294319, 31.17750352127469, 37.47200663898634, 0.2505024999999998, 410.0, 1123, 833337, 1146, 51.46442999999999
1147, 6.296569521033115, 31.15307154795116, 37.45576030300252, 0.24945940000000003, 330.0, 1195, 834532, 1147, 55.671331499997905
1148, 5.311467982014152, 31.15638150371073, 37.41316982639153, 0.24844824999999993, 320.0, 1052, 835584, 1148, 48.302755500000785
1149, 5.273904878796652, 31.241206727846706, 37.56498154004415, 0.24761844999999982, 165.0, 792, 836376, 1149, 37.21048090000113
1150, 5.278313462319784, 31.180553710460664, 37.511828629175824, 0.24683004999999997, 230.0, 960, 837336, 1150, 49.56608750000305
1151, 3.466806509921997, 31.079074629421893, 37.32442008098358, 0.24603265000000002, 160.0, 812, 838148, 1151, 37.07149129999743
1152, 3.4695976400542037, 31.093383517309764, 37.32765968312595, 0.24532930000000003, 140.0, 751, 838899, 1152, 35.77902449999965
1153, 5.594239060066729, 31.20859254664773, 37.54726457855258, 0.2445778, 185.0, 919, 839818, 1153, 45.17686479999975
1154, 3.9766314940615777, 31.247294633566927, 37.529275760088375, 0.24376735000000005, 115.0, 882, 840700, 1154, 46.323550400000386
1155, 6.510428991272661, 31.325253662633283, 37.71029408295267, 0.24295104999999995, 195.0, 932, 841632, 1155, 45.872792400001345
1156, 2.6551263145406114, 31.196507772552632, 37.44697677309268, 0.2421464499999999, 145.0, 856, 842488, 1156, 44.41044909999982
1157, 5.868538734242573, 31.248374234779504, 37.601525102574314, 0.24136389999999985, 125.0, 883, 843371, 1157, 42.474449500001356
1158, 5.493962289556767, 31.27298689392606, 37.617550956774465, 0.24075370000000001, 125.0, 473, 843844, 1158, 23.818824400001176
1159, 5.608305572930409, 31.22981328312278, 37.61057598678031, 0.24025780000000002, 60.0, 629, 844473, 1159, 30.355950900000607
1160, 4.482152910511928, 31.262969518665265, 37.582663284311806, 0.2392911999999998, 575.0, 1519, 845992, 1160, 76.05411959999765
1161, 4.111793022399006, 31.183618687435626, 37.47420680131641, 0.23819635000000008, 245.0, 914, 846906, 1161, 44.41184670000075
1162, 3.715174223282016, 31.266979924038317, 37.58694414443518, 0.23702455000000003, 690.0, 1690, 848596, 1162, 86.16988439999841
1163, 6.919041517803012, 31.26194009062362, 37.63849214658345, 0.23600124999999997, 55.0, 584, 849180, 1163, 28.1200439000022
1164, 6.185843448779407, 31.243376940696642, 37.56648520146454, 0.23541580000000006, 180.0, 717, 849897, 1164, 39.48005909999847
1165, 5.496229765307432, 31.21609774228543, 37.56463783177952, 0.23469489999999998, 190.0, 885, 850782, 1165, 43.355682699999306
1166, 5.425871284129763, 31.214875549077988, 37.578032423342975, 0.23389344999999997, 310.0, 896, 851678, 1166, 48.94973970000137
1167, 5.758531393229656, 31.274129824268346, 37.64475737553565, 0.23287555000000001, 425.0, 1366, 853044, 1167, 72.85363100000177
1168, 5.273615484474444, 31.261154449790535, 37.58957900591423, 0.23196745, 180.0, 652, 853696, 1168, 32.59880549999798
1169, 4.690962043341991, 31.194006961621376, 37.51471303338127, 0.23117050000000008, 240.0, 1119, 854815, 1169, 57.74467910000021
1170, 3.449812672176161, 31.189029193072585, 37.45874393948857, 0.23037714999999995, 135.0, 644, 855459, 1170, 32.543697500001144
1171, 3.5444226717886544, 31.276629511283897, 37.5841132121481, 0.22959279999999996, 245.0, 1099, 856558, 1171, 57.97121989999869
1172, 5.785479799889285, 31.140705417764597, 37.39947780740672, 0.22883724999999996, 120.0, 580, 857138, 1172, 32.29724079999869
1173, 3.5125501043075484, 31.238434962588602, 37.491363922513365, 0.22828014999999993, 90.0, 658, 857796, 1173, 32.61745339999834
1174, 5.000208232804453, 31.334330621100825, 37.694654579962226, 0.2276191, 235.0, 811, 858607, 1174, 39.75982020000083
1175, 6.709181217738614, 31.37207695658173, 37.70253520441281, 0.22696929999999998, 135.0, 633, 859240, 1175, 31.24506459999975
1176, 2.7422537583722164, 31.265877844179467, 37.52170155135161, 0.22626415000000002, 245.0, 934, 860174, 1176, 46.579974799999036
1177, 5.65410775463965, 31.126000037974556, 37.4368585489564, 0.2253659499999999, 220.0, 1062, 861236, 1177, 49.81978319999689
1178, 2.6811839649361024, 31.169674853003382, 37.42814616967061, 0.22457169999999993, 130.0, 703, 861939, 1178, 33.545174900002166
1179, 5.299937334446305, 31.12397618205459, 37.43610956933763, 0.22406094999999993, 20.0, 432, 862371, 1179, 20.94940359999964
1180, 3.79083712332945, 31.15940053197104, 37.41807392441159, 0.22337425, 220.0, 1094, 863465, 1180, 52.105239299999084
1181, 3.6236583161142284, 31.21042869515615, 37.50674539722809, 0.22235634999999987, 305.0, 1168, 864633, 1181, 58.285130399999616
1182, 6.730946032766332, 31.40602582276411, 37.79118666605384, 0.22153465, 110.0, 658, 865291, 1182, 36.392208299999766
1183, 3.4386654008054642, 31.175319619374733, 37.43463627635913, 0.2208771999999998, 220.0, 803, 866094, 1183, 42.354713900000206
1184, 4.360109656104739, 31.164844037445498, 37.453538080672146, 0.22019634999999987, 140.0, 710, 866804, 1184, 35.664449500000046
1185, 6.6032349613313315, 31.195827596991727, 37.534986814803624, 0.2195726499999999, 120.0, 676, 867480, 1185, 33.381773000000976
1186, 3.532503928771573, 31.17186348237724, 37.45859578391102, 0.2188832499999999, 175.0, 856, 868336, 1186, 43.69862219999777
1187, 6.532700670424307, 31.177698726823845, 37.49775006438575, 0.21819474999999988, 80.0, 674, 869010, 1187, 31.5967204999979
1188, 3.7973776903638643, 31.242109061386177, 37.51614737620552, 0.21769614999999992, 65.0, 434, 869444, 1188, 22.11222110000017
1189, 5.138019717783585, 31.333162006769797, 37.67503252138203, 0.21702745, 350.0, 1052, 870496, 1189, 55.69769429999724
1190, 6.268348203903591, 31.47163228803268, 37.83937751242718, 0.2161373499999999, 165.0, 926, 871422, 1190, 51.375990000000456
1191, 6.076622286454383, 31.361369622186057, 37.64976266258121, 0.21554694999999996, 110.0, 386, 871808, 1191, 22.382709199999226
1192, 4.011529782998358, 31.425742445461754, 37.736244691771155, 0.21516309999999997, 105.0, 467, 872275, 1192, 24.13406060000125
1193, 4.597790874364143, 31.38660545545755, 37.748941850170645, 0.21451644999999994, 285.0, 970, 873245, 1193, 50.529445100000885
1194, 3.5344221208888786, 31.243110817357113, 37.5451910836356, 0.21378069999999988, 110.0, 665, 873910, 1194, 34.327716700001474
1195, 5.23645346366145, 31.47916341357761, 37.84398804240757, 0.21299544999999992, 285.0, 1080, 874990, 1195, 48.905749400000786
1196, 4.8555783291184715, 31.22207931034149, 37.52550484188019, 0.21222594999999994, 145.0, 630, 875620, 1196, 28.37794070000018
1197, 2.9598536993977587, 31.269848278993685, 37.53569299934884, 0.21163824999999997, 125.0, 676, 876296, 1197, 30.336426400001073
1198, 4.750665984397922, 31.41378511149564, 37.78177495463243, 0.21104514999999988, 65.0, 642, 876938, 1198, 28.831970699997328
1199, 4.742514673044881, 31.381803500294172, 37.74178355753166, 0.21033684999999996, 290.0, 932, 877870, 1199, 41.58550629999809
1200, 5.1875902315728295, 31.41185078852385, 37.72671104357081, 0.20945395, 290.0, 1030, 878900, 1200, 49.77618530000109
1201, 4.797698981676029, 31.45576136123731, 37.8518630993731, 0.20871099999999992, 90.0, 621, 879521, 1201, 30.181574199999886
1202, 4.78248600063559, 31.272373719093128, 37.647955503219215, 0.2081507499999999, 115.0, 624, 880145, 1202, 31.633783499997662
1203, 3.5789968680132898, 30.876968927550735, 37.086196010991145, 0.20735694999999998, 340.0, 1140, 881285, 1203, 56.59504200000083
1204, 4.980809287916168, 30.948236461810648, 37.256096509261255, 0.20637279999999994, 220.0, 1047, 882332, 1204, 51.90235980000216
1205, 5.60166380543406, 30.96657780579934, 37.22338021045937, 0.20550654999999982, 230.0, 878, 883210, 1205, 42.904213199999504
1206, 2.896780491581598, 30.933735106827378, 37.09771506074187, 0.20476494999999983, 165.0, 770, 883980, 1206, 38.298643599999195
1207, 4.542353024043463, 30.927403341773097, 37.16643627435883, 0.20412504999999992, 130.0, 652, 884632, 1207, 29.37727090000044
1208, 5.317454667165052, 30.907388479011495, 37.17321065776256, 0.20350584999999996, 165.0, 724, 885356, 1208, 32.38676409999971
1209, 3.1160719297625716, 30.951135967252135, 37.1515301311791, 0.20249469999999992, 650.0, 1523, 886879, 1209, 67.3105531000001
1210, 8.193800734641792, 31.078973718664862, 37.44480961832133, 0.20149254999999994, 95.0, 704, 887583, 1210, 31.500086399999418
1211, 4.436315840870312, 31.023816246103106, 37.258773488301266, 0.20054169999999993, 495.0, 1409, 888992, 1211, 66.64130230000228
1212, 3.672203273449723, 30.865694547130165, 37.11003124067936, 0.1996335999999999, 100.0, 609, 889601, 1212, 30.43510460000107
1213, 4.461647705896683, 30.95917287542378, 37.20830128660539, 0.19893970000000002, 250.0, 933, 890534, 1213, 46.11583149999933
1214, 2.402878930284547, 30.977890521548073, 37.19054359006835, 0.19805589999999995, 235.0, 1031, 891565, 1214, 50.3803153000008
1215, 4.079226663238976, 31.074338108560312, 37.38227392901545, 0.1971779499999999, 285.0, 920, 892485, 1215, 45.29220770000029
1216, 4.364429516695749, 30.990453415368435, 37.26649942905945, 0.19645974999999996, 185.0, 676, 893161, 1216, 33.90052730000025
1217, 3.433357653608828, 30.971398810184365, 37.21060085585623, 0.19585855, 55.0, 660, 893821, 1217, 32.417010299999674
1218, 3.9789823274488096, 30.992770863944525, 37.26863396143377, 0.19534149999999992, 55.0, 489, 894310, 1218, 25.92089819999819
1219, 3.6317919807180825, 30.989331567133956, 37.228560960957935, 0.19459720000000003, 395.0, 1165, 895475, 1219, 58.37892269999793
1220, 3.7724412051530987, 31.024412257854756, 37.32410910312946, 0.1938389499999999, 80.0, 520, 895995, 1220, 26.829777200000535
1221, 4.646949796937406, 31.041544902019012, 37.317049625592354, 0.19332414999999992, 160.0, 624, 896619, 1221, 31.19068569999945
1222, 6.215426619110019, 31.002637699438267, 37.337972867471805, 0.19272879999999987, 140.0, 699, 897318, 1222, 35.13278809999974
1223, 4.083157633547362, 30.92978627738649, 37.16104724742373, 0.19207494999999983, 115.0, 754, 898072, 1223, 37.44571929999802
1224, 5.487571982450263, 31.025229721486813, 37.300350533627615, 0.19140669999999985, 140.0, 731, 898803, 1224, 36.45417120000275
1225, 2.9705158785811774, 30.985645960277157, 37.22856397294812, 0.19061514999999998, 245.0, 1028, 899831, 1225, 50.70146829999794
1226, 5.739365269207373, 30.750888282496756, 36.96164493095584, 0.18978355, 100.0, 820, 900651, 1226, 40.94187659999807
1227, 3.9657853332083572, 30.668643660181306, 36.8725706059882, 0.189055, 200.0, 799, 901450, 1227, 40.087844400000904
1228, 2.5832646591879893, 30.54623710612456, 36.65625609457493, 0.18834985, 210.0, 768, 902218, 1228, 38.26831780000066
1229, 4.7706775638975225, 30.60746930166075, 36.81808781688104, 0.18783729999999993, 105.0, 371, 902589, 1229, 18.887463299997762
1230, 3.0117585100382924, 30.54443607467982, 36.69589635364132, 0.18710919999999995, 330.0, 1247, 903836, 1230, 62.24277240000083
1231, 3.2434889277076087, 30.58085890274126, 36.763785146960686, 0.18610749999999998, 225.0, 979, 904815, 1231, 48.7744343000013
1232, 4.142384580351879, 30.57587244487045, 36.73632919040843, 0.18512154999999994, 300.0, 1212, 906027, 1232, 65.0718257999979
1233, 4.4426480634535395, 30.533137937202525, 36.694523866189876, 0.18409105, 185.0, 1078, 907105, 1233, 53.3218123000006
1234, 5.840244671721893, 30.7723538493822, 37.008523578009935, 0.18315909999999994, 325.0, 993, 908098, 1234, 49.917434399998456
1235, 5.636170907225231, 30.62693551365808, 36.81380767962857, 0.1823459499999999, 195.0, 814, 908912, 1235, 41.087546400001884
1236, 5.005710967811415, 30.671567792329466, 36.89055722088208, 0.18147654999999993, 415.0, 1118, 910030, 1236, 56.005073399999674
1237, 4.712942264812148, 30.55780233655657, 36.68365850211671, 0.18068365, 95.0, 644, 910674, 1237, 32.676513700000214
1238, 5.914492147945866, 30.46882939420615, 36.67376866291479, 0.1801319499999999, 140.0, 582, 911256, 1238, 29.730365999999776
1239, 2.9607529433309168, 30.544421840059584, 36.66644347923389, 0.1795595499999999, 150.0, 690, 911946, 1239, 34.8625346000008
1240, 4.734476517821235, 30.53137722151759, 36.71789235942089, 0.17880849999999987, 140.0, 979, 912925, 1240, 49.17236319999938
1241, 5.3998599883506735, 30.664274310700282, 36.842431780935705, 0.17801559999999989, 335.0, 783, 913708, 1241, 40.12926769999831
1242, 4.903213657719501, 30.564917904397717, 36.68333121313565, 0.17735274999999992, 150.0, 690, 914398, 1242, 35.161414900001546
1243, 5.969202420945651, 30.58960569868957, 36.749881071058866, 0.17669169999999992, 270.0, 779, 915177, 1243, 39.33422470000005
1244, 3.804027009997921, 30.50923093849908, 36.67200355816365, 0.17580204999999993, 275.0, 1198, 916375, 1244, 61.12775740000143
1245, 4.154621492063982, 30.53926717515868, 36.71553724382345, 0.17462889999999992, 480.0, 1409, 917784, 1245, 70.8483023000008
1246, 2.829054958367748, 30.52139221020599, 36.63777454812728, 0.17381394999999997, 55.0, 402, 918186, 1246, 21.019666600001074
1247, 3.756380199750138, 30.590453875596356, 36.74648251867598, 0.1732797999999999, 150.0, 785, 918971, 1247, 40.01603190000242
1248, 4.338883344156595, 30.660792916368095, 36.85643732599366, 0.17251074999999988, 345.0, 924, 919895, 1248, 47.116709800000535
1249, 6.878836198020088, 30.680379210925494, 36.96053115514991, 0.1717929999999999, 180.0, 671, 920566, 1249, 34.27325850000125
1250, 4.418661401879268, 30.577084615304038, 36.775883264166644, 0.17106759999999985, 190.0, 941, 921507, 1250, 48.46470340000087
1251, 4.3197484202437195, 30.607073756010323, 36.75824896644355, 0.17016669999999992, 320.0, 1061, 922568, 1251, 54.21145909999905
1252, 5.772961145056025, 30.65724246456938, 36.91939945041009, 0.1694984499999999, 35.0, 424, 922992, 1252, 22.283095899998443
1253, 4.46085498597465, 30.6274994771192, 36.78240798739618, 0.16888374999999986, 195.0, 942, 923934, 1253, 48.33217539999896
1254, 5.29399906206822, 30.657927421556003, 36.85262681781382, 0.16796305, 390.0, 1104, 925038, 1254, 56.60001090000151
1255, 4.355281740000492, 30.6930296406531, 36.85429774016033, 0.16709679999999996, 420.0, 821, 925859, 1255, 41.91744729999846
1256, 5.828687913686105, 30.74103745141894, 36.96246760682614, 0.16633269999999997, 145.0, 877, 926736, 1256, 45.24209989999872
1257, 8.013688321227438, 30.640358959155137, 36.85817259027717, 0.16553754999999992, 240.0, 890, 927626, 1257, 45.641623999999865
1258, 6.548290350816698, 30.671931653960137, 36.87617844801683, 0.16471584999999989, 325.0, 936, 928562, 1258, 48.257728900000075
1259, 4.010165947671329, 30.56188349226673, 36.67801173317975, 0.16398819999999992, 135.0, 681, 929243, 1259, 35.19244759999856
1260, 3.8334153315949218, 30.659510521241177, 36.83952853120404, 0.16339014999999993, 55.0, 648, 929891, 1260, 33.623519300002954
1261, 4.061720127703754, 30.89187212947576, 37.10575685891077, 0.16285644999999999, 105.0, 538, 930429, 1261, 28.02580289999969
1262, 3.917673968108077, 30.86444145001863, 37.08125513980263, 0.16218684999999997, 190.0, 950, 931379, 1262, 48.89174609999827
1263, 3.812302168812603, 31.02226419766744, 37.2764776579539, 0.16121934999999996, 220.0, 1200, 932579, 1263, 62.46006750000015
1264, 4.218158826543225, 30.952886884901258, 37.188947930230036, 0.16017309999999996, 190.0, 1125, 933704, 1264, 58.00531229999979
1265, 3.968650007564686, 30.865188598632812, 37.10418399650894, 0.15936625, 55.0, 668, 934372, 1265, 34.97423770000023
1266, 4.921572354512069, 30.93293365639054, 37.15423746051674, 0.1586165499999999, 305.0, 998, 935370, 1266, 52.18155990000014
1267, 4.299730908660102, 30.888960207299963, 37.12132151683342, 0.15795729999999997, 45.0, 467, 935837, 1267, 24.480485399999452
1268, 6.385665460843728, 30.903544104994065, 37.144714304667694, 0.1575612999999999, 45.0, 413, 936250, 1268, 21.892923999999766
1269, 3.1336357867924103, 30.79962033810823, 36.964989384207364, 0.15709599999999993, 150.0, 621, 936871, 1269, 32.31295669999963
1270, 3.8572125645848563, 30.87090046551763, 37.09779660393592, 0.15628734999999985, 580.0, 1176, 938047, 1270, 60.99402650000047
1271, 6.491600153952294, 30.978238360403388, 37.21915266881535, 0.15548679999999993, 65.0, 603, 938650, 1271, 31.908119600000646
1272, 6.749853515841204, 30.81779817497069, 37.02184244104334, 0.1548990999999999, 120.0, 703, 939353, 1272, 37.07908189999944
1273, 5.497283486764477, 30.952853606549226, 37.17152778180295, 0.15418944999999992, 225.0, 874, 940227, 1273, 45.65109490000032
1274, 3.0206285387277605, 31.149807615058368, 37.362627535088116, 0.15360264999999995, 125.0, 430, 940657, 1274, 22.70205939999869
1275, 4.3689070201673825, 31.152616844620816, 37.4360834461774, 0.15294474999999993, 330.0, 1032, 941689, 1275, 53.89576950000264
1276, 5.939811689504819, 31.18025244483652, 37.550712064255116, 0.15224814999999994, 55.0, 516, 942205, 1276, 27.6439289000009
1277, 6.767440806091814, 31.14792068712004, 37.444902011326384, 0.15185214999999996, 45.0, 364, 942569, 1277, 19.395345400000224
1278, 4.708839733858044, 31.156819100563343, 37.44453479234989, 0.15112674999999998, 225.0, 1248, 943817, 1278, 65.22411920000013
1279, 5.741208503211044, 31.170453730624722, 37.46851530051564, 0.15001749999999991, 470.0, 1217, 945034, 1279, 63.76926310000272
1280, 3.30639981488753, 31.140278135027206, 37.376233650242675, 0.1492745499999999, 65.0, 434, 945468, 1280, 23.4008281000024
1281, 5.968798050275671, 31.15852907446891, 37.464404164300724, 0.14854059999999994, 545.0, 1197, 946665, 1281, 63.35100690000036
1282, 5.2094328965977645, 31.06458161006509, 37.35038762375205, 0.14764509999999992, 95.0, 793, 947458, 1282, 41.42681780000203
1283, 6.216150596737862, 31.20902269509188, 37.49331860025977, 0.14700564999999993, 100.0, 628, 948086, 1283, 33.28681309999956
1284, 6.030444523584842, 31.238903872680662, 37.54259885864258, 0.14644179999999993, 185.0, 625, 948711, 1284, 33.63775700000042
1285, 6.120340326446286, 31.217983593290178, 37.522687827629305, 0.14556025000000003, 635.0, 1334, 950045, 1285, 70.63069019999966
1286, 6.57994284391848, 31.214684330764694, 37.534448059044074, 0.1440554499999999, 525.0, 2010, 952055, 1286, 106.77254719999837
1287, 3.8464631523095254, 31.13869811491145, 37.40315540151575, 0.1427486499999999, 175.0, 894, 952949, 1287, 47.80604870000025
1288, 4.290835556572336, 31.25640022637568, 37.525565696371565, 0.14211729999999997, 90.0, 509, 953458, 1288, 27.520666899999924
1289, 5.682780464540701, 31.27959588368734, 37.61160060564677, 0.14102424999999988, 585.0, 1920, 955378, 1289, 101.1693411999986
1290, 4.958603072169118, 31.156525832746357, 37.44663643965387, 0.13990959999999994, 35.0, 557, 955935, 1290, 30.332473300000856
1291, 8.693030485767446, 31.383831661792982, 37.82547845578228, 0.13934799999999992, 110.0, 691, 956626, 1291, 36.96021929999915
1292, 4.4363740678148185, 31.161768782827266, 37.45573345868421, 0.1385928999999999, 210.0, 987, 957613, 1292, 53.12653030000001
1293, 4.3151954574403915, 31.15776566123586, 37.4711740181526, 0.1379206, 30.0, 507, 958120, 1293, 27.296114700002363
1294, 3.454153625974346, 31.21416618261727, 37.51197276787639, 0.13700934999999997, 515.0, 1518, 959638, 1294, 81.13613729999997
1295, 3.885527843617034, 31.4227496086338, 37.741797986800506, 0.13599459999999994, 150.0, 737, 960375, 1295, 39.95873019999999
1296, 4.761011730948648, 31.558399306581958, 37.9197016244795, 0.13512924999999995, 245.0, 1186, 961561, 1296, 63.454907499999536
1297, 6.616278723979643, 31.619117808632414, 38.09713572758773, 0.13418919999999995, 295.0, 903, 962464, 1297, 48.4875346000008
1298, 3.7904822123868973, 31.547271508322492, 37.911325901049345, 0.1334943999999999, 180.0, 641, 963105, 1298, 34.87684739999895
1299, 5.5799576827378745, 31.57002083631734, 37.938772984279595, 0.13274649999999993, 265.0, 1021, 964126, 1299, 55.15122530000008
1300, 3.247687495117845, 31.70696880029068, 38.05953924850607, 0.13195089999999995, 160.0, 747, 964873, 1300, 40.41990789999909
1301, 6.737492073496634, 31.762670679525897, 38.266556002876975, 0.13129794999999997, 200.0, 704, 965577, 1301, 38.3473355999995
1302, 3.194375445092257, 31.635909048006482, 37.996562679842135, 0.13059819999999997, 430.0, 851, 966428, 1302, 46.56340840000121
1303, 4.321899164646685, 31.5680471204973, 37.94578679339155, 0.12976479999999993, 255.0, 1001, 967429, 1303, 47.35645110000041
1304, 4.224465323447049, 31.73135280609131, 38.09347487703155, 0.12902994999999995, 115.0, 632, 968061, 1304, 28.93705829999817
1305, 3.473142167574715, 31.63894863420976, 38.00844240736687, 0.12851064999999998, 85.0, 522, 968583, 1305, 24.127879299998312
1306, 3.60391629055662, 31.59026199787084, 37.96754485388843, 0.12787569999999993, 205.0, 889, 969472, 1306, 41.17199089999849
1307, 7.168303025132489, 31.66388822737194, 38.13078958647592, 0.12724884999999994, 35.0, 504, 969976, 1307, 23.798208199998044
1308, 5.909475688755329, 31.35455435651788, 37.678405137655375, 0.12672909999999993, 100.0, 651, 970627, 1308, 29.878293600002507
1309, 3.60474185175567, 31.37423225117621, 37.71458168208042, 0.12595464999999992, 145.0, 1070, 971697, 1309, 48.82317080000212
1310, 5.460581879129898, 31.385515972026216, 37.73810527664106, 0.12494844999999993, 205.0, 1166, 972863, 1310, 53.287765600001876
1311, 4.493450827521307, 31.342142116405345, 37.654787402682835, 0.12411999999999992, 140.0, 675, 973538, 1311, 31.217737200000556
1312, 2.908377885909713, 31.336010602055765, 37.616345440611546, 0.12359574999999991, 65.0, 490, 974028, 1312, 22.728626500000246
1313, 4.661558855253496, 31.347441351998334, 37.7020750106779, 0.12295314999999994, 365.0, 938, 974966, 1313, 43.173062600002595
1314, 6.085630734909333, 31.374489491193376, 37.74481470165625, 0.12202434999999992, 185.0, 1126, 976092, 1314, 51.56297579999955
1315, 3.341404845819194, 31.2221143073224, 37.469497838933414, 0.12130614999999997, 5.0, 470, 976562, 1315, 21.942119899998943
1316, 8.744864933764223, 31.46377528255636, 37.844896392388776, 0.12093624999999991, 30.0, 352, 976914, 1316, 16.557695700001204
1317, 5.0229723416268826, 31.399260544054435, 37.67990025029038, 0.1204808499999999, 100.0, 660, 977574, 1317, 31.194338099998276
1318, 4.1501657669735215, 31.386318472516795, 37.727497676577734, 0.11989314999999995, 165.0, 646, 978220, 1318, 29.561714800001937
1319, 6.253220028481977, 31.414741548610703, 37.80108694074038, 0.11925909999999995, 190.0, 763, 978983, 1319, 35.36562860000049
1320, 5.262403692413344, 31.26377370894125, 37.549452814281494, 0.11859984999999994, 135.0, 702, 979685, 1320, 32.362328200000775
1321, 4.734114019620582, 31.300431799232413, 37.5986007270463, 0.11779344999999991, 510.0, 1090, 980775, 1321, 50.35202729999946
1322, 7.205863427671587, 31.297863009553517, 37.62679355929357, 0.11701314999999991, 100.0, 644, 981419, 1322, 30.629367800000182
1323, 4.745695446451158, 31.306000430511073, 37.5939560069788, 0.11620809999999994, 245.0, 1145, 982564, 1323, 52.636726999997336
1324, 4.3960877157109595, 31.240952668916663, 37.54564931740087, 0.11528829999999993, 310.0, 899, 983463, 1324, 41.5692988999981
1325, 4.1491232811570615, 31.05417972180381, 37.34897941261975, 0.11464254999999997, 80.0, 536, 983999, 1325, 25.139310400001705
1326, 4.819967462271187, 31.320193596702207, 37.667304707083474, 0.11389644999999991, 360.0, 1122, 985121, 1326, 51.6667372999982
1327, 7.229367896994596, 31.20009857608426, 37.49104037336124, 0.11322415000000002, 45.0, 372, 985493, 1327, 17.99248979999902
1328, 7.1808170345383, 31.234940616651983, 37.61670544192235, 0.11255319999999992, 135.0, 1119, 986612, 1328, 52.188970100000006
1329, 5.909327637329891, 31.22235173260969, 37.573371622527254, 0.11153079999999993, 340.0, 1153, 987765, 1329, 53.38091340000028
1330, 5.51013516485691, 31.232057932670543, 37.58408356976035, 0.11067219999999993, 225.0, 755, 988520, 1330, 35.43124480000188
1331, 2.888210087749861, 31.218215632559684, 37.44109905552743, 0.11015514999999992, 20.0, 394, 988914, 1331, 18.90542540000024
1332, 4.167752620558032, 31.2713812347007, 37.53992770484767, 0.1096727499999999, 100.0, 678, 989592, 1332, 32.1699234000007
1333, 4.746134360719648, 31.244190017648993, 37.54329562091187, 0.10869714999999985, 595.0, 1490, 991082, 1333, 69.76314900000216
1334, 7.198142862622022, 31.39226400189111, 37.77400327996064, 0.10766259999999994, 165.0, 809, 991891, 1334, 38.00742100000207
1335, 5.0798159765448165, 31.2218961501504, 37.49535260327997, 0.10687779999999991, 225.0, 935, 992826, 1335, 43.710293700001785
1336, 4.130130209209453, 31.269225381152463, 37.551348759868354, 0.10600254999999995, 250.0, 1010, 993836, 1336, 48.51481150000109
1337, 7.050870625565078, 31.365153672755554, 37.75421361612612, 0.10517499999999996, 115.0, 829, 994665, 1337, 39.276516099998844
1338, 5.281563836612604, 31.28097412721166, 37.620156165188966, 0.10451574999999992, 200.0, 636, 995301, 1338, 30.37444520000281
1339, 4.486360866876972, 31.40703554851253, 37.74725820244365, 0.10398969999999998, 60.0, 533, 995834, 1339, 25.816829600000347
1340, 6.291597281513749, 31.382164893685207, 37.781822691669326, 0.10356129999999995, 35.0, 419, 996253, 1340, 20.09784419999778
1341, 5.36459095241538, 31.3471521578337, 37.710574839584055, 0.10304784999999993, 145.0, 722, 996975, 1341, 34.84952080000221
1342, 5.251731323625232, 31.343888136694662, 37.64837533574439, 0.10205019999999991, 645.0, 1495, 998470, 1342, 70.1743037999986
1343, 6.764726642559078, 31.264313988507112, 37.59114605092747, 0.1012091499999999, 75.0, 374, 998844, 1343, 17.937006800002564
1344, 4.27405803189083, 31.195644267634865, 37.48419723046748, 0.10052289999999997, 420.0, 1151, 999995, 1344, 54.42829339999662
