,loss,mae,mean_q,mean_eps,episode_reward,nb_episode_steps,nb_steps,episode,duration
0,0,0,0,0,85.0,508,508,0,1.1452660999999988
1, 0, 0, 0, 0, 440.0, 1256, 1764, 1, 2.6489495000000005
2, 0, 0, 0, 0, 125.0, 659, 2423, 2, 1.4248695999999992
3, 0, 0, 0, 0, 415.0, 1275, 3698, 3, 2.5217646999999985
4, 0, 0, 0, 0, 110.0, 719, 4417, 4, 1.4387085000000006
5, 0, 0, 0, 0, 160.0, 661, 5078, 5, 1.3509305000000005
6, 0, 0, 0, 0, 50.0, 509, 5587, 6, 1.038617200000001
7, 0, 0, 0, 0, 230.0, 914, 6501, 7, 1.9063601000000006
8, 0, 0, 0, 0, 65.0, 380, 6881, 8, 0.7935032
9, 0, 0, 0, 0, 120.0, 506, 7387, 9, 1.0387002999999986
10, 0, 0, 0, 0, 210.0, 754, 8141, 10, 1.5166277000000008
11, 0, 0, 0, 0, 120.0, 585, 8726, 11, 1.1935386000000001
12, 0, 0, 0, 0, 120.0, 751, 9477, 12, 1.5362496000000014
13, 0, 0, 0, 0, 50.0, 369, 9846, 13, 0.7681112999999975
14, 0, 0, 0, 0, 125.0, 583, 10429, 14, 1.1824604999999977
15, 0, 0, 0, 0, 30.0, 364, 10793, 15, 0.7574597999999995
16, 0, 0, 0, 0, 110.0, 513, 11306, 16, 1.0587505000000021
17, 0, 0, 0, 0, 110.0, 492, 11798, 17, 1.0134016000000017
18, 0, 0, 0, 0, 60.0, 531, 12329, 18, 1.099041200000002
19, 0, 0, 0, 0, 50.0, 409, 12738, 19, 0.8523959999999988
20, 0, 0, 0, 0, 140.0, 858, 13596, 20, 1.7266125000000017
21, 0, 0, 0, 0, 80.0, 522, 14118, 21, 1.0696579000000028
22, 0, 0, 0, 0, 80.0, 440, 14558, 22, 0.9186461999999977
23, 0, 0, 0, 0, 210.0, 786, 15344, 23, 1.5894560999999996
24, 0, 0, 0, 0, 210.0, 815, 16159, 24, 1.6437083000000001
25, 0, 0, 0, 0, 35.0, 438, 16597, 25, 0.9008676999999992
26, 0, 0, 0, 0, 60.0, 371, 16968, 26, 0.7733131000000029
27, 0, 0, 0, 0, 615.0, 1193, 18161, 27, 2.388052199999997
28, 0, 0, 0, 0, 135.0, 719, 18880, 28, 1.4584292999999988
29, 0, 0, 0, 0, 180.0, 819, 19699, 29, 1.6486878999999988
30, 0, 0, 0, 0, 185.0, 972, 20671, 30, 1.961247499999999
31, 0, 0, 0, 0, 110.0, 621, 21292, 31, 1.2611187999999984
32, 0, 0, 0, 0, 20.0, 456, 21748, 32, 0.9333767000000037
33, 0, 0, 0, 0, 100.0, 392, 22140, 33, 0.8339783999999995
34, 0, 0, 0, 0, 55.0, 511, 22651, 34, 1.0495687999999959
35, 0, 0, 0, 0, 385.0, 732, 23383, 35, 1.5198903000000001
36, 0, 0, 0, 0, 55.0, 398, 23781, 36, 0.8164517000000018
37, 0, 0, 0, 0, 20.0, 418, 24199, 37, 0.8585867999999977
38, 0, 0, 0, 0, 20.0, 481, 24680, 38, 0.9807142000000013
39, 0, 0, 0, 0, 230.0, 868, 25548, 39, 1.7306662000000017
40, 0, 0, 0, 0, 155.0, 727, 26275, 40, 1.477316800000004
41, 0, 0, 0, 0, 135.0, 675, 26950, 41, 1.3661670999999984
42, 0, 0, 0, 0, 215.0, 843, 27793, 42, 1.6991881999999947
43, 0, 0, 0, 0, 35.0, 397, 28190, 43, 0.8315637999999979
44, 0, 0, 0, 0, 210.0, 902, 29092, 44, 1.8118555000000072
45, 0, 0, 0, 0, 135.0, 745, 29837, 45, 1.5156432999999936
46, 0, 0, 0, 0, 140.0, 736, 30573, 46, 1.5007944000000037
47, 0, 0, 0, 0, 380.0, 1353, 31926, 47, 2.657412899999997
48, 0, 0, 0, 0, 135.0, 491, 32417, 48, 0.9999605999999943
49, 0, 0, 0, 0, 215.0, 1003, 33420, 49, 2.0178863999999948
50, 0, 0, 0, 0, 425.0, 836, 34256, 50, 1.6743945000000053
51, 0, 0, 0, 0, 195.0, 744, 35000, 51, 1.538746500000002
52, 0, 0, 0, 0, 60.0, 470, 35470, 52, 0.9673930999999953
53, 0, 0, 0, 0, 190.0, 763, 36233, 53, 1.5728201000000013
54, 0, 0, 0, 0, 185.0, 596, 36829, 54, 1.2149933000000033
55, 0, 0, 0, 0, 230.0, 625, 37454, 55, 1.276516700000002
56, 0, 0, 0, 0, 140.0, 553, 38007, 56, 1.1354544000000004
57, 0, 0, 0, 0, 130.0, 973, 38980, 57, 1.9512047999999993
58, 0, 0, 0, 0, 80.0, 399, 39379, 58, 0.8318670000000026
59, 0, 0, 0, 0, 210.0, 798, 40177, 59, 1.6435490000000073
60, 0, 0, 0, 0, 100.0, 576, 40753, 60, 1.1768788999999913
61, 0, 0, 0, 0, 120.0, 478, 41231, 61, 0.9789808999999963
62, 0, 0, 0, 0, 75.0, 608, 41839, 62, 1.2475017000000008
63, 0, 0, 0, 0, 120.0, 558, 42397, 63, 1.1283493999999905
64, 0, 0, 0, 0, 135.0, 642, 43039, 64, 1.3282692000000083
65, 0, 0, 0, 0, 70.0, 548, 43587, 65, 1.1386427000000054
66, 0, 0, 0, 0, 125.0, 519, 44106, 66, 1.0546561999999966
67, 0, 0, 0, 0, 145.0, 905, 45011, 67, 1.8335487000000086
68, 0, 0, 0, 0, 50.0, 385, 45396, 68, 0.7947020000000009
69, 0, 0, 0, 0, 45.0, 646, 46042, 69, 1.3219477000000097
70, 0, 0, 0, 0, 150.0, 814, 46856, 70, 1.6543537999999955
71, 0, 0, 0, 0, 340.0, 1024, 47880, 71, 2.073396299999999
72, 0, 0, 0, 0, 290.0, 815, 48695, 72, 1.6762019000000095
73, 0, 0, 0, 0, 135.0, 600, 49295, 73, 1.2277533999999974
74, 0, 0, 0, 0, 125.0, 463, 49758, 74, 0.9547641999999996
75, 0, 0, 0, 0, 250.0, 1046, 50804, 75, 2.0910372000000024
76, 0, 0, 0, 0, 125.0, 667, 51471, 76, 1.3578061000000048
77, 0, 0, 0, 0, 105.0, 630, 52101, 77, 1.3064911000000023
78, 0, 0, 0, 0, 165.0, 644, 52745, 78, 1.312175499999995
79, 0, 0, 0, 0, 145.0, 958, 53703, 79, 1.9222078999999894
80, 0, 0, 0, 0, 210.0, 699, 54402, 80, 1.4559466999999984
81, 0, 0, 0, 0, 370.0, 939, 55341, 81, 1.8841305999999918
82, 0, 0, 0, 0, 65.0, 613, 55954, 82, 1.2590821999999946
83, 0, 0, 0, 0, 30.0, 337, 56291, 83, 0.7075370000000021
84, 0, 0, 0, 0, 80.0, 550, 56841, 84, 1.1194785999999937
85, 0, 0, 0, 0, 180.0, 641, 57482, 85, 1.3131271000000027
86, 0, 0, 0, 0, 120.0, 623, 58105, 86, 1.2752411999999822
87, 0, 0, 0, 0, 490.0, 1242, 59347, 87, 2.4743351999999845
88, 0, 0, 0, 0, 50.0, 392, 59739, 88, 0.8265590000000032
89, 0, 0, 0, 0, 55.0, 467, 60206, 89, 0.9507138000000168
90, 0, 0, 0, 0, 215.0, 1012, 61218, 90, 2.0234793000000195
91, 0, 0, 0, 0, 180.0, 543, 61761, 91, 1.1065333999999893
92, 0, 0, 0, 0, 500.0, 944, 62705, 92, 1.8933590999999979
93, 0, 0, 0, 0, 85.0, 543, 63248, 93, 1.1226522999999986
94, 0, 0, 0, 0, 185.0, 516, 63764, 94, 1.0632393000000206
95, 0, 0, 0, 0, 230.0, 850, 64614, 95, 1.7022533000000237
96, 0, 0, 0, 0, 125.0, 580, 65194, 96, 1.2004911999999877
97, 0, 0, 0, 0, 110.0, 665, 65859, 97, 1.352304299999986
98, 0, 0, 0, 0, 65.0, 402, 66261, 98, 0.8364117000000135
99, 0, 0, 0, 0, 85.0, 548, 66809, 99, 1.1220744000000025
100, 0, 0, 0, 0, 200.0, 918, 67727, 100, 1.8334407000000112
101, 0, 0, 0, 0, 80.0, 525, 68252, 101, 1.0610189999999875
102, 0, 0, 0, 0, 275.0, 830, 69082, 102, 1.697053000000011
103, 0, 0, 0, 0, 230.0, 640, 69722, 103, 1.3165620000000047
104, 0, 0, 0, 0, 145.0, 690, 70412, 104, 1.4087379999999996
105, 0, 0, 0, 0, 150.0, 661, 71073, 105, 1.3505712999999844
106, 0, 0, 0, 0, 630.0, 1231, 72304, 106, 2.395546199999984
107, 0, 0, 0, 0, 165.0, 647, 72951, 107, 1.3109426999999982
108, 0, 0, 0, 0, 30.0, 556, 73507, 108, 1.1389852999999732
109, 0, 0, 0, 0, 135.0, 604, 74111, 109, 1.213415700000013
110, 0, 0, 0, 0, 35.0, 522, 74633, 110, 1.0737340999999958
111, 0, 0, 0, 0, 55.0, 382, 75015, 111, 0.8012194000000079
112, 0, 0, 0, 0, 105.0, 684, 75699, 112, 1.405845400000004
113, 0, 0, 0, 0, 170.0, 914, 76613, 113, 1.8395473999999865
114, 0, 0, 0, 0, 50.0, 561, 77174, 114, 1.1691085000000214
115, 0, 0, 0, 0, 140.0, 862, 78036, 115, 1.7410162000000184
116, 0, 0, 0, 0, 80.0, 665, 78701, 116, 1.35666710000001
117, 0, 0, 0, 0, 180.0, 715, 79416, 117, 1.4329481000000044
118, 0, 0, 0, 0, 110.0, 569, 79985, 118, 1.1738980000000083
119, 0, 0, 0, 0, 120.0, 586, 80571, 119, 1.2007297999999764
120, 0, 0, 0, 0, 155.0, 628, 81199, 120, 1.238867899999974
121, 0, 0, 0, 0, 150.0, 818, 82017, 121, 1.6804110999999864
122, 0, 0, 0, 0, 225.0, 714, 82731, 122, 1.438869899999986
123, 0, 0, 0, 0, 80.0, 376, 83107, 123, 0.7848914999999863
124, 0, 0, 0, 0, 365.0, 1038, 84145, 124, 2.0758458999999903
125, 0, 0, 0, 0, 230.0, 1262, 85407, 125, 2.6618905999999924
126, 0, 0, 0, 0, 80.0, 553, 85960, 126, 1.1713504999999884
127, 0, 0, 0, 0, 45.0, 420, 86380, 127, 0.9136033000000054
128, 0, 0, 0, 0, 75.0, 490, 86870, 128, 1.068710899999985
129, 0, 0, 0, 0, 45.0, 430, 87300, 129, 0.9368262000000129
130, 0, 0, 0, 0, 135.0, 535, 87835, 130, 1.1484703000000138
131, 0, 0, 0, 0, 55.0, 490, 88325, 131, 1.0482392000000118
132, 0, 0, 0, 0, 60.0, 388, 88713, 132, 0.8479020999999989
133, 0, 0, 0, 0, 430.0, 1263, 89976, 133, 2.588535699999994
134, 0, 0, 0, 0, 90.0, 470, 90446, 134, 0.9911856999999884
135, 0, 0, 0, 0, 135.0, 729, 91175, 135, 1.534797999999995
136, 0, 0, 0, 0, 220.0, 1110, 92285, 136, 2.3121150000000057
137, 0, 0, 0, 0, 125.0, 595, 92880, 137, 1.258613500000024
138, 0, 0, 0, 0, 110.0, 552, 93432, 138, 1.1768626999999867
139, 0, 0, 0, 0, 75.0, 533, 93965, 139, 1.1546347000000026
140, 0, 0, 0, 0, 80.0, 470, 94435, 140, 1.0279427000000112
141, 0, 0, 0, 0, 140.0, 779, 95214, 141, 1.6811925000000087
142, 0, 0, 0, 0, 30.0, 576, 95790, 142, 1.234472199999999
143, 0, 0, 0, 0, 125.0, 571, 96361, 143, 1.22259489999999
144, 0, 0, 0, 0, 180.0, 647, 97008, 144, 1.3695281999999906
145, 0, 0, 0, 0, 105.0, 790, 97798, 145, 1.696013100000016
146, 0, 0, 0, 0, 210.0, 799, 98597, 146, 1.6682608999999786
147, 0, 0, 0, 0, 265.0, 859, 99456, 147, 1.7705047000000036
148, 455.74957412143925, 26.725260140760888, 50.38274244992238, 0.90995185, 130.0, 651, 100107, 148, 2.5596533999999735
149, 20.02134845695135, 36.89874797342569, 46.03672988472116, 0.9093803499999991, 225.0, 1164, 101271, 149, 11.042859099999987
150, 13.384367960773103, 37.09898552829272, 45.33889340701168, 0.90859375, 125.0, 584, 101855, 150, 5.601295100000016
151, 14.615838951983694, 37.08674105771742, 45.28038795744183, 0.9080919999999999, 80.0, 531, 102386, 151, 5.084719100000001
152, 13.136584823557685, 36.85001165370293, 44.91698786567902, 0.9075484000000003, 135.0, 677, 103063, 152, 6.49311130000001
153, 10.241748113632202, 36.95211310646751, 44.843231416182086, 0.9069962499999997, 55.0, 550, 103613, 153, 5.287000699999993
154, 13.773239662746589, 36.99625851114591, 45.04257804950078, 0.9063167499999994, 215.0, 960, 104573, 154, 9.177190600000017
155, 13.693104995107188, 36.86832468100736, 44.77890310318339, 0.90560665, 55.0, 618, 105191, 155, 6.0131823000000395
156, 13.771952486418662, 36.99010728267913, 44.77597243735131, 0.9051593500000004, 105.0, 376, 105567, 156, 3.6499603999999977
157, 12.789208240779496, 37.01274379819595, 44.82127059579042, 0.9046252000000001, 210.0, 811, 106378, 157, 7.791383900000028
158, 12.555106862386067, 36.92430380079481, 44.796625247531466, 0.9040577499999997, 85.0, 450, 106828, 158, 4.358440299999984
159, 10.493835610854052, 36.90502315837743, 44.67553498963602, 0.9034430499999995, 425.0, 916, 107744, 159, 8.815791499999989
160, 12.40490289996652, 36.85263106402229, 44.63668653343906, 0.90270955, 180.0, 714, 108458, 160, 6.917469199999971
161, 10.744427272767732, 36.79352679975105, 44.5115613301595, 0.9020912500000003, 80.0, 660, 109118, 161, 6.438388400000008
162, 14.700374044209159, 36.95398280321262, 44.85779152081642, 0.9014823999999998, 110.0, 693, 109811, 162, 6.732095700000002
163, 10.441803705568114, 36.936866809924446, 44.6696950395902, 0.9009977499999998, 35.0, 384, 110195, 163, 3.7973122999999873
164, 9.853923742055892, 37.04253140258789, 44.815553413391115, 0.90059995, 105.0, 500, 110695, 164, 4.8969222999999715
165, 8.184789755980173, 37.02621344502767, 44.77848247273763, 0.9000374500000002, 120.0, 750, 111445, 165, 7.363841200000024
166, 8.448331535672365, 36.961836540180705, 44.734968429026395, 0.8993687500000006, 155.0, 736, 112181, 166, 7.230872999999974
167, 8.43829208753594, 36.978593183667336, 44.82359186260769, 0.8986194999999998, 230.0, 929, 113110, 167, 9.061921499999983
168, 5.2589898558866555, 36.95871404052931, 44.66254329988044, 0.8979215500000002, 110.0, 622, 113732, 168, 6.064926599999978
169, 9.389129135329807, 37.073142599381185, 44.85537790875289, 0.8972146000000006, 285.0, 949, 114681, 169, 9.252825700000017
170, 6.710424903119438, 36.8808599241595, 44.60871529272712, 0.8966125000000001, 50.0, 389, 115070, 170, 3.8449699000000237
171, 6.750413078513135, 36.92348289907109, 44.55749985843049, 0.89602615, 225.0, 914, 115984, 171, 9.07040539999997
172, 7.182896076368308, 37.001569577963046, 44.83217537217632, 0.8952966999999996, 145.0, 707, 116691, 172, 6.979836000000034
173, 7.469880483662896, 36.93972040019216, 44.5758621963467, 0.8945744500000008, 210.0, 898, 117589, 173, 8.853555900000003
174, 6.830919364205113, 37.00936898125543, 44.72139213703297, 0.8939273500000002, 80.0, 540, 118129, 174, 5.340007500000013
175, 8.239800982598055, 37.058166282121526, 44.75710309304272, 0.8934134500000002, 180.0, 602, 118731, 175, 6.039157900000021
176, 6.464578206783959, 36.90911604676928, 44.49963582697369, 0.8928401499999995, 90.0, 672, 119403, 176, 6.7154773999999975
177, 6.450560871503822, 36.86124503234476, 44.50579801321534, 0.8921120499999995, 460.0, 946, 120349, 177, 9.419164800000033
178, 13.79143625871459, 36.77083706072907, 44.588881432832174, 0.8915355999999997, 30.0, 335, 120684, 178, 3.38802400000003
179, 8.235441600186963, 36.704347694276294, 44.45129118317669, 0.8911288000000003, 110.0, 569, 121253, 179, 5.7411890999999855
180, 5.959275124873789, 36.802028308557155, 44.40854963270039, 0.8906356000000002, 105.0, 527, 121780, 180, 5.284028599999999
181, 8.233821242231745, 36.74327193338526, 44.434578847076935, 0.8900532999999994, 240.0, 767, 122547, 181, 7.6639480999999705
182, 5.9015277169194675, 36.688036061391585, 44.33361606151049, 0.8893431999999997, 230.0, 811, 123358, 182, 8.153410399999984
183, 4.926185369544606, 36.68712854215683, 44.30711203198416, 0.8887253499999997, 45.0, 562, 123920, 183, 5.708732199999986
184, 7.580744785320668, 36.74931211871955, 44.42460040827744, 0.8880008500000004, 255.0, 1048, 124968, 184, 10.532882099999995
185, 6.046463641209331, 36.64415321505167, 44.30977724044303, 0.8870864499999993, 475.0, 984, 125952, 185, 9.942208799999946
186, 5.64798445992377, 36.612142015701366, 44.254399044587124, 0.8863660000000002, 105.0, 617, 126569, 186, 6.2939183999999955
187, 5.619177727210791, 36.67509343570337, 44.303366108944545, 0.8858489499999996, 55.0, 532, 127101, 187, 5.457256700000016
188, 6.783521982644474, 36.638741074848035, 44.32543882203771, 0.8853049000000005, 155.0, 677, 127778, 188, 6.891271300000028
189, 7.987921060587262, 36.61902558589043, 44.30726073395011, 0.8848251999999999, 80.0, 389, 128167, 189, 3.994993999999963
190, 6.951046738534065, 36.70230458960161, 44.3839729533476, 0.8839922499999994, 245.0, 1462, 129629, 190, 14.814987099999996
191, 10.262108610736, 36.70593617560019, 44.51565981527324, 0.8831601999999998, 35.0, 387, 130016, 191, 3.9654544999999644
192, 7.7057676587998865, 37.316728076934815, 45.12463952064514, 0.8828060499999998, 20.0, 400, 130416, 192, 4.097658000000024
193, 11.826829650795272, 37.41399650174286, 45.33732290417736, 0.8824541500000002, 30.0, 382, 130798, 193, 3.8629442000000154
194, 5.146001843447538, 37.31794983578711, 45.061904690929296, 0.88210765, 125.0, 388, 131186, 194, 4.0006120000000465
195, 7.572465348321122, 37.35425547314929, 45.18224411010742, 0.8815865499999996, 135.0, 770, 131956, 195, 7.827116700000033
196, 7.868378966878837, 37.322483900902974, 45.17100006963166, 0.88092055, 210.0, 710, 132666, 196, 7.354760599999963
197, 5.203109763141972, 37.305443296449866, 45.02758345751597, 0.8803539999999997, 50.0, 549, 133215, 197, 5.680144600000062
198, 6.728463813915091, 37.15846393606757, 44.95466970454502, 0.8799476500000001, 80.0, 354, 133569, 198, 3.6794172999999546
199, 4.2184990023383655, 37.18534534638771, 44.914012268299366, 0.8796115000000003, 80.0, 393, 133962, 199, 4.067448799999966
200, 8.143392054902183, 37.29222951818396, 45.17693065360741, 0.87919165, 75.0, 540, 134502, 200, 5.587366100000054
201, 7.368483737151257, 37.297761528104246, 45.06692620728965, 0.8784477999999991, 290.0, 1113, 135615, 201, 11.479036599999972
202, 9.045139355307457, 37.25142872957575, 45.111114870621854, 0.8776117000000003, 155.0, 745, 136360, 202, 7.72925859999998
203, 7.863398283527329, 37.28638917413251, 45.08964153404894, 0.8768588500000004, 260.0, 928, 137288, 203, 9.617361399999936
204, 5.052600199953089, 37.25696711548052, 45.02338388753055, 0.8761671999999997, 80.0, 609, 137897, 204, 6.390873000000056
205, 7.165475449123284, 37.23571056135219, 45.026065143992696, 0.8755434999999997, 355.0, 777, 138674, 205, 8.071706600000084
206, 6.520756067266428, 37.17848182113437, 44.96776553528521, 0.8748352000000005, 155.0, 797, 139471, 206, 8.296693400000095
207, 8.228589238019179, 37.41963822320597, 45.27567092946033, 0.8742047500000004, 135.0, 604, 140075, 207, 6.297403299999928
208, 5.177813289719715, 38.28026864682025, 46.108274063868826, 0.8736251500000001, 95.0, 684, 140759, 208, 7.199697300000025
209, 5.041419556284968, 38.19086651553475, 46.00096909581767, 0.8731274499999995, 55.0, 422, 141181, 209, 4.491975899999943
210, 6.417197553270381, 38.164300839819646, 46.14178848951467, 0.8726869000000005, 45.0, 557, 141738, 210, 5.846289899999988
211, 7.596280729008275, 38.1707890976307, 46.13129384240439, 0.8722427500000002, 55.0, 430, 142168, 211, 4.522334799999953
212, 6.697164851770126, 38.23940658569336, 46.21064176490839, 0.8718615999999997, 50.0, 417, 142585, 212, 4.349362299999939
213, 5.4402807714229215, 38.15244794695565, 46.0101956228192, 0.8712734500000004, 250.0, 890, 143475, 213, 9.363488599999982
214, 6.299244057592236, 38.29200947221177, 46.24579695232384, 0.8703662499999995, 335.0, 1126, 144601, 214, 11.838314999999966
215, 5.959241433827193, 38.117415912334735, 46.03816712386124, 0.8695377999999999, 85.0, 715, 145316, 215, 7.574174800000037
216, 6.874727713203506, 38.20337462727028, 46.09259333791612, 0.8689316499999997, 190.0, 632, 145948, 216, 6.712500299999988
217, 6.644413816374402, 38.195522747483366, 46.12229079313057, 0.8682602500000004, 170.0, 860, 146808, 217, 9.179469900000072
218, 6.242913191327973, 38.21572950453985, 46.12236812531002, 0.8675897499999997, 105.0, 630, 147438, 218, 6.733010199999967
219, 3.715097568617574, 38.1739581075458, 45.98134338175843, 0.8670695500000004, 50.0, 526, 147964, 219, 5.6117411000000175
220, 7.934901763516736, 38.21188179843397, 46.21788025668347, 0.86660875, 95.0, 498, 148462, 220, 5.358431300000007
221, 3.9030384100410673, 38.13290659586588, 45.967990125868056, 0.8658784000000002, 265.0, 1125, 149587, 221, 12.005919900000094
222, 6.469439300302228, 38.2748249857645, 46.217182204702134, 0.8650688499999999, 125.0, 674, 150261, 222, 7.2959022000000004
223, 5.022389901968677, 38.57617800193065, 46.55044535663732, 0.8644136499999993, 155.0, 782, 151043, 223, 8.374555800000053
224, 5.615093848931468, 38.60098032540503, 46.56694797021187, 0.8635447000000008, 455.0, 1149, 152192, 224, 12.323575099999971
225, 5.117564124353933, 38.62810236552976, 46.56962685315114, 0.8628368500000002, 30.0, 424, 152616, 225, 4.619042799999988
226, 5.429180860250574, 38.695742125363694, 46.66956700983736, 0.8624714500000003, 50.0, 388, 153004, 226, 4.204663500000038
227, 3.639119777757271, 38.496821903625616, 46.388702186049926, 0.8618729499999994, 255.0, 942, 153946, 227, 10.208130400000073
228, 7.326461029652307, 38.54039556175999, 46.6089784182035, 0.8611448500000001, 125.0, 676, 154622, 228, 7.3464495000000625
229, 5.47163913702824, 38.60387922351085, 46.52066632166004, 0.8603452000000004, 315.0, 1101, 155723, 229, 11.88705809999999
230, 6.412907212518191, 38.53241301118658, 46.51810034052327, 0.8595694000000002, 120.0, 623, 156346, 230, 6.8049747000000025
231, 7.801441247438647, 38.57484727839834, 46.70542967491543, 0.8590707999999997, 105.0, 485, 156831, 231, 5.295022899999935
232, 4.884329688608121, 38.525280586948476, 46.411544690573265, 0.8586482500000003, 80.0, 454, 157285, 232, 4.993383999999992
233, 4.7087809395073625, 38.48825283001756, 46.376548396352, 0.8582680000000003, 35.0, 391, 157676, 233, 4.313849799999957
234, 5.075976958323327, 38.45236576824001, 46.35259272507163, 0.8577712000000001, 180.0, 713, 158389, 234, 7.785223500000029
235, 4.818525068740318, 38.53991334855289, 46.52516316868621, 0.8571493000000004, 110.0, 669, 159058, 235, 7.300403700000061
236, 5.3223365384986865, 38.629430490944095, 46.54810843385124, 0.8563545999999996, 240.0, 1097, 160155, 236, 11.978826299999923
237, 5.439158005944526, 39.286200382754245, 47.32851038669453, 0.8556931, 75.0, 373, 160528, 237, 4.083476700000006
238, 6.2972831731705075, 39.29877805929579, 47.40659194102485, 0.8550370000000007, 145.0, 1085, 161613, 238, 11.896101700000031
239, 5.205229085572172, 39.27552380960338, 47.371221003683566, 0.8542364500000004, 105.0, 694, 162307, 239, 7.667612299999973
240, 6.068908290316661, 39.243922843933106, 47.37262748082479, 0.8536541499999999, 155.0, 600, 162907, 240, 6.635822599999983
241, 3.59477311889641, 39.211561226844786, 47.23053325414658, 0.8530961500000002, 110.0, 640, 163547, 241, 7.139187500000048
242, 6.691409968863334, 39.231141704696796, 47.33922933028625, 0.8524085500000008, 290.0, 888, 164435, 242, 9.784450500000048
243, 4.654667365513429, 39.33221994127546, 47.44887536313353, 0.85179475, 65.0, 476, 164911, 243, 5.307274199999938
244, 5.642807110745436, 39.237118991924696, 47.33906105673237, 0.8512272999999999, 105.0, 785, 165696, 244, 8.721679999999992
245, 5.963228233267621, 39.202012359805224, 47.27916138811809, 0.8505050499999994, 165.0, 820, 166516, 245, 9.118515799999955
246, 5.5869469186815435, 39.27395465738332, 47.37730312603089, 0.8498003500000001, 210.0, 746, 167262, 246, 8.32165980000002
247, 6.482647213831912, 39.33315999419601, 47.46814014882217, 0.8491730499999997, 135.0, 648, 167910, 247, 7.239202500000033
248, 6.661468095974167, 39.271010264783804, 47.36927033981474, 0.8486542000000001, 65.0, 505, 168415, 248, 5.6641769000000295
249, 5.144440837214045, 39.209484512741504, 47.2636954406974, 0.8480772999999999, 205.0, 777, 169192, 249, 8.698009999999954
250, 5.438284745456976, 39.253138930061176, 47.3592788159665, 0.8474333500000001, 180.0, 654, 169846, 250, 7.308318299999996
251, 4.882942640775089, 39.571761066630735, 47.72693479667276, 0.8469266500000001, 60.0, 472, 170318, 251, 5.320405400000027
252, 4.191636753676374, 39.594134536443974, 47.70014210619958, 0.8464388499999995, 60.0, 612, 170930, 252, 6.890957700000058
253, 5.765408995802756, 39.688176308149174, 47.84570836196711, 0.8457989500000003, 150.0, 810, 171740, 253, 9.113441699999953
254, 3.0139843813776324, 39.64312075432047, 47.73555423740705, 0.8450190999999994, 175.0, 923, 172663, 254, 10.389951499999938
255, 4.186862039177314, 39.67963578597359, 47.83840697578762, 0.8443450000000001, 150.0, 575, 173238, 255, 6.521978699999977
256, 4.31052876409072, 39.62639688382483, 47.75878591355245, 0.8437330000000002, 225.0, 785, 174023, 256, 8.88795319999997
257, 6.2159950838428, 39.59920747703481, 47.82012998023243, 0.8430427000000004, 135.0, 749, 174772, 257, 8.498832799999946
258, 5.610513677154991, 39.64164779976891, 47.83701282295286, 0.8423555499999997, 340.0, 778, 175550, 258, 8.798685000000091
259, 5.736816335280575, 39.65165800206802, 47.834566816596904, 0.8417836000000003, 50.0, 493, 176043, 259, 5.631536099999948
260, 3.652565489667071, 39.54889065234067, 47.62070746075844, 0.8412764500000003, 110.0, 634, 176677, 260, 7.295033999999987
261, 4.4952492125162475, 39.570264400022424, 47.64432232387679, 0.8407148499999993, 135.0, 614, 177291, 261, 6.983906899999852
262, 5.706261139668858, 39.587566086308875, 47.72352962588789, 0.8400767500000003, 210.0, 804, 178095, 262, 9.151285499999858
263, 3.8375596907038703, 39.4602294981949, 47.49944601784854, 0.8395434999999999, 80.0, 381, 178476, 263, 4.397123700000066
264, 5.165980502803573, 39.614706471061126, 47.77862825306184, 0.8390777499999997, 120.0, 654, 179130, 264, 7.494684900000038
265, 6.281024532325467, 39.50010923642587, 47.64163688283265, 0.8383091500000008, 200.0, 1054, 180184, 265, 12.088467099999889
266, 5.906919507608867, 39.18291722687197, 47.26777332467093, 0.8375153500000004, 110.0, 710, 180894, 266, 8.147774100000106
267, 6.481385139550901, 39.16914043282018, 47.255295262192234, 0.83695825, 45.0, 528, 181422, 267, 6.0870046
268, 4.425986831545648, 39.18247848812666, 47.19525015844058, 0.8364249999999994, 155.0, 657, 182079, 268, 7.579627999999957
269, 3.363995719811704, 39.18092377485952, 47.20679567760592, 0.8358111999999998, 110.0, 707, 182786, 269, 8.152341699999852
270, 2.9578194172327756, 39.172006308577444, 47.15967813884939, 0.8352572499999996, 130.0, 524, 183310, 270, 6.057419299999992
271, 5.242667052103923, 39.097611060509315, 47.102856192955606, 0.8347289500000002, 75.0, 650, 183960, 271, 7.560873299999912
272, 3.709128403046634, 39.18291852871577, 47.21416615446409, 0.8340908499999999, 155.0, 768, 184728, 272, 8.933540400000084
273, 5.54425647614595, 39.192395038292055, 47.2199351513972, 0.8335805499999999, 65.0, 366, 185094, 273, 4.2591297000001305
274, 5.8265145421319176, 39.15183597058058, 47.22626809030771, 0.8331854500000001, 125.0, 512, 185606, 274, 6.01643439999998
275, 6.798194135183987, 39.12533322560419, 47.22836395637276, 0.8326058500000004, 210.0, 776, 186382, 275, 8.978525300000001
276, 4.954575322019175, 39.14673377917363, 47.14747570722531, 0.8319758500000006, 160.0, 624, 187006, 276, 7.303493399999979
277, 4.270505940301104, 39.17319470196515, 47.19663817603309, 0.8313953500000001, 150.0, 666, 187672, 277, 7.8702290999999605
278, 4.062055946488802, 39.13479875980463, 47.16850919651806, 0.8308562499999996, 135.0, 532, 188204, 278, 6.280763400000069
279, 3.0544323465875958, 39.12831192680027, 47.11293741640837, 0.8303581000000002, 110.0, 575, 188779, 279, 6.807875700000068
280, 4.545097630042546, 39.16330952486332, 47.205061944139864, 0.8298685, 80.0, 513, 189292, 280, 6.047093199999836
281, 4.433036562733686, 39.15789735708664, 47.196529633251586, 0.82933615, 105.0, 670, 189962, 281, 7.898736900000131
282, 5.2714462319961175, 38.60868655310737, 46.573723225811726, 0.8287592500000003, 110.0, 612, 190574, 282, 7.231007399999953
283, 5.9402657616660175, 38.665857969142266, 46.617370742688074, 0.8282961999999997, 55.0, 417, 190991, 283, 4.949138100000027
284, 2.9216818938693723, 38.54735627607866, 46.45147176064736, 0.8278363, 120.0, 605, 191596, 284, 7.142112499999939
285, 3.3172154546414734, 38.5940565785403, 46.5005197979155, 0.8273939500000002, 80.0, 378, 191974, 285, 4.475302000000056
286, 3.449930082924806, 38.5551027267255, 46.43487611382458, 0.8269165, 155.0, 683, 192657, 286, 8.043957500000033
287, 6.171599357499813, 38.626347975297406, 46.59159095461329, 0.8262577000000004, 210.0, 781, 193438, 287, 9.263811799999985
288, 5.411365305952413, 38.55421050501541, 46.46350826679821, 0.8253950499999997, 390.0, 1136, 194574, 288, 13.391694599999937
289, 3.8799563168149254, 38.53627368487793, 46.38459425971857, 0.8245359999999998, 210.0, 773, 195347, 289, 9.189162699999997
290, 6.630850067663499, 38.60205937834347, 46.56722921483657, 0.8239433499999995, 75.0, 544, 195891, 290, 6.500546499999928
291, 3.9550993616160537, 38.652500862166995, 46.547667219525295, 0.8233961500000004, 110.0, 672, 196563, 291, 8.071141600000146
292, 3.608910639749001, 38.593175446410825, 46.523701393573944, 0.8227400499999998, 120.0, 786, 197349, 292, 9.373980500000016
293, 5.145148271425672, 38.63965917376554, 46.58376543515127, 0.8220686500000002, 130.0, 706, 198055, 293, 8.458306700000094
294, 6.933102338227766, 38.57845452643591, 46.52908633030132, 0.8214152500000005, 160.0, 746, 198801, 294, 8.939168899999913
295, 5.403796447469995, 38.651360681123826, 46.5658205751318, 0.8207906500000002, 225.0, 642, 199443, 295, 7.724034099999926
296, 4.004032677264659, 38.56223733084543, 46.46778795570681, 0.8202560500000001, 90.0, 546, 199989, 296, 6.604538199999979
297, 7.031086468367461, 38.78265214651688, 46.78150608103142, 0.8197128999999994, 135.0, 661, 200650, 297, 8.013645600000018
298, 3.862109220532171, 38.80884696397761, 46.7447902695993, 0.8190005499999996, 165.0, 922, 201572, 298, 11.143436800000018
299, 3.087999174271831, 38.775209140534926, 46.68005829245686, 0.8184087999999996, 75.0, 393, 201965, 299, 4.787190600000031
300, 2.821598295551358, 38.77790195580685, 46.70021872664943, 0.81793495, 150.0, 660, 202625, 300, 8.0682726
301, 3.7441715430125826, 38.78654853356778, 46.73645302261288, 0.8173198, 105.0, 707, 203332, 301, 8.660428700000011
302, 5.0019622900484135, 38.85955255843618, 46.828074352922926, 0.8167122999999994, 155.0, 643, 203975, 302, 7.788951700000098
303, 8.76818108198033, 38.89254299727023, 47.03052092832336, 0.8161273, 140.0, 657, 204632, 303, 8.051944800000001
304, 4.099189827430545, 38.80766739023856, 46.750158126021, 0.8154163000000001, 265.0, 923, 205555, 304, 11.291597299999921
305, 6.738738936620454, 38.82957006295522, 46.874534618854526, 0.81456895, 195.0, 960, 206515, 305, 11.766294799999969
306, 7.422097809396627, 38.903811744515224, 46.91316861451127, 0.8138421999999998, 120.0, 655, 207170, 306, 8.04535850000002
307, 2.821742070128832, 38.73921996488699, 46.676434675139696, 0.8133467500000001, 90.0, 446, 207616, 307, 5.524625600000036
308, 2.967748944625207, 38.775740502216564, 46.6725292467989, 0.8128841499999999, 90.0, 582, 208198, 308, 7.18675549999989
309, 5.653087115386464, 38.84932815349654, 46.864427791368094, 0.8122825000000004, 185.0, 755, 208953, 309, 9.329603000000134
310, 5.608404540977303, 38.847346678449895, 46.84449557899603, 0.8114877999999996, 565.0, 1011, 209964, 310, 12.49955060000002
311, 7.511752127370703, 39.02873435880795, 47.133584935366194, 0.8107385500000002, 180.0, 654, 210618, 311, 8.091433800000004
312, 4.809855922172453, 38.928295615785544, 46.905046797005724, 0.8101333000000002, 375.0, 691, 211309, 312, 8.563818599999877
313, 4.629704896441106, 38.98762547591136, 47.00573689268081, 0.8094682000000004, 135.0, 787, 212096, 313, 9.698723900000005
314, 5.473879868153549, 39.019686059970745, 47.03215830747934, 0.8088877000000001, 105.0, 503, 212599, 314, 6.307806699999901
315, 4.933866488363813, 39.009021073385, 47.020928717386745, 0.8082482499999993, 415.0, 918, 213517, 315, 11.49222009999994
316, 3.388277464615617, 38.97944444291135, 46.935764718563, 0.8074967500000005, 160.0, 752, 214269, 316, 9.416236399999889
317, 4.119723870667047, 39.0076395517874, 47.01254147941889, 0.80674615, 385.0, 916, 215185, 317, 11.508042599999953
318, 6.970938131134207, 39.005130990233944, 47.112003427512235, 0.80607925, 30.0, 566, 215751, 318, 7.146989400000166
319, 5.160533789413276, 39.021706938192544, 47.03408417900097, 0.8055324999999994, 135.0, 649, 216400, 319, 8.165098800000123
320, 4.845820195589946, 38.97043794115013, 46.912117494600956, 0.8050478500000001, 80.0, 428, 216828, 320, 5.392515699999876
321, 6.474228524635267, 38.993550213353494, 46.96580485715977, 0.8044273000000006, 460.0, 951, 217779, 321, 11.940785100000085
322, 5.845001675412059, 39.06313526153564, 47.14929225921631, 0.8038193500000002, 70.0, 400, 218179, 322, 5.117794999999887
323, 3.9673774262789028, 38.97767535541619, 46.97854946604677, 0.8034157000000002, 80.0, 497, 218676, 323, 6.297455900000159
324, 4.377685265591855, 39.046123128028434, 47.03265578276033, 0.8029094499999997, 105.0, 628, 219304, 324, 7.929371200000105
325, 5.741090463016901, 39.035506761562054, 47.106705933286435, 0.8023190500000003, 180.0, 684, 219988, 325, 8.738318199999867
326, 4.1344290845854115, 39.36305276572556, 47.386681246698345, 0.8018299, 80.0, 403, 220391, 326, 5.13970479999989
327, 5.326767579177204, 39.439685658753916, 47.59029039513866, 0.8014059999999995, 95.0, 539, 220930, 327, 6.87613599999986
328, 5.43675294848698, 39.423964706532686, 47.53745834294693, 0.8009177500000004, 105.0, 546, 221476, 328, 6.971878600000082
329, 6.228695175638146, 39.361338247167005, 47.4403776131054, 0.8003084500000001, 180.0, 808, 222284, 329, 10.261584699999958
330, 6.59034141788252, 39.46088279344113, 47.58126923864372, 0.79970995, 110.0, 522, 222806, 330, 6.704181000000062
331, 6.532024262888091, 39.45347726004464, 47.54344657244001, 0.7990813000000004, 130.0, 875, 223681, 331, 11.216831400000046
332, 7.450689593739262, 39.36351986921897, 47.45391419533883, 0.7983496000000001, 145.0, 751, 224432, 332, 9.672946700000011
333, 6.148536641975126, 39.40564062806982, 47.52880471585065, 0.7976314000000001, 115.0, 845, 225277, 333, 10.861355799999956
334, 6.315556206575564, 39.365656442049016, 47.453957429913245, 0.7968749499999994, 215.0, 836, 226113, 334, 10.799020400000018
335, 4.431196824570636, 39.36525650557938, 47.40915441446371, 0.7961770000000002, 155.0, 715, 226828, 335, 9.237454300000081
336, 4.412824074344305, 39.43461037592558, 47.500796324882415, 0.7954781500000001, 330.0, 838, 227666, 336, 10.804231200000004
337, 3.0764429252202574, 39.38915421335321, 47.418054711191274, 0.79475905, 180.0, 760, 228426, 337, 9.854426599999897
338, 4.64297034448156, 39.4070981832651, 47.49793698801797, 0.7941128499999999, 135.0, 676, 229102, 338, 8.805460799999992
339, 5.229403475140816, 39.39359376922928, 47.48062879813872, 0.7934230000000007, 235.0, 857, 229959, 339, 11.095736299999999
340, 6.28947784090584, 39.851191461736505, 48.09514402909712, 0.7927898499999999, 80.0, 550, 230509, 340, 7.213244599999825
341, 3.9816178397032362, 39.786332330874515, 47.90162705431335, 0.7920649, 290.0, 1061, 231570, 341, 13.786572100000058
342, 5.623910137780116, 39.82630672066797, 47.94302134745185, 0.7912999000000001, 55.0, 639, 232209, 342, 8.387445200000002
343, 4.231798528622497, 39.90643033576734, 48.06335712317264, 0.7906411000000005, 145.0, 825, 233034, 343, 10.8046003999998
344, 3.775616212164968, 39.761241044455424, 47.919048177517524, 0.7900484499999997, 15.0, 492, 233526, 344, 6.49083840000003
345, 7.093889180189412, 39.88362219878838, 48.15765376302569, 0.7895633500000001, 155.0, 586, 234112, 345, 7.745424899999989
346, 3.8122250937908735, 39.77377586558386, 47.88151353748922, 0.7891223500000001, 40.0, 394, 234506, 346, 5.191393199999993
347, 5.141410603102749, 39.84878533691813, 48.0326403397292, 0.7886745999999994, 120.0, 601, 235107, 347, 7.875913200000014
348, 4.373451684293148, 39.77304781993992, 47.93570024695513, 0.7879815999999998, 405.0, 939, 236046, 348, 12.400739299999941
349, 4.012090311314971, 39.80438617971492, 47.964304029495324, 0.7871382999999997, 160.0, 935, 236981, 349, 12.300324799999999
350, 4.151605650922744, 39.85261869147272, 47.992361771234194, 0.78626305, 285.0, 1010, 237991, 350, 13.421740699999873
351, 3.9103333161989218, 39.81580425910799, 47.97356444196739, 0.7855808500000006, 50.0, 506, 238497, 351, 6.835788799999818
352, 8.555257638953229, 39.89458123008229, 48.196080577972275, 0.7850575000000003, 180.0, 657, 239154, 352, 8.775197199999866
353, 3.4859448909116306, 39.88362319726738, 48.01497375707832, 0.7844490999999995, 155.0, 695, 239849, 353, 9.264343299999837
354, 4.980048407330614, 39.68127325006122, 47.82693011811133, 0.7838384500000001, 120.0, 662, 240511, 354, 8.880446399999983
355, 2.9138622353671666, 39.70484161376953, 47.77959309087421, 0.7833366999999998, 55.0, 453, 240964, 355, 6.080457699999897
356, 3.610292391161326, 39.62652962905703, 47.70168370280774, 0.7828669, 120.0, 591, 241555, 356, 7.899861900000133
357, 3.838169616971697, 39.67335048857189, 47.83576835995629, 0.7823647000000002, 55.0, 525, 242080, 357, 7.077099500000031
358, 4.498501707874297, 39.64989641809389, 47.733972729094546, 0.7815551500000004, 315.0, 1274, 243354, 358, 17.047188799999958
359, 4.891421675713585, 39.676647922109225, 47.82958538036056, 0.7804499499999996, 185.0, 1182, 244536, 359, 15.821404900000061
360, 4.368023761681148, 39.7023201808616, 47.85487292418739, 0.7795620999999997, 135.0, 791, 245327, 360, 10.691323300000022
361, 3.1514686595777794, 39.631273191433976, 47.7423703527601, 0.7789208499999997, 120.0, 634, 245961, 361, 8.57295769999996
362, 6.126449317379732, 39.73282037600122, 47.904965866294376, 0.7783682500000003, 110.0, 594, 246555, 362, 8.093200900000056
363, 5.590156936924754, 39.667192375910304, 47.7934222675872, 0.7778223999999999, 110.0, 619, 247174, 363, 8.390389600000162
364, 5.436980149952468, 39.70873571224941, 47.84629995418843, 0.7770366999999992, 215.0, 1127, 248301, 364, 15.26219789999982
365, 4.1544025813407295, 39.61886946394197, 47.71577385217429, 0.7761079000000002, 415.0, 937, 249238, 365, 12.778713800000105
366, 4.512358458489446, 39.415699810376104, 47.47886363252971, 0.77518315, 390.0, 1118, 250356, 366, 15.242267299999867
367, 3.9317253778960244, 38.919618447621666, 46.88844424817297, 0.7741616499999993, 375.0, 1152, 251508, 367, 15.783626700000013
368, 4.247408004712284, 38.86777260547548, 46.84072357838548, 0.7734146499999998, 95.0, 508, 252016, 368, 6.982908400000042
369, 4.378004608146938, 38.896013079356756, 46.8568393644482, 0.7729673500000002, 35.0, 486, 252502, 369, 6.73772810000014
370, 5.85372161667181, 38.9024030045618, 46.93987115425399, 0.7724642500000002, 130.0, 632, 253134, 370, 8.745047699999986
371, 4.787073196959682, 38.892455796400704, 46.85216984152794, 0.7720070499999996, 120.0, 384, 253518, 371, 5.299956700000166
372, 4.403363184964224, 38.93150182618238, 46.918617113598444, 0.7713635499999995, 270.0, 1046, 254564, 372, 14.40841219999993
373, 4.46413465445374, 38.92733429813152, 46.91078528331953, 0.77052475, 265.0, 818, 255382, 373, 11.341650999999956
374, 4.025700367136201, 38.86971038005073, 46.854664303929674, 0.76997935, 85.0, 394, 255776, 374, 5.510831599999847
375, 4.240104260904837, 38.86771399343116, 46.84912465848135, 0.7694861500000001, 155.0, 702, 256478, 375, 9.725885000000062
376, 6.2534245152874535, 38.942892937564025, 46.934842706070164, 0.7688579499999998, 120.0, 694, 257172, 376, 9.681808499999988
377, 4.654122774510294, 38.91423879165995, 46.87606715292952, 0.7681478500000006, 195.0, 884, 258056, 377, 12.31588910000005
378, 3.408782486052763, 38.90020198206748, 46.83011186661259, 0.7674710499999998, 80.0, 620, 258676, 378, 8.74266539999985
379, 4.9136970835381835, 38.89744879924793, 46.85984669145638, 0.7666529499999999, 260.0, 1198, 259874, 379, 16.68644919999997
380, 3.757955012030777, 39.370803020039546, 47.41351345875224, 0.7658393500000004, 125.0, 610, 260484, 380, 8.602297700000236
381, 2.74986799224214, 39.406968008000035, 47.42503735527017, 0.7650874000000005, 215.0, 1061, 261545, 381, 14.967164800000319
382, 2.397421651386094, 39.35837011113179, 47.35285520429088, 0.7644376, 80.0, 383, 261928, 382, 5.424041100000068
383, 4.595066317030518, 39.370666977092284, 47.47369933895094, 0.7639714000000002, 155.0, 653, 262581, 383, 9.185181199999988
384, 6.875545395476352, 39.384893973375156, 47.55535487495225, 0.7633116999999993, 410.0, 813, 263394, 384, 11.525680000000193
385, 4.542586617808246, 39.35338244605903, 47.44090593040888, 0.7625876500000003, 210.0, 796, 264190, 385, 11.340806100000009
386, 2.7748983141794366, 39.35790641562453, 47.383850949481854, 0.7620440499999995, 75.0, 412, 264602, 386, 5.899914800000261
387, 4.513823534884333, 39.390723044511475, 47.47061368902642, 0.7615553500000004, 155.0, 674, 265276, 387, 9.550992299999962
388, 4.81533445618622, 39.47214568011295, 47.5549850134446, 0.7609914999999999, 65.0, 579, 265855, 388, 8.228930299999774
389, 3.82668400341001, 39.36754373354212, 47.428996107027466, 0.7604640999999995, 110.0, 593, 266448, 389, 8.508236399999987
390, 3.9934400266988925, 39.35974697642198, 47.432211407963536, 0.7599798999999999, 80.0, 483, 266931, 390, 6.935458899999958
391, 6.496511919449453, 39.44357997423982, 47.53500796204211, 0.7593026500000003, 210.0, 1022, 267953, 391, 14.553262100000211
392, 3.794810206554972, 39.38979969097181, 47.4562946580662, 0.7583693499999999, 390.0, 1052, 269005, 392, 14.954754900000353
393, 5.825701726966147, 39.384368065151584, 47.4525273601644, 0.7576047999999999, 140.0, 647, 269652, 393, 9.268987200000083
394, 5.901291393832317, 39.46192496259447, 47.62777934275882, 0.7570580500000001, 115.0, 568, 270220, 394, 8.208098300000074
395, 4.564591366781923, 39.3537226678286, 47.41915128463078, 0.7564833999999997, 155.0, 709, 270929, 395, 10.222573999999895
396, 2.5593861250015615, 39.347490572193415, 47.333805426538035, 0.7555375000000002, 415.0, 1393, 272322, 396, 19.98730969999997
397, 4.270683292928454, 39.3880796171026, 47.49776561126048, 0.7545988000000002, 105.0, 693, 273015, 397, 10.074003400000038
398, 7.719115594723101, 39.33857800860058, 47.45467169166068, 0.75405205, 80.0, 522, 273537, 398, 7.572665500000312
399, 4.039823314292611, 39.303990435940186, 47.37351918269078, 0.7535961999999996, 55.0, 491, 274028, 399, 7.139286200000242
400, 4.646965887543878, 39.395613241195676, 47.48636046818324, 0.7531232500000004, 65.0, 560, 274588, 400, 8.197349900000063
401, 3.2342722695859876, 39.359868831573195, 47.37294194629338, 0.75259135, 105.0, 622, 275210, 401, 9.067722300000241
402, 2.868778705900341, 39.352513317608725, 47.37780277545635, 0.7521125499999999, 115.0, 442, 275652, 402, 6.494062499999927
403, 4.419831952088835, 39.3676498181352, 47.404140597191926, 0.7515284499999997, 175.0, 856, 276508, 403, 12.459787600000254
404, 7.100154738634678, 39.38961917895989, 47.47497918453123, 0.7509605499999998, 60.0, 406, 276914, 404, 5.966865699999744
405, 2.403982680044773, 39.32631868762942, 47.32720742246653, 0.7504714000000005, 105.0, 681, 277595, 405, 10.036036299999978
406, 4.376026943144105, 39.383133382304734, 47.41996652307645, 0.7496856999999999, 300.0, 1065, 278660, 406, 15.546966599999905
407, 2.6025985404280307, 39.293070895071246, 47.29652796446822, 0.7489706500000003, 120.0, 524, 279184, 407, 7.739261599999736
408, 3.3340374771505594, 39.34328797934712, 47.397511726416255, 0.7483622500000005, 120.0, 828, 280012, 408, 12.191125400000146
409, 3.8603228397780294, 39.27509819377553, 47.30219414017417, 0.7477520500000001, 15.0, 528, 280540, 409, 7.759165999999823
410, 3.4760377006877428, 39.28302777127887, 47.32314098246677, 0.7468830999999998, 235.0, 1403, 281943, 410, 20.758439199999884
411, 7.632624414383139, 39.2511136611507, 47.45273678835989, 0.7459016500000001, 115.0, 778, 282721, 411, 11.622008700000151
412, 3.6645192857621756, 39.27587960653259, 47.38317452767045, 0.7452720999999998, 85.0, 621, 283342, 412, 9.322060599999986
413, 3.1414153300949503, 39.2253078351702, 47.24633924211775, 0.7445989000000004, 215.0, 875, 284217, 413, 13.061452199999621
414, 4.190888662136953, 39.241713989378596, 47.329918219734935, 0.7438640499999997, 210.0, 758, 284975, 414, 11.356935800000429
415, 4.012577118110642, 39.303035209918846, 47.400883736990295, 0.7431445, 150.0, 841, 285816, 415, 12.648585599999933
416, 2.471492254226296, 39.1923225402832, 47.2273127746582, 0.7424622999999997, 110.0, 675, 286491, 416, 10.133712100000139
417, 5.723944961242989, 39.246302939243, 47.34127304827581, 0.7418840500000004, 120.0, 610, 287101, 417, 9.317215999999917
418, 3.0587462094508204, 39.25719448855249, 47.31205872151187, 0.7411028499999998, 265.0, 1126, 288227, 418, 16.937406499999724
419, 4.12192365722855, 39.247070790608724, 47.331417399088544, 0.74025865, 210.0, 750, 288977, 419, 11.38429320000023
420, 4.641069357949718, 39.2991919801406, 47.385557076524414, 0.7394752000000001, 260.0, 991, 289968, 420, 15.030654600000162
421, 3.8512491054631113, 39.57872558232086, 47.71664153587737, 0.73863055, 215.0, 886, 290854, 421, 13.383154399999967
422, 4.703929597408979, 39.54398504014832, 47.69571852815744, 0.737580249999999, 225.0, 1448, 292302, 422, 21.982847100000072
423, 2.5241527013673353, 39.45011086299502, 47.504653366132715, 0.7366154499999995, 155.0, 696, 292998, 423, 10.678817199999685
424, 4.5050602791128584, 39.52889563763728, 47.68121268475642, 0.7360277500000001, 210.0, 610, 293608, 424, 9.410674200000358
425, 4.740549205709754, 39.569829709706646, 47.67561260313065, 0.7355043999999997, 35.0, 553, 294161, 425, 8.582958099999814
426, 4.7069504968822, 39.586328447882224, 47.6980920016969, 0.7349918500000001, 180.0, 586, 294747, 426, 8.970417600000019
427, 5.937180702037439, 39.595838365100676, 47.704367602313006, 0.7345580500000001, 70.0, 378, 295125, 427, 5.861900500000047
428, 3.9116272035986186, 39.567102139336725, 47.61010504450117, 0.7341359499999999, 105.0, 560, 295685, 428, 8.651621199999681
429, 3.8302745298936594, 39.52830688224351, 47.54648798950448, 0.7336661500000003, 120.0, 484, 296169, 429, 7.505416299999979
430, 4.4977020347195955, 39.53931815091545, 47.62452186783069, 0.73303345, 315.0, 922, 297091, 430, 14.260664800000086
431, 7.205307618040463, 39.6026858907615, 47.76072096707198, 0.7322531499999996, 130.0, 812, 297903, 431, 12.485688399999617
432, 3.119897309833837, 39.61293567862652, 47.68862848459824, 0.7314778000000005, 210.0, 911, 298814, 432, 14.147566999999981
433, 2.2378753466597687, 39.46746108684134, 47.46290596495283, 0.7307506000000005, 110.0, 705, 299519, 433, 11.051589100000001
434, 3.60910406026995, 39.56971898734846, 47.63929423077213, 0.7301422000000001, 135.0, 647, 300166, 434, 10.126242900000307
435, 3.3833422046366404, 39.59431742538106, 47.684410143982284, 0.7295342499999996, 190.0, 704, 300870, 435, 11.096612299999833
436, 5.028499779616737, 39.60233620269801, 47.72592336718187, 0.7286905000000009, 545.0, 1171, 302041, 436, 18.181888900000104
437, 5.731478167811641, 39.657670690261355, 47.8278081842623, 0.7279795000000001, 65.0, 409, 302450, 437, 6.443608600000061
438, 5.188648070400906, 39.59923374337494, 47.738745709575674, 0.7274552500000001, 110.0, 756, 303206, 438, 11.823012299999846
439, 3.056293585642212, 39.57199901498872, 47.63264998843391, 0.7267379499999994, 355.0, 838, 304044, 439, 13.146627399999943
440, 2.7371394059184024, 39.55656416540406, 47.632599449631, 0.7259981500000005, 210.0, 806, 304850, 440, 12.792538199999854
441, 2.6509954247300263, 39.56709834770374, 47.64138202115271, 0.7253555499999996, 110.0, 622, 305472, 441, 9.80070829999977
442, 3.369278157644632, 39.59741465250651, 47.70036159960972, 0.72475975, 150.0, 702, 306174, 442, 11.163320099999964
443, 4.415110561345677, 39.5697302586824, 47.664449455668624, 0.7240730499999996, 185.0, 824, 306998, 443, 13.135447600000134
444, 4.060497036469001, 39.57308485660941, 47.68793896181109, 0.7231271500000005, 235.0, 1278, 308276, 444, 20.276558199999727
445, 4.3360054704892095, 39.5359020394794, 47.6200730598579, 0.7222334500000004, 140.0, 708, 308984, 445, 11.361728299999868
446, 4.275339869860317, 39.525380154083166, 47.599512945247604, 0.7214526999999998, 320.0, 1027, 310011, 446, 16.44937059999984
447, 5.083569088935852, 39.26537648010254, 47.32859752655029, 0.7207655500000002, 80.0, 500, 310511, 447, 7.977964499999871
448, 5.108443733185962, 39.24646511907163, 47.30372893291971, 0.72023005, 105.0, 690, 311201, 448, 11.096278299999994
449, 3.7641541159340086, 39.239429999894625, 47.27297370209288, 0.7195181500000002, 350.0, 892, 312093, 449, 14.3778456
450, 2.3850767938806987, 39.237718630903444, 47.22135043525086, 0.71883505, 175.0, 626, 312719, 450, 10.190420500000073
451, 2.3971522977540953, 39.21712916830312, 47.22053401070352, 0.7182635499999996, 125.0, 644, 313363, 451, 10.425674099999924
452, 6.203207305971628, 39.34089935009296, 47.44940552344689, 0.7176227500000002, 130.0, 780, 314143, 452, 12.733840399999735
453, 5.726082337814309, 39.297459894096946, 47.379890373249594, 0.7169216499999999, 355.0, 778, 314921, 453, 12.636389000000236
454, 5.184122043357035, 39.28252004892763, 47.34859281730433, 0.7161796, 210.0, 871, 315792, 454, 14.11447219999991
455, 2.6459118044376373, 39.24498697916667, 47.21719083150228, 0.7155851499999997, 30.0, 450, 316242, 455, 7.445223499999884
456, 3.7859102914945817, 39.25069781175748, 47.230029673088254, 0.7149254499999999, 270.0, 1016, 317258, 456, 16.67369269999972
457, 5.3232704557045665, 39.20884386598596, 47.254124502185, 0.7141815999999995, 135.0, 637, 317895, 457, 10.547759499999756
458, 4.927642833045188, 39.24956575537558, 47.299015362442574, 0.7134296500000001, 215.0, 1034, 318929, 458, 16.920858199999657
459, 3.4380132599994395, 39.19838351792785, 47.219557588581004, 0.7127343999999997, 125.0, 511, 319440, 459, 8.411315100000138
460, 3.7241410132483543, 39.3054780529854, 47.349229945276015, 0.7120256500000002, 230.0, 1064, 320504, 460, 17.436901000000034
461, 3.6871082513091658, 39.296892437568076, 47.36579447526198, 0.7113128499999999, 155.0, 520, 321024, 461, 8.649583800000073
462, 6.427750252375279, 39.29027412968103, 47.388557403997666, 0.71079355, 105.0, 634, 321658, 462, 10.526158399999986
463, 3.174949135321742, 39.314939720808965, 47.35343361957582, 0.7101833499999997, 155.0, 722, 322380, 463, 11.990622899999835
464, 2.4668535797634634, 39.255104815112, 47.226969667059606, 0.7096433500000002, 105.0, 478, 322858, 464, 7.963668599999892
465, 4.954784986271989, 39.285183196266495, 47.34890684982141, 0.7090826500000001, 315.0, 768, 323626, 465, 12.76631640000005
466, 5.941378270249282, 39.38668466976711, 47.4519325869424, 0.7084850499999997, 90.0, 560, 324186, 466, 9.302104299999883
467, 2.5244172049905953, 39.22211154861801, 47.17489402034929, 0.7079392000000001, 160.0, 653, 324839, 467, 10.768966699999964
468, 6.394060081783242, 39.32388834915762, 47.37507825836422, 0.7073595999999998, 180.0, 635, 325474, 468, 10.6663152000001
469, 4.86955291474307, 39.371099661665355, 47.39943251135754, 0.7068430000000003, 65.0, 513, 325987, 469, 8.56464380000034
470, 4.858018615240525, 39.361899695420625, 47.37761872674003, 0.7062575500000003, 180.0, 788, 326775, 470, 13.118194600000152
471, 2.2464016604130874, 39.2086702472939, 47.189304260070436, 0.7056783999999999, 110.0, 499, 327274, 471, 8.329505700000027
472, 4.044934862288669, 39.37473143392534, 47.39429794615181, 0.7052729499999999, 50.0, 402, 327676, 472, 6.6995766
473, 6.103168606091697, 39.33726494640698, 47.4764198412409, 0.7048405000000001, 120.0, 559, 328235, 473, 9.349135599999954
474, 5.832329822416158, 39.285084144356325, 47.34397974702501, 0.7044143499999999, 55.0, 388, 328623, 474, 6.495304799999758
475, 4.11548297231396, 39.32281190722292, 47.37072193590283, 0.7039076500000002, 155.0, 738, 329361, 475, 12.318121099999644
476, 3.8149685238041044, 39.40287057010167, 47.43581845940212, 0.7032951999999999, 105.0, 623, 329984, 476, 10.399471400000039
477, 4.02716899328414, 39.7970928733081, 47.89994367314966, 0.7027705, 105.0, 543, 330527, 477, 9.13167169999997
478, 2.631369162489761, 39.68288725199151, 47.744801637226026, 0.7022485000000002, 140.0, 617, 331144, 478, 10.567095299999892
479, 2.625844221139214, 39.75285836511971, 47.83879585918705, 0.7016814999999997, 110.0, 643, 331787, 479, 10.714897299999848
480, 2.6508821099000945, 39.87782762523218, 48.030587066786325, 0.7011901000000001, 105.0, 449, 332236, 480, 7.517800099999931
481, 5.562918253208476, 39.85329027529116, 48.05817363880299, 0.7005992500000005, 445.0, 864, 333100, 481, 14.447576700000354
482, 5.085579183998734, 39.791109297010635, 47.90730649389402, 0.6997649500000004, 410.0, 990, 334090, 482, 16.57499850000022
483, 3.4616758059254655, 39.77364198423976, 47.85838983659264, 0.6990066999999999, 110.0, 695, 334785, 483, 11.647499000000153
484, 2.2135201339503547, 39.78714004818932, 47.86650631422207, 0.6983078500000001, 165.0, 858, 335643, 484, 14.36815230000002
485, 3.2124691071810587, 39.83434284543528, 47.946544075217965, 0.6975046000000001, 185.0, 927, 336570, 485, 15.519372700000076
486, 5.0111207992146145, 39.843831087635685, 47.99953575846954, 0.6966298000000002, 520.0, 1017, 337587, 486, 17.022087199999987
487, 4.190580331781818, 39.83201602265075, 47.96375202870631, 0.6958445499999993, 180.0, 728, 338315, 487, 12.233468299999913
488, 4.322489039741812, 39.91698172102759, 48.07811923336673, 0.6949972000000006, 435.0, 1155, 339470, 488, 19.370869400000174
489, 5.357794520692517, 39.963086637008, 48.16550868433012, 0.6942826000000001, 85.0, 433, 339903, 489, 7.295889200000147
490, 7.324183110375634, 39.756914847007785, 47.909501027457324, 0.6936611500000001, 280.0, 948, 340851, 490, 15.907757099999799
491, 4.836940165036376, 39.75796771958059, 47.89410935751555, 0.6928920999999997, 215.0, 761, 341612, 491, 12.852165600000262
492, 5.01614349624847, 39.81331725709467, 47.92416947961328, 0.6923237500000002, 75.0, 502, 342114, 492, 8.440888000000086
493, 5.369625809770552, 39.86159339642868, 48.00378419236091, 0.6916914999999999, 215.0, 903, 343017, 493, 15.138980099999571
494, 4.910444918187226, 39.831181055819826, 47.95788568004763, 0.6907878999999999, 550.0, 1105, 344122, 494, 18.52908239999988
495, 4.791164730788227, 39.86264596319502, 47.96536251238197, 0.6900080500000001, 105.0, 628, 344750, 495, 10.541838400000415
496, 4.31144022288298, 39.76650155254823, 47.86917131038006, 0.6894185500000002, 125.0, 682, 345432, 496, 11.531345299999884
497, 6.618882266916783, 39.87137204480459, 48.01879801233131, 0.6888128499999996, 145.0, 664, 346096, 497, 11.151913899999727
498, 3.713772722144798, 39.875851116506716, 47.99725933282594, 0.6882247000000001, 75.0, 643, 346739, 498, 10.803752700000132
499, 3.1842750698814872, 39.85031737301981, 47.936532704944234, 0.6875496999999997, 230.0, 857, 347596, 499, 14.41359650000004
500, 3.271676052868926, 39.7340928198586, 47.86467707996637, 0.6867806499999998, 455.0, 852, 348448, 500, 14.30221019999999
501, 6.457570241202438, 39.84778221884927, 48.04692805643047, 0.6860286999999995, 195.0, 819, 349267, 501, 13.923204899999746
502, 4.702855333452615, 39.6986947103539, 47.83900429179436, 0.6854157999999999, 80.0, 543, 349810, 502, 9.142968099999962
503, 6.020601173359124, 39.76786823238089, 47.91575619789304, 0.6846755499999995, 550.0, 1102, 350912, 503, 18.515210900000056
504, 5.378833121809914, 39.70209396506938, 47.82023883355549, 0.6838948000000002, 105.0, 633, 351545, 504, 10.655245999999806
505, 2.3503225173501576, 39.600059289309975, 47.67167005987558, 0.6833133999999995, 155.0, 659, 352204, 505, 11.1422120000002
506, 4.508271899068298, 39.66974775471479, 47.817655991660565, 0.6827383000000001, 75.0, 619, 352823, 506, 10.459305400000176
507, 2.3371691682322284, 39.672620940626715, 47.73192979817402, 0.6822802, 45.0, 399, 353222, 507, 6.746235500000239
508, 3.2234892468661704, 39.769754839958026, 47.87096593329247, 0.6816776499999992, 445.0, 940, 354162, 508, 15.804688900000201
509, 3.8826345523867087, 39.61958936544565, 47.70986367902185, 0.68104405, 45.0, 468, 354630, 509, 7.879014099999949
510, 6.224290169484123, 39.671072315237375, 47.863760793675254, 0.6806723499999998, 30.0, 358, 354988, 510, 6.115258599999834
511, 2.5263366653640915, 39.662846240211515, 47.719753170132485, 0.6801508000000004, 150.0, 801, 355789, 511, 13.636544500000127
512, 4.94717699125027, 39.74484648093199, 47.873079414041634, 0.6795271, 95.0, 585, 356374, 512, 9.911965099999634
513, 6.371087441674477, 39.69049887780699, 47.87615334703515, 0.6788295999999994, 265.0, 965, 357339, 513, 16.29386169999998
514, 2.7095167649841216, 39.738270101583595, 47.7949710589049, 0.6780412, 140.0, 787, 358126, 514, 13.276979899999787
515, 4.049500302980879, 39.65773201435455, 47.743685550377016, 0.6774948999999999, 35.0, 427, 358553, 515, 7.27931609999996
516, 4.7553239345550535, 39.71347816698479, 47.83802470814098, 0.6769315000000001, 150.0, 825, 359378, 516, 14.068621099999746
517, 3.9546886916535025, 39.63149976636296, 47.73865252462835, 0.6761039499999995, 295.0, 1014, 360392, 517, 17.22169380000014
518, 3.257633904857662, 39.56128779068369, 47.58681855413127, 0.6752822500000002, 210.0, 812, 361204, 518, 13.833293600000161
519, 4.854098430220385, 39.57944808391311, 47.6445851770247, 0.6745546000000003, 190.0, 805, 362009, 519, 13.737754499999937
520, 8.337168669092586, 39.674578962654905, 47.81577753746647, 0.6740357500000002, 70.0, 348, 362357, 520, 5.998079100000268
521, 5.247247634339894, 39.66272965947872, 47.82551705403297, 0.6736689999999999, 55.0, 467, 362824, 521, 8.110052900000028
522, 4.80033888347841, 39.58596735937469, 47.65694169493707, 0.6731015500000002, 170.0, 794, 363618, 522, 13.48670200000015
523, 3.4013375921032996, 39.59025267070851, 47.64351265163823, 0.6724666, 135.0, 617, 364235, 523, 10.614447100000234
524, 5.8418050242604265, 39.607030512993795, 47.75156147856461, 0.6717785500000001, 180.0, 912, 365147, 524, 15.618998399999782
525, 6.654533910229614, 39.658369636055205, 47.75049041921005, 0.67101085, 155.0, 794, 365941, 525, 13.664088200000151
526, 3.53194010366253, 39.62028518061, 47.68350601947214, 0.6701963499999996, 380.0, 1016, 366957, 526, 17.457431799999995
527, 3.8545202152214753, 39.57501673461429, 47.613880111967354, 0.6695127999999999, 105.0, 503, 367460, 527, 8.626993299999867
528, 4.237356384922849, 39.64346322134031, 47.734028376586046, 0.6689692000000003, 125.0, 705, 368165, 528, 12.128634199999851
529, 4.884716851406089, 39.61214789709631, 47.74359541239007, 0.6684085000000002, 55.0, 541, 368706, 529, 9.288638099999844
530, 3.0051075024819522, 39.64998563751248, 47.707679927930855, 0.6676578999999992, 230.0, 1127, 369833, 530, 19.422742799999924
531, 6.730957287616095, 39.65147454311655, 47.79249578799385, 0.6668668000000001, 70.0, 631, 370464, 531, 10.931480100000044
532, 4.392394774864597, 39.497287102824636, 47.5329106818023, 0.6663123999999997, 135.0, 601, 371065, 532, 10.566398899999967
533, 4.496971190100608, 39.574088935212714, 47.661667479616305, 0.6656392000000001, 335.0, 895, 371960, 533, 15.504524500000116
534, 7.183426002559948, 39.62067116213517, 47.81288177060409, 0.6649169499999994, 160.0, 710, 372670, 534, 12.363065500000175
535, 4.835538704184893, 39.569262745159726, 47.63010000793125, 0.6643495, 105.0, 551, 373221, 535, 9.651589299999614
536, 4.668780165180292, 39.538974284157206, 47.627891390728806, 0.6634369000000003, 500.0, 1477, 374698, 536, 25.731439000000137
537, 3.0731257899138895, 39.436010034963296, 47.480261979030075, 0.6623901999999998, 305.0, 849, 375547, 537, 15.079175600000326
538, 2.551956014701024, 39.5034795176855, 47.50979994818195, 0.6616306000000001, 240.0, 839, 376386, 538, 13.580085600000075
539, 6.669717624406867, 39.557365254768264, 47.670563678229215, 0.6609681999999998, 130.0, 633, 377019, 539, 10.35822780000035
540, 7.044343524576319, 39.51963293205187, 47.63971637059184, 0.6603125500000004, 175.0, 824, 377843, 540, 13.498982100000376
541, 5.6352348370150525, 39.564446037962234, 47.66974596212838, 0.6594701499999996, 610.0, 1048, 378891, 541, 17.056549700000232
542, 2.353644699851672, 39.530036832079475, 47.522759595329376, 0.6588163, 50.0, 405, 379296, 542, 6.684873599999719
543, 3.41391525792212, 39.504632911898874, 47.53009146993811, 0.6583172499999999, 290.0, 704, 380000, 543, 11.552711599999839
544, 5.60418219839776, 39.76391617884554, 47.889807493587575, 0.6576323500000004, 155.0, 818, 380818, 544, 13.409108299999843
545, 5.217599913385151, 39.726150120936985, 47.867186221838985, 0.6568304499999997, 340.0, 964, 381782, 545, 15.83034039999984
546, 10.274909339100123, 39.7160805646111, 47.87995929718018, 0.65624365, 20.0, 340, 382122, 546, 5.624148500000047
547, 4.344040024540173, 39.63124907173838, 47.69996501760637, 0.6557833000000001, 160.0, 683, 382805, 547, 11.314773099999911
548, 4.284194625079726, 39.69190947114481, 47.772773411747785, 0.6551906499999997, 95.0, 634, 383439, 548, 10.475028199999997
549, 7.387674838100886, 39.7684439018225, 47.90308627898287, 0.6546254500000002, 130.0, 622, 384061, 549, 10.300822400000015
550, 4.440388820433457, 39.74697650614239, 47.85214530286335, 0.65404315, 125.0, 672, 384733, 550, 11.169315800000277
551, 3.025439473667315, 39.689507578585065, 47.75206431168436, 0.65296585, 230.0, 1722, 386455, 551, 28.28760289999991
552, 5.3611246452594, 39.65644630777492, 47.80539156281899, 0.6519722500000001, 95.0, 486, 386941, 552, 8.11549769999965
553, 3.835080663471118, 39.71601613613928, 47.8137163833196, 0.6515258500000003, 95.0, 506, 387447, 553, 8.44436289999976
554, 2.309980965386968, 39.69285733280145, 47.72770549250295, 0.6510654999999996, 30.0, 517, 387964, 554, 8.625164200000654
555, 5.05161861180198, 39.73756510558958, 47.88299052179284, 0.6503904999999999, 225.0, 983, 388947, 555, 16.475608299999294
556, 4.579358058391499, 39.627990075119406, 47.70449139891552, 0.6496803999999997, 110.0, 595, 389542, 556, 9.957730600000104
557, 8.018785357749055, 39.739825511541895, 47.927523595454495, 0.6492412000000001, 35.0, 381, 389923, 557, 6.38254920000054
558, 2.109118505893636, 39.39641547387885, 47.35608126026715, 0.6488375500000002, 55.0, 516, 390439, 558, 8.694138900000326
559, 6.552129199944388, 39.48301674239745, 47.57809174452099, 0.6483997, 65.0, 457, 390896, 559, 7.763492099999894
560, 5.361285681100119, 39.51584949190654, 47.66244779919821, 0.6479105499999999, 70.0, 630, 391526, 560, 10.630444800000078
561, 7.330953196300875, 39.446053302501475, 47.56204933400654, 0.64727515, 155.0, 782, 392308, 561, 13.187741299999288
562, 3.4951200650017245, 39.508938514465115, 47.557885933601135, 0.6466703499999996, 120.0, 562, 392870, 562, 9.399316899999576
563, 2.29710026666989, 39.40131809636738, 47.343106544255534, 0.6462594999999999, 40.0, 351, 393221, 563, 5.95010480000019
564, 6.048130789537515, 39.48032239096505, 47.59444367000035, 0.6457865500000001, 120.0, 700, 393921, 564, 11.806227600000057
565, 4.998679624073607, 39.50608156143881, 47.56817272243998, 0.6451443999999997, 225.0, 727, 394648, 565, 12.220890200000213
566, 7.616778880778764, 39.50555370265372, 47.57393225122292, 0.6443713000000003, 370.0, 991, 395639, 566, 16.67565089999971
567, 4.702290678737172, 39.450506719375895, 47.50164258414065, 0.6435190000000004, 205.0, 903, 396542, 567, 15.223381100000552
568, 4.818922835689926, 39.50444872111721, 47.543138568969574, 0.6427557999999999, 180.0, 793, 397335, 568, 13.357892799999718
569, 5.92201864849278, 39.47494581089938, 47.565312468176856, 0.6419782, 195.0, 935, 398270, 569, 15.713400800000272
570, 4.951526224747434, 39.481555022276915, 47.548754677758204, 0.6412577499999997, 135.0, 666, 398936, 570, 11.48969070000021
571, 3.2868902245624585, 39.48630138000103, 47.529936456529875, 0.6406727500000003, 125.0, 634, 399570, 571, 10.81926620000013
572, 7.033943485934287, 39.645374883304946, 47.796205786141485, 0.64007065, 325.0, 704, 400274, 572, 11.979886200000692
573, 4.862466507023254, 39.761040007407075, 47.82451156995492, 0.6392831499999996, 490.0, 1046, 401320, 573, 17.81791350000003
574, 3.956701283380389, 39.73215594204989, 47.79865934545344, 0.6383174500000001, 465.0, 1100, 402420, 574, 18.809089700000186
575, 5.813463286232961, 39.74887766036312, 47.91325905892701, 0.6374156500000001, 170.0, 904, 403324, 575, 15.465983599999163
576, 2.59938129569803, 39.64333319997921, 47.65757364652404, 0.6368482000000001, 85.0, 357, 403681, 576, 6.168453599999339
577, 5.001521407945515, 39.68381281639343, 47.78162085302344, 0.6364904499999999, 60.0, 438, 404119, 577, 7.589349400000174
578, 4.2307011730778425, 39.70069542803963, 47.74684057325566, 0.6359590000000002, 135.0, 743, 404862, 578, 12.762208199999804
579, 7.9008937603527585, 39.856375889167474, 48.08231324655808, 0.6354595, 45.0, 367, 405229, 579, 6.381354399999509
580, 3.644376683513668, 39.73488341314944, 47.82127529210438, 0.6348272500000002, 380.0, 1038, 406267, 580, 17.98011250000036
581, 5.880931131070173, 39.649604985147256, 47.78719041183193, 0.6340401999999995, 175.0, 711, 406978, 581, 12.254923399999825
582, 2.213926243516455, 39.70132307299304, 47.73795727750856, 0.63343495, 105.0, 634, 407612, 582, 10.975990299999467
583, 4.135688611716739, 39.72230525807747, 47.827692655590475, 0.6326749000000002, 285.0, 1055, 408667, 583, 18.249503699999877
584, 7.174569046721586, 39.73370909459383, 47.944573161671464, 0.63201475, 70.0, 412, 409079, 584, 7.24587210000027
585, 4.02436315533873, 39.739123732766735, 47.82263728041197, 0.6314922999999998, 200.0, 749, 409828, 585, 13.010667999999896
586, 5.349739731278287, 39.17787323701217, 47.20160634968138, 0.630667, 320.0, 1085, 410913, 586, 18.952779700000065
587, 5.228824257226707, 39.11032887162833, 47.117407869235635, 0.6298133499999995, 125.0, 812, 411725, 587, 14.169319300000097
588, 3.228120224382899, 38.993160583776074, 46.90838077790146, 0.6292026999999999, 60.0, 545, 412270, 588, 9.51434109999991
589, 3.6011061959893165, 39.01956232446824, 46.94965088744523, 0.6287724999999998, 100.0, 411, 412681, 589, 7.259798399999454
590, 4.592568196571038, 39.0971610516235, 47.08049238056766, 0.6278693499999995, 615.0, 1596, 414277, 590, 27.612385999999788
591, 5.652157609308859, 39.09117158094243, 47.09841756005982, 0.62679295, 215.0, 796, 415073, 591, 13.928023800000119
592, 3.9629961615323683, 39.13229968038838, 47.10024399703808, 0.6261143500000002, 135.0, 712, 415785, 592, 12.483664899999894
593, 3.3666769473539726, 39.08713745662992, 47.04248383256547, 0.6255045999999996, 110.0, 643, 416428, 593, 11.371292599999833
594, 3.7407107023209787, 39.09705839801198, 47.083893254431764, 0.6250087, 45.0, 459, 416887, 594, 8.099733399999423
595, 2.1905063682769805, 38.95958169741644, 46.81180085369755, 0.6246397, 65.0, 361, 417248, 595, 6.359335699999974
596, 4.5317698445346135, 39.02327189349488, 46.98324141278363, 0.62380675, 575.0, 1490, 418738, 596, 26.004273900000044
597, 4.0119224626118735, 39.03750042557027, 47.05299819549384, 0.6229805499999997, 45.0, 346, 419084, 597, 6.130373599999984
598, 3.3703784006464876, 39.07382992747327, 46.98676269508201, 0.62252695, 120.0, 662, 419746, 598, 11.753793099999712
599, 3.8092705136705503, 39.18746697588219, 47.16453902155375, 0.6218537500000001, 210.0, 834, 420580, 599, 14.824227000000064
600, 2.3059528906389812, 39.15008102183588, 47.0721081976225, 0.6210077500000003, 505.0, 1046, 421626, 600, 18.713206499999615
601, 3.9945258636849488, 39.212676258688326, 47.2237468107382, 0.6202229499999998, 110.0, 698, 422324, 601, 12.41191179999987
602, 2.163778947841795, 39.22112065463081, 47.12575023152546, 0.6197608, 20.0, 329, 422653, 602, 5.864612600000328
603, 3.2351191055989976, 39.188328842941154, 47.17451435986052, 0.61929505, 150.0, 706, 423359, 603, 12.632884300000114
604, 3.401281271011135, 39.12511210810614, 47.105303936554556, 0.6186807999999996, 135.0, 659, 424018, 604, 11.744807799999762
605, 4.25325566776502, 39.263968586090385, 47.25855336528443, 0.6180616000000002, 105.0, 717, 424735, 605, 12.760028699999566
606, 3.7202225682176002, 39.27875948684365, 47.2925213137327, 0.6172992999999996, 280.0, 977, 425712, 606, 17.357717000000775
607, 3.2073163178047226, 39.19328105091537, 47.153341967319385, 0.6165451000000001, 175.0, 699, 426411, 607, 12.52287780000006
608, 7.436325894916333, 39.20042866319131, 47.28622382867773, 0.6159969999999998, 110.0, 519, 426930, 608, 9.322705300000052
609, 3.95689620840796, 39.16132697687822, 47.123419234932484, 0.6153935500000004, 180.0, 822, 427752, 609, 14.774105299999974
610, 6.133184223988792, 39.18617732822895, 47.2593030333519, 0.6147932500000001, 130.0, 512, 428264, 610, 9.26237620000029
611, 3.906633043055171, 39.222935119346985, 47.18507327989398, 0.6143679999999997, 105.0, 433, 428697, 611, 7.802667299999484
612, 4.079270290967808, 39.13824702688185, 47.121117677499896, 0.6138775000000003, 125.0, 657, 429354, 612, 11.892028300000675
613, 2.53991211761986, 39.18840158039628, 47.10995380695049, 0.61338295, 75.0, 442, 429796, 613, 8.026169100000516
614, 5.741297156076578, 39.02260146586752, 47.010211412183146, 0.6128325999999998, 165.0, 781, 430577, 614, 14.06832730000042
615, 4.767785413427302, 38.90564966628291, 46.83294453902407, 0.6122296000000002, 100.0, 559, 431136, 615, 10.091799100000571
616, 5.2772732793434605, 39.00582038031684, 46.97814663609227, 0.6116783499999996, 120.0, 666, 431802, 616, 12.06993439999951
617, 7.508339759356604, 38.96302285774675, 47.02510185847207, 0.6112085500000001, 55.0, 378, 432180, 617, 6.863956199999848
618, 3.3606145207090643, 38.88250670937153, 46.76185386432932, 0.6107788000000002, 150.0, 577, 432757, 618, 10.477835400000004
619, 5.508899753672374, 38.93701016639685, 46.872534056943294, 0.6102338499999995, 60.0, 634, 433391, 619, 11.552081999999245
620, 4.947303743014681, 38.84863229213206, 46.73054627281421, 0.6095197000000001, 230.0, 953, 434344, 620, 17.318694900000082
621, 3.796375097503245, 38.923489572513645, 46.803293171270234, 0.6088644999999998, 45.0, 503, 434847, 621, 9.221095300000343
622, 4.190195910461332, 38.960531052044985, 46.857610812132386, 0.6082858000000002, 170.0, 783, 435630, 622, 14.311713000000054
623, 6.358184395225647, 38.87592486605618, 46.81356852171851, 0.60776875, 80.0, 366, 435996, 623, 6.767747800000507
624, 7.1796443020192005, 38.788617490228255, 46.69862555979487, 0.6074244999999997, 50.0, 399, 436395, 624, 7.393848399999115
625, 4.40229639289819, 38.87884168244151, 46.79493966330108, 0.6067828000000003, 400.0, 1027, 437422, 625, 18.655803099999503
626, 4.325522991576846, 38.94733254740557, 46.839533868424226, 0.6061491999999998, 105.0, 381, 437803, 626, 7.027245600000242
627, 4.875896585973095, 38.96528478545328, 46.917499108681874, 0.6053877999999996, 390.0, 1311, 439114, 627, 23.93875619999926
628, 4.8727820313310035, 38.863012297257136, 46.73632000277502, 0.6044355999999997, 255.0, 805, 439919, 628, 14.926279700000123
629, 6.539019700126115, 38.94111514877487, 46.92124226678422, 0.6035819499999999, 335.0, 1092, 441011, 629, 20.197650299999623
630, 7.3615350318038635, 38.93992428215807, 46.9431717362337, 0.602866, 25.0, 499, 441510, 630, 9.292478600000322
631, 5.775298087579769, 38.95366108417511, 46.93378261596926, 0.6021950500000003, 145.0, 992, 442502, 631, 18.284120800000892
632, 3.8017915988972795, 38.93561621174413, 46.864245612190686, 0.6013400500000005, 385.0, 908, 443410, 632, 16.775749899999937
633, 3.9151070408596853, 38.99323828668878, 46.90140518339554, 0.6007042000000001, 90.0, 505, 443915, 633, 9.389805600000727
634, 5.160943317491415, 38.980300511855745, 46.93081113657056, 0.6000647499999997, 200.0, 916, 444831, 634, 17.02415370000017
635, 4.160962684075038, 38.9913900756836, 46.90067774454753, 0.5994838, 75.0, 375, 445206, 635, 6.957519199999297
636, 4.898625675998219, 39.02098376934345, 46.96173765720465, 0.5990693499999997, 25.0, 546, 445752, 636, 10.184756900000139
637, 4.5001472077164495, 38.93698005467816, 46.936934497187046, 0.5986589500000001, 65.0, 366, 446118, 637, 6.8878992999998445
638, 3.9545475807101504, 38.91110045735429, 46.81344595963393, 0.59827285, 155.0, 492, 446610, 638, 9.187089199999718
639, 5.4181692948683775, 38.991062959711606, 46.953097866951154, 0.5978399499999999, 135.0, 470, 447080, 639, 8.800178599999526
640, 2.4580181252378908, 38.876763670502235, 46.72123713641843, 0.5973683499999999, 90.0, 578, 447658, 640, 10.777393299999858
641, 4.2046897778369, 38.91848609314425, 46.833053393241684, 0.5968099, 190.0, 663, 448321, 641, 12.44993760000034
642, 5.8776813488102935, 38.87778160542408, 46.849338606026414, 0.5962581999999997, 155.0, 563, 448884, 642, 10.58952539999973
643, 5.229242205561376, 38.835541751337985, 46.72963025710162, 0.59577535, 90.0, 510, 449394, 643, 9.63492430000042
644, 3.3059917506852607, 38.90321943749195, 46.788428042067224, 0.5952457000000001, 185.0, 667, 450061, 644, 12.46770209999977
645, 4.031799879155977, 38.96856352799916, 46.91291906831443, 0.5944590999999994, 430.0, 1081, 451142, 645, 20.236279300000206
646, 4.654401054997267, 38.95696984166684, 46.90012009247489, 0.5937242500000001, 95.0, 552, 451694, 646, 10.367574900000363
647, 4.396787742532644, 38.91508498098336, 46.84795723335416, 0.5930168500000002, 565.0, 1020, 452714, 647, 19.25839420000011
648, 4.4938566378664735, 38.82200534296971, 46.75597438438266, 0.59232835, 50.0, 510, 453224, 648, 9.65675999999985
649, 6.833712127351777, 38.96384621978298, 46.93308271699299, 0.5917716999999996, 125.0, 727, 453951, 649, 13.71389900000031
650, 3.4380715582569796, 38.889998286562296, 46.762547468221285, 0.5909419000000005, 565.0, 1117, 455068, 650, 21.0238274000003
651, 5.102928181020719, 38.93748274189371, 46.87255979733897, 0.5900099500000004, 305.0, 954, 456022, 651, 17.948121399999764
652, 6.975455563219043, 38.82963619909205, 46.77564394984718, 0.5892129999999998, 185.0, 817, 456839, 652, 15.498931599999196
653, 5.603902999088614, 38.89791478653868, 46.80124331662755, 0.5882441500000004, 385.0, 1336, 458175, 653, 25.314438299999892
654, 3.5319478349851394, 38.88237649757904, 46.75881998384545, 0.5873581000000004, 150.0, 633, 458808, 654, 12.04254579999997
655, 5.280486087494654, 38.80598454072922, 46.72536531265543, 0.5867587000000001, 305.0, 699, 459507, 655, 13.375410899999224
656, 5.225700335688686, 39.21545514696955, 47.18402085070601, 0.5859482499999995, 270.0, 1102, 460609, 656, 21.013329800000065
657, 7.371846886298761, 39.505352168120154, 47.654543765755584, 0.5852782000000001, 35.0, 387, 460996, 657, 7.406049100000018
658, 4.411510471521759, 39.34857852920305, 47.33990410377595, 0.5847714999999997, 195.0, 739, 461735, 658, 14.162725600000158
659, 4.706838674230375, 39.29591062082015, 47.28504026786065, 0.5841928, 155.0, 547, 462282, 659, 10.463377000000037
660, 5.531197683142635, 39.45241887838128, 47.54745271849931, 0.5836950999999999, 180.0, 559, 462841, 660, 10.655724399999599
661, 5.368519280553521, 39.413421719182026, 47.42079599584476, 0.5830354000000003, 145.0, 907, 463748, 661, 17.396890500000154
662, 5.769917583589669, 39.350204019437626, 47.395280170632816, 0.5819572000000003, 400.0, 1489, 465237, 662, 28.539911399999255
663, 6.172802890852554, 39.32005197696377, 47.37515337442614, 0.5809816, 100.0, 679, 465916, 663, 13.1405950999997
664, 4.156290690923925, 39.333087336272, 47.3021151535213, 0.5802152499999998, 230.0, 1024, 466940, 664, 19.747413699999925
665, 4.06830140322651, 39.374484090935695, 47.339419869200825, 0.5794259499999997, 135.0, 730, 467670, 665, 14.038032000000385
666, 3.188613028935532, 39.3577454372425, 47.34931376822552, 0.5786452000000003, 320.0, 1005, 468675, 666, 19.49318470000071
667, 8.079348584678167, 39.46508489002094, 47.57798203462864, 0.5776425999999992, 620.0, 1223, 469898, 667, 23.63053260000015
668, 4.888776918664118, 39.559427295412334, 47.569058369617075, 0.5767394499999998, 300.0, 784, 470682, 668, 15.23363100000006
669, 3.6031972054720467, 39.58529170885637, 47.59675519299724, 0.5760905500000002, 110.0, 658, 471340, 669, 12.918913600000451
670, 9.453487233758446, 39.60652291434152, 47.755919719877696, 0.5755109500000002, 145.0, 630, 471970, 670, 12.275996699999268
671, 3.877358937228902, 39.63975220907126, 47.63433631291934, 0.5749947999999997, 45.0, 517, 472487, 671, 10.031600799999978
672, 4.745518545440652, 39.59695869445801, 47.63888946533203, 0.57451465, 55.0, 550, 473037, 672, 10.70797979999952
673, 3.8697158740260607, 39.627688814132796, 47.64410162297903, 0.5738720499999999, 250.0, 878, 473915, 673, 17.15084409999963
674, 4.6778768910184345, 39.510257762219105, 47.51922539618137, 0.5731858000000002, 115.0, 647, 474562, 674, 12.737498899999991
675, 5.293523995988831, 39.47848709262147, 47.519722654381575, 0.5726741500000001, 120.0, 490, 475052, 675, 9.657652900000357
676, 3.350759266898663, 39.514284258483976, 47.54435437649532, 0.5721435999999995, 150.0, 689, 475741, 676, 13.4575205000001
677, 4.014704757346806, 39.67384042613832, 47.71226307088933, 0.5715271, 185.0, 681, 476422, 677, 13.373805199999879
678, 4.528271729072381, 39.56947923439895, 47.59442119328855, 0.5706792999999999, 445.0, 1203, 477625, 678, 23.701240499999585
679, 2.616436292136912, 39.56936581693174, 47.51527847233315, 0.5698958500000001, 55.0, 538, 478163, 679, 10.602192600000308
680, 5.180257429152119, 39.62169236552958, 47.73158969489896, 0.5692127499999994, 200.0, 980, 479143, 680, 19.430492499999673
681, 4.196628363869214, 39.60491307253765, 47.62538811155987, 0.5685944500000002, 20.0, 394, 479537, 681, 7.8987068999995245
682, 2.2960479208916156, 39.51655697171493, 47.50135616208239, 0.5680710999999997, 125.0, 769, 480306, 682, 15.216552699999738
683, 4.482517001216131, 39.4950363992507, 47.520054583584894, 0.5673007000000001, 250.0, 943, 481249, 683, 18.63054809999994
684, 6.526812602193828, 39.521122856591965, 47.609876616553805, 0.5666103999999995, 165.0, 591, 481840, 684, 11.77250069999991
685, 4.463180390944984, 39.54926760906598, 47.599055193531605, 0.5659228000000001, 320.0, 937, 482777, 685, 18.520825200000218
686, 4.407038070433703, 39.5688080332387, 47.60912181911756, 0.5650533999999998, 225.0, 995, 483772, 686, 19.927418100000068
687, 5.254566133769145, 39.48337025061996, 47.55649328118008, 0.5644171000000001, 40.0, 419, 484191, 687, 8.365051000000676
688, 4.730191532236856, 39.630711609094675, 47.6890422554601, 0.5639643999999999, 45.0, 587, 484778, 688, 11.703418999999485
689, 5.445529881494645, 39.524612775215736, 47.58357147681407, 0.5634194500000003, 75.0, 624, 485402, 689, 12.437289899999996
690, 2.6230586519153634, 39.47963791654592, 47.40938924851263, 0.5629582000000001, 85.0, 401, 485803, 690, 8.0678953000006
691, 3.1654678618047862, 39.53543511717111, 47.53470298715886, 0.5624424999999996, 190.0, 745, 486548, 691, 14.941674499999863
692, 3.5209432243715497, 39.53302598347434, 47.51125490678815, 0.5617063000000002, 370.0, 891, 487439, 692, 17.9475738000001
693, 5.836473254828644, 39.64346194205666, 47.688456937016134, 0.5611311999999998, 70.0, 387, 487826, 693, 7.857919799999763
694, 4.777537379814173, 39.5987499123189, 47.68293145023175, 0.5606555500000002, 140.0, 670, 488496, 694, 13.452851099999862
695, 3.9138814186746322, 39.658002111646866, 47.64627632682706, 0.56006245, 140.0, 648, 489144, 695, 13.061302699999942
696, 5.028131148656001, 39.503173820136105, 47.53224416203524, 0.5593410999999998, 305.0, 955, 490099, 696, 19.294693499999994
697, 4.476041019190576, 39.30818845572194, 47.26644996927256, 0.5584401999999999, 695.0, 1047, 491146, 697, 21.10692149999977
698, 4.904269007372945, 39.303592481863184, 47.322457902886896, 0.5576086000000002, 225.0, 801, 491947, 698, 16.136514400000124
699, 3.98225747107474, 39.32298165716087, 47.32241269745604, 0.5568534999999997, 445.0, 877, 492824, 699, 17.83633120000013
700, 2.347416937426107, 39.35141319964998, 47.28965294421019, 0.55627975, 45.0, 398, 493222, 700, 8.067637500000274
701, 5.588922297107356, 39.33743843570832, 47.31537052277596, 0.5558216500000002, 140.0, 620, 493842, 701, 12.521632599999975
702, 4.757794509592134, 39.34949516388307, 47.32924009313272, 0.5552811999999996, 55.0, 581, 494423, 702, 11.805318400000033
703, 5.5178329145024625, 39.34313332470433, 47.31691415227174, 0.5547344499999999, 230.0, 634, 495057, 703, 12.930045000000064
704, 4.621511665664406, 39.33886530664232, 47.285586719159724, 0.5540603499999996, 425.0, 864, 495921, 704, 17.531845299999986
705, 4.830744479688013, 39.38545842081928, 47.3778832426207, 0.5532607000000002, 340.0, 913, 496834, 705, 18.533814299999904
706, 5.3512862954872205, 39.46475299582424, 47.50090447965875, 0.5525510499999996, 140.0, 664, 497498, 706, 13.540912700000263
707, 3.9573867750435943, 39.29808677290274, 47.23046452031475, 0.5520371499999999, 35.0, 478, 497976, 707, 9.769037000000026
708, 5.5364571315351245, 39.37837419325671, 47.37093502345092, 0.5515192, 125.0, 673, 498649, 708, 13.83679260000008
709, 5.198804974339263, 39.37484493414121, 47.43155282884423, 0.5508914500000003, 115.0, 722, 499371, 709, 14.717575900000156
710, 6.254165547274215, 39.314213123852994, 47.31997943441196, 0.5502758500000002, 170.0, 646, 500017, 710, 13.323394400000325
711, 4.21715114478554, 39.245443597131846, 47.14251155269389, 0.5498087499999998, 35.0, 392, 500409, 711, 8.097458399999596
712, 5.434106099799761, 39.150648427786386, 47.113529396535164, 0.5494528, 40.0, 399, 500808, 712, 8.164224400000421
713, 4.450568912812591, 39.23978047655118, 47.21143881971122, 0.5486617000000006, 435.0, 1359, 502167, 713, 27.833097499999894
714, 4.44535098532531, 39.21345145234926, 47.18820543069829, 0.5476393000000002, 200.0, 913, 503080, 714, 18.83237729999928
715, 3.1802675306704904, 39.15260446716497, 47.093537426437074, 0.5466461499999992, 375.0, 1294, 504374, 715, 26.616665999999896
716, 4.379365060069576, 39.19763473766606, 47.14895214104071, 0.5457686499999999, 125.0, 656, 505030, 716, 13.520082299999558
717, 4.5227105513953205, 39.16595352692501, 47.10090987379706, 0.5451827500000002, 185.0, 646, 505676, 717, 13.454885000000104
718, 4.238234718768137, 39.213329068444345, 47.15711707990517, 0.54445375, 275.0, 974, 506650, 718, 20.159770500000377
719, 8.026921682560644, 39.26373522533199, 47.335622970908744, 0.5435335, 320.0, 1071, 507721, 719, 22.215986899999734
720, 4.594205563093802, 39.10360193178635, 47.028495829974034, 0.5427612999999997, 120.0, 645, 508366, 720, 13.501223400000526
721, 6.262647613003029, 39.281481326846624, 47.32365386242003, 0.5421853, 185.0, 635, 509001, 721, 13.260282799999914
722, 3.799850287667757, 39.13032890768612, 47.03403853596345, 0.5416777, 120.0, 493, 509494, 722, 10.25328509999963
723, 7.843173977528882, 39.14388338181368, 47.15898796364113, 0.5412978999999998, 50.0, 351, 509845, 723, 7.38741519999985
724, 4.718114812619948, 39.402767563787634, 47.38335088370503, 0.5407673500000003, 210.0, 828, 510673, 724, 17.313424899999518
725, 5.10896658656143, 39.417161622339364, 47.45771885566971, 0.5400639999999998, 235.0, 735, 511408, 725, 15.379331099999945
726, 11.674315431526313, 39.53389186620983, 47.71703542997293, 0.5393368000000003, 225.0, 881, 512289, 726, 18.529030500000772
727, 5.553056619284789, 39.454357277686896, 47.45300006555812, 0.5386640499999998, 135.0, 614, 512903, 727, 12.891564599999583
728, 4.465968066119006, 39.49209887279308, 47.46773777146989, 0.5379553000000004, 305.0, 961, 513864, 728, 20.187592000000222
729, 8.33261940514105, 39.48133193122016, 47.60833178260774, 0.53728795, 35.0, 522, 514386, 729, 10.894558199999665
730, 4.239989121400531, 39.425854737554964, 47.39556296650489, 0.5366053000000002, 140.0, 995, 515381, 730, 21.277025299999877
731, 4.074577936521525, 39.47103024353555, 47.428238178879795, 0.5358452499999998, 375.0, 694, 516075, 731, 14.90523419999954
732, 10.700396001338959, 39.45760487235166, 47.66593634253517, 0.53536465, 5.0, 374, 516449, 732, 8.024067100000138
733, 4.307977108581161, 39.42093674703078, 47.50074433196675, 0.5350379499999997, 50.0, 352, 516801, 733, 7.471788800000468
734, 3.304842655157902, 39.41481328208066, 47.355089185364854, 0.5344992999999999, 205.0, 845, 517646, 734, 17.86261039999954
735, 2.462849724619603, 39.528045766300075, 47.49441105343517, 0.5338585000000001, 140.0, 579, 518225, 735, 12.249598800000058
736, 4.184890769768243, 39.497415742970475, 47.54094720705591, 0.5331524499999999, 430.0, 990, 519215, 736, 21.043992799999614
737, 3.8916497282611515, 39.44552433297858, 47.43126306256044, 0.5321507500000001, 475.0, 1236, 520451, 737, 26.20551880000039
738, 2.4789093032942535, 39.36290514654446, 47.2869546722254, 0.5314208500000001, 50.0, 386, 520837, 738, 8.282360600000175
739, 4.859104061415978, 39.45644789850422, 47.48512561841943, 0.5308948000000002, 140.0, 783, 521620, 739, 16.808673999999883
740, 4.918903419920981, 39.29814739262037, 47.308457984298954, 0.5302953999999999, 55.0, 549, 522169, 740, 11.7798571000003
741, 5.677024954675682, 39.31209265895622, 47.29841308997422, 0.5296231000000003, 250.0, 945, 523114, 741, 20.287631899999724
742, 2.422934984922596, 39.38590363051077, 47.313457441180475, 0.5289107499999999, 210.0, 638, 523752, 742, 13.656948900000316
743, 9.411503777570195, 39.45790136831778, 47.60027687637894, 0.5283806500000001, 60.0, 540, 524292, 743, 11.635238599999866
744, 4.418299587222612, 39.38791906671034, 47.36030474539694, 0.5277088000000001, 120.0, 953, 525245, 744, 20.43368669999927
745, 3.592247467673652, 39.3569433001861, 47.30416743526255, 0.5267741499999998, 275.0, 1124, 526369, 745, 24.121928300000036
746, 4.655782232192201, 39.439865691374536, 47.43026230741928, 0.5259807999999998, 65.0, 639, 527008, 746, 13.772236100000555
747, 3.5082546119565325, 39.164769084260776, 47.106944481061525, 0.5254650999999999, 140.0, 507, 527515, 747, 10.988253900000018
748, 7.407953620199924, 39.452880164851315, 47.4890370161637, 0.5250713500000002, 35.0, 368, 527883, 748, 7.900332799999887
749, 3.9919059899104528, 39.43601046580585, 47.44166003771065, 0.5245790499999997, 70.0, 726, 528609, 749, 15.763350699999137
750, 4.266483775823861, 39.09905583149678, 46.96227925389378, 0.5241025000000001, 30.0, 333, 528942, 750, 7.247109500000079
751, 4.124933096257912, 39.48596695783883, 47.51988286676156, 0.5237641, 35.0, 419, 529361, 751, 9.092374399999244
752, 6.054810871762904, 39.382377210023435, 47.46489268771851, 0.5233312, 50.0, 543, 529904, 752, 11.805558499999279
753, 6.033099029889868, 39.727126291103616, 47.84304550273013, 0.5226161500000004, 290.0, 1046, 530950, 753, 22.659474399999453
754, 7.674196972777396, 39.75614794813437, 47.89282174667126, 0.5217021999999997, 135.0, 985, 531935, 754, 21.32041500000014
755, 4.693160804707125, 39.628330709335955, 47.59742141752207, 0.5210186499999998, 60.0, 534, 532469, 755, 11.640214200000628
756, 6.164249200601514, 39.76222121555652, 47.92800057378505, 0.5204763999999998, 380.0, 671, 533140, 756, 14.685739900000044
757, 4.213561606111154, 39.71984131977666, 47.74799034243724, 0.5197078000000004, 290.0, 1037, 534177, 757, 22.593469299999924
758, 5.091320461360299, 39.74365601476752, 47.843768886702655, 0.5190021999999999, 80.0, 531, 534708, 758, 11.593674599999758
759, 7.590734805653263, 39.7402735061917, 47.858508123621824, 0.51825745, 505.0, 1124, 535832, 759, 24.505976999999803
760, 2.627717752147604, 39.905496459368884, 47.910400491542916, 0.5174964999999997, 100.0, 567, 536399, 760, 12.469794300000103
761, 4.206983584363893, 39.78104390550333, 47.85191994443631, 0.5167477000000001, 290.0, 1097, 537496, 761, 23.992960999999923
762, 7.469739067779397, 39.82262916804859, 47.911399375867546, 0.5158962999999994, 230.0, 795, 538291, 762, 17.529148700000405
763, 3.5455556327014937, 39.81852565134378, 47.875908399883066, 0.51529915, 110.0, 532, 538823, 763, 11.7036307999997
764, 7.1502363640488635, 39.771595093418824, 47.888830519154716, 0.5147618499999999, 145.0, 662, 539485, 764, 14.666542500000105
765, 4.814356722707767, 39.81448941450487, 47.9302941508786, 0.5141026000000003, 190.0, 803, 540288, 765, 17.657806999999593
766, 6.112996482668997, 40.12530039692973, 48.27076654119806, 0.51357745, 75.0, 364, 540652, 766, 8.07419100000061
767, 6.043362889776225, 39.94057248506932, 48.043304024404186, 0.5129465499999997, 335.0, 1038, 541690, 767, 22.802399700000024
768, 8.953212791646365, 39.99475163221359, 48.12137367576361, 0.51224905, 100.0, 512, 542202, 768, 11.376437400000214
769, 5.9746931251078035, 39.86123159872519, 47.968268350137244, 0.5116023999999999, 150.0, 925, 543127, 769, 20.482312499999352
770, 4.461304805739674, 39.937903426414316, 47.987983564997826, 0.5108765500000002, 165.0, 688, 543815, 770, 15.30885599999965
771, 5.9078515932584805, 39.91129975091843, 48.090376161393664, 0.5104157499999998, 30.0, 336, 544151, 771, 7.466466900000341
772, 4.060432262103492, 39.89669715811353, 47.95276591849671, 0.5099212000000003, 295.0, 763, 544914, 772, 16.86127359999955
773, 6.7303758635626005, 39.8606705956247, 48.019081737889096, 0.5093046999999999, 65.0, 607, 545521, 773, 13.438970799999879
774, 4.231303271540679, 39.93536378042001, 48.004106614160946, 0.5085586000000004, 390.0, 1051, 546572, 774, 23.32679559999997
775, 3.464895295451012, 39.83922351820402, 47.86550271633254, 0.5077782999999999, 105.0, 683, 547255, 775, 15.179692000000614
776, 4.873117463885721, 39.87058145438445, 47.978908382585026, 0.5072072500000001, 155.0, 586, 547841, 776, 13.09105080000063
777, 3.387745411309585, 39.8359068215999, 47.89012468283333, 0.5066767000000001, 110.0, 593, 548434, 777, 13.215557099999387
778, 3.3269126267320868, 39.89922950302345, 47.94459189262943, 0.5060993499999996, 175.0, 690, 549124, 778, 15.490117599999394
779, 6.887262276856296, 39.95581784535603, 48.111714641157405, 0.5056020999999998, 85.0, 415, 549539, 779, 9.302293400000053
780, 2.792286696283858, 39.914263617679175, 47.9736688251289, 0.5051242, 60.0, 647, 550186, 780, 14.532282000000123
781, 4.681093521770977, 39.760082907369494, 47.79303300146963, 0.5046724, 75.0, 357, 550543, 781, 7.99079410000013
782, 3.705635704448567, 39.83648629259707, 47.895019238979664, 0.5040595000000001, 260.0, 1005, 551548, 782, 22.380330799999683
783, 4.957871678241645, 39.93322230130434, 48.05138623714447, 0.5033768499999998, 145.0, 512, 552060, 783, 11.59773849999965
784, 2.8557290993120574, 39.80805693151744, 47.78912707115417, 0.50294935, 105.0, 438, 552498, 784, 9.84791689999929
785, 2.476860424535615, 39.938568115234375, 47.96721518380301, 0.5025947500000002, 15.0, 350, 552848, 785, 7.897190900000169
786, 6.37590996799163, 39.92412132941113, 48.07093880442201, 0.5021181999999998, 155.0, 709, 553557, 786, 16.142801699999836
787, 4.919237821461709, 39.81780798128336, 47.88371203475154, 0.5014810000000001, 115.0, 707, 554264, 787, 15.905556400000023
788, 5.281221716484878, 39.897553897952484, 47.99757986998695, 0.5009275, 130.0, 523, 554787, 788, 11.84900209999978
789, 3.542204840139134, 40.00701954074606, 48.08650665570382, 0.5003335, 260.0, 797, 555584, 789, 17.99764839999989
790, 4.064762987050875, 39.83072915085679, 47.91879602435639, 0.49972150000000015, 90.0, 563, 556147, 790, 12.747818200000438
791, 7.733869776988835, 39.78076862767487, 47.85733346958047, 0.49924179999999974, 120.0, 503, 556650, 791, 11.405283999999483
792, 6.250669523484863, 39.9121206579806, 48.037748134103715, 0.49868515000000024, 225.0, 734, 557384, 792, 16.602699199999734
793, 5.618528498803049, 39.71753046296526, 47.77197655884352, 0.49806189999999995, 75.0, 651, 558035, 793, 14.816963100000066
794, 6.070931787088947, 39.92368779456306, 48.04920091786598, 0.4971970000000004, 475.0, 1271, 559306, 794, 28.736103700000058
795, 6.652016344355907, 39.505173075292724, 47.55380584477187, 0.49599459999999934, 485.0, 1401, 560707, 795, 31.69437939999989
796, 4.90565472446568, 39.191284494528155, 47.16992657564423, 0.49489524999999956, 295.0, 1042, 561749, 796, 23.780209399999876
797, 4.750075842764918, 39.141580913831994, 47.09226133214944, 0.4940155000000001, 315.0, 913, 562662, 797, 20.68645689999994
798, 4.693760036579653, 39.265582653477026, 47.25079179497357, 0.4931987500000001, 300.0, 902, 563564, 798, 20.699301399999968
799, 10.16681300394046, 39.2271118620522, 47.248372650146486, 0.4925296, 60.0, 585, 564149, 799, 13.503952900000513
800, 3.1446392479259218, 39.195430072508714, 47.068763453083385, 0.4918492000000001, 275.0, 927, 565076, 800, 21.381070599999475
801, 4.750899467166041, 39.38704305299571, 47.293044882760924, 0.4912723, 60.0, 355, 565431, 801, 8.249181900000622
802, 3.306152656392471, 39.11905750240292, 47.017771265528225, 0.4906130499999994, 480.0, 1110, 566541, 802, 25.492667299999994
803, 7.897383329400327, 39.17471758276224, 47.22776322066784, 0.48988315000000016, 80.0, 512, 567053, 803, 11.798594399999274
804, 4.011032496684606, 39.27424044461594, 47.227555412607096, 0.48947814999999995, 45.0, 388, 567441, 804, 9.006191399999807
805, 2.5213455088888876, 39.11836541270296, 46.93933931783366, 0.4890218500000002, 45.0, 626, 568067, 805, 14.453102299999955
806, 2.794539317443787, 39.16267804065382, 47.07411308748176, 0.4884413500000003, 150.0, 664, 568731, 806, 15.398989600000277
807, 3.858952813101026, 39.22945965117058, 47.20547927586378, 0.4878882999999998, 105.0, 565, 569296, 807, 13.075853800000004
808, 4.0139674315860105, 39.196638468466126, 47.14754830070503, 0.48719440000000014, 615.0, 977, 570273, 808, 22.84324529999958
809, 4.174280809090201, 39.27752545208455, 47.24209950636371, 0.48639879999999963, 115.0, 791, 571064, 809, 18.3896780999994
810, 4.109317537007717, 39.07881604708158, 46.956865931403705, 0.48581469999999993, 65.0, 507, 571571, 810, 11.793663800000104
811, 7.288608918651874, 39.281292974518834, 47.266023655130404, 0.4852746999999999, 65.0, 693, 572264, 811, 16.160402700000304
812, 3.5789849730001557, 39.284974729097804, 47.21746622721354, 0.48469960000000006, 105.0, 585, 572849, 812, 13.636123500000394
813, 3.5597857946497515, 39.090399456477584, 47.01245446666107, 0.48415240000000004, 120.0, 631, 573480, 813, 14.68280059999961
814, 3.417165742737132, 39.02986424929136, 46.910955404306385, 0.4835219499999996, 145.0, 770, 574250, 814, 17.976090099999965
815, 3.9828213590222434, 39.22933120985289, 47.1565605928232, 0.48277585000000006, 275.0, 888, 575138, 815, 20.6541729999999
816, 7.288869603467521, 39.097136359902755, 47.09718763057272, 0.48219534999999997, 80.0, 402, 575540, 816, 9.586555999999291
817, 2.8252026968374238, 39.135412980165405, 47.03172911350344, 0.4818493, 70.0, 367, 575907, 817, 8.558351099999527
818, 6.900506063469277, 39.16341550743016, 47.10133350615011, 0.4814083000000002, 105.0, 613, 576520, 818, 14.374103899999682
819, 10.336192921912001, 39.27928162199955, 47.359632518114196, 0.4808358999999996, 110.0, 659, 577179, 819, 15.507555299999694
820, 5.9412100582763, 39.10762209614749, 46.996793857957954, 0.48036924999999986, 50.0, 378, 577557, 820, 8.840182699999787
821, 4.446467082556805, 39.280140599260655, 47.238590088341404, 0.47989450000000006, 75.0, 677, 578234, 821, 15.82881559999987
822, 7.881920957002774, 39.233815373187085, 47.284196348075405, 0.4793657500000001, 60.0, 498, 578732, 822, 11.728184100000362
823, 7.367614287552954, 39.22512535807453, 47.22623775578752, 0.47885724999999985, 115.0, 632, 579364, 823, 14.928368400000181
824, 4.98012175825802, 39.30693254728575, 47.23709157479776, 0.47823984999999986, 165.0, 740, 580104, 824, 17.532869000000574
825, 3.4431028965316464, 39.497035135847796, 47.446837465950615, 0.4775063500000002, 310.0, 890, 580994, 825, 20.93993320000027
826, 6.3489186144640755, 39.53960540972981, 47.56297883838594, 0.4767309999999997, 190.0, 833, 581827, 826, 19.650586400000066
827, 3.47317777065694, 39.58139880586066, 47.51430002497046, 0.47603035, 125.0, 724, 582551, 827, 17.0917658999997
828, 5.35926944189521, 39.493536499858266, 47.5240771748737, 0.4754084499999997, 355.0, 658, 583209, 828, 15.70282380000026
829, 2.4749205546985142, 39.606673993080925, 47.530851528798934, 0.4747370500000002, 190.0, 834, 584043, 829, 19.717724799999814
830, 4.874445768061486, 39.47069647926954, 47.51192937407104, 0.4742186500000001, 25.0, 318, 584361, 830, 7.593390699999873
831, 5.820763694340072, 39.56020192564529, 47.60596364763691, 0.4737789999999997, 120.0, 659, 585020, 831, 15.54634150000038
832, 5.584472740057604, 39.53908582699079, 47.530580239793274, 0.47318905, 100.0, 652, 585672, 832, 15.557249700000284
833, 4.794309842351938, 39.49114383567851, 47.47024875975252, 0.4726440999999999, 15.0, 559, 586231, 833, 13.383128000000397
834, 2.5714869078505656, 39.49187874794006, 47.42383787549775, 0.47218374999999996, 125.0, 464, 586695, 834, 11.172402600000169
835, 6.837846851001991, 39.590769871603115, 47.680017225434995, 0.4716154, 100.0, 799, 587494, 835, 19.00538729999971
836, 4.188928145158793, 39.36913945087223, 47.331642857304324, 0.4709034999999996, 110.0, 783, 588277, 836, 18.690259699999842
837, 4.947202246331412, 39.46891255450368, 47.42535888213347, 0.4702815999999999, 115.0, 599, 588876, 837, 14.261471199999505
838, 4.740517054499846, 39.545231545618336, 47.55117774616972, 0.46960569999999957, 480.0, 903, 589779, 838, 21.594816799999535
839, 6.609473074709668, 39.363212346095665, 47.42011800279804, 0.46896984999999985, 115.0, 510, 590289, 839, 12.261035800000172
840, 7.533222267774449, 39.2506964738945, 47.253154369669225, 0.4684460499999999, 90.0, 654, 590943, 840, 15.853477299999213
841, 5.005852162355353, 39.17479917909774, 47.12844449144948, 0.4678183000000003, 410.0, 741, 591684, 841, 17.924976100001004
842, 4.203436019856826, 39.277809880304, 47.21934951619899, 0.46697724999999984, 440.0, 1128, 592812, 842, 26.964705700000195
843, 4.514154441593163, 39.24667391645799, 47.18051312647828, 0.46597914999999995, 630.0, 1090, 593902, 843, 26.20403020000049
844, 6.057046732163046, 39.27402170456667, 47.274956677686724, 0.46515205, 240.0, 748, 594650, 844, 18.016795999999886
845, 4.327995208891037, 39.27887558025089, 47.227394677250764, 0.4644860500000001, 100.0, 732, 595382, 845, 17.67864969999937
846, 6.79257464893697, 39.19320360211094, 47.167992806320555, 0.46396854999999987, 35.0, 418, 595800, 846, 10.216096500000276
847, 3.1025653287961887, 39.138611793518066, 46.92625013574377, 0.46364184999999997, 10.0, 308, 596108, 847, 7.476215400000001
848, 4.299599334122019, 39.194319532272665, 47.11889490168145, 0.46333404999999983, 55.0, 376, 596484, 848, 9.15880670000115
849, 6.208830160656905, 39.1949047521272, 47.148595311335015, 0.4625141499999994, 470.0, 1446, 597930, 849, 34.77890049999951
850, 6.637133593344535, 39.23956606961991, 47.17589712682179, 0.4615849, 60.0, 619, 598549, 850, 15.101343099999212
851, 6.132781592581634, 39.29908228014583, 47.31193938998311, 0.4610782000000001, 80.0, 507, 599056, 851, 12.379555599998639
852, 9.25725152652495, 39.39235084306839, 47.47537374720327, 0.46056249999999993, 125.0, 639, 599695, 852, 15.609334100001433
853, 3.524838623360242, 38.78058303228699, 46.612215117652816, 0.46000224999999995, 65.0, 606, 600301, 853, 14.876325400000496
854, 3.645001992693927, 38.63310660938225, 46.38502080369704, 0.45936595000000024, 115.0, 808, 601109, 854, 19.704445600000327
855, 7.108367028314548, 38.59805695588655, 46.5051872074477, 0.4587913, 60.0, 469, 601578, 855, 11.500052699999287
856, 7.0199135686152765, 38.61580499055707, 46.48250144377888, 0.4582431999999997, 225.0, 749, 602327, 856, 18.315847699999722
857, 6.681263447861324, 38.66142082605206, 46.485369553331466, 0.45746695000000004, 165.0, 976, 603303, 857, 23.892764700000043
858, 4.564703783325371, 38.58112852196945, 46.37141625923023, 0.4567199499999999, 110.0, 684, 603987, 858, 16.69601859999966
859, 3.383649937974082, 38.595796188653686, 46.346299718719685, 0.4560679, 185.0, 765, 604752, 859, 18.740028000000166
860, 4.875990952351559, 38.643001568721836, 46.41956212254834, 0.4554450999999999, 90.0, 619, 605371, 860, 15.23127469999963
861, 4.725247246428511, 38.46096530608599, 46.20731441041457, 0.45477910000000005, 180.0, 861, 606232, 861, 21.15893849999884
862, 5.550205013270794, 38.623435772940304, 46.43261207286533, 0.4541697999999999, 60.0, 493, 606725, 862, 12.118518299999778
863, 6.996898190187128, 38.674309869207256, 46.577382892036866, 0.45374679999999995, 90.0, 447, 607172, 863, 11.01044340000044
864, 5.87174179763568, 38.487898757630155, 46.28384707158343, 0.45318475, 215.0, 802, 607974, 864, 19.768934899999294
865, 5.528768964532316, 38.709373374751266, 46.53013977956151, 0.45251290000000005, 185.0, 691, 608665, 865, 17.087481200000184
866, 6.268107584569598, 38.646558557137865, 46.47582700844203, 0.45189550000000017, 95.0, 681, 609346, 866, 16.756512800000564
867, 5.036050033081501, 38.59270505905151, 46.4260006177993, 0.4512110499999996, 310.0, 840, 610186, 867, 20.66285760000028
868, 3.404917609021524, 38.21525751616177, 45.891008972808756, 0.4503186999999999, 345.0, 1143, 611329, 868, 28.31640200000038
869, 4.231777676241866, 38.35976721044991, 46.0684516239256, 0.4493260000000003, 375.0, 1063, 612392, 869, 26.14132790000076
870, 7.1350802063650995, 38.3287320316586, 46.09743173617864, 0.4485249999999997, 215.0, 717, 613109, 870, 17.851280299999416
871, 2.735557131008389, 38.31435043295634, 45.95993668271094, 0.44802774999999995, 80.0, 388, 613497, 871, 9.63500860000022
872, 6.199254466186152, 38.40661606927765, 46.1998657813439, 0.44768350000000007, 65.0, 377, 613874, 872, 9.442910499999925
873, 4.377823408886972, 38.3206005540005, 46.056213763333105, 0.4471074999999996, 280.0, 903, 614777, 873, 22.45441589999973
874, 5.854689240083099, 38.420136997776645, 46.221693672672394, 0.4461431499999999, 360.0, 1240, 616017, 874, 30.94380419999834
875, 6.1800526976980645, 38.39395412273053, 46.13343624347717, 0.44524585000000005, 205.0, 754, 616771, 875, 18.825324600000386
876, 5.400199591270968, 38.35578215571571, 46.12500848791287, 0.44450064999999983, 205.0, 902, 617673, 876, 22.52048570000079
877, 5.896290381974759, 38.35833862996771, 46.11946485229668, 0.4434697, 425.0, 1389, 619062, 877, 34.55989679999948
878, 4.02229952784371, 38.43737609356766, 46.17634808868788, 0.44262775, 15.0, 482, 619544, 878, 12.06161559999964
879, 6.336601788056765, 38.4775399540576, 46.2370829015856, 0.44217594999999993, 80.0, 522, 620066, 879, 13.061735499999486
880, 4.603013347632539, 38.80930226159829, 46.7277996348078, 0.44163369999999985, 165.0, 683, 620749, 880, 17.133924699999625
881, 4.4387764607302165, 38.873434006084096, 46.719130143252286, 0.44112835000000006, 30.0, 440, 621189, 881, 11.232651300000725
882, 5.353395953597057, 38.85114288742924, 46.738648084335, 0.4405145500000001, 215.0, 924, 622113, 882, 23.29492930000015
883, 9.615060942264291, 38.88830202119844, 46.810503559284385, 0.43984900000000005, 115.0, 555, 622668, 883, 14.07669949999945
884, 5.854317939193378, 38.90083622110301, 46.78491914683375, 0.43941654999999985, 20.0, 406, 623074, 884, 10.772145199998704
885, 3.778005200816622, 38.7941460899483, 46.58313505260904, 0.4390489000000001, 80.0, 411, 623485, 885, 10.572869300000093
886, 3.7874895960211044, 38.79877893588178, 46.55213269182512, 0.4386375999999999, 55.0, 503, 623988, 886, 12.635908300000665
887, 4.685435105211797, 38.80750248823798, 46.65592333768905, 0.4380989499999999, 105.0, 694, 624682, 887, 17.63200610000058
888, 5.520126041453947, 38.78459706409763, 46.625569146742436, 0.4373919999999997, 520.0, 877, 625559, 888, 22.423778799999127
889, 2.9530827469169294, 38.67909544147907, 46.42410318436632, 0.4367619999999999, 145.0, 523, 626082, 889, 13.39629799999966
890, 3.8477782367793347, 38.74567357249715, 46.599065124314514, 0.43624809999999997, 125.0, 619, 626701, 890, 15.633011700001589
891, 7.3369877691769485, 38.951836234157525, 46.8362005474498, 0.43578415000000015, 50.0, 412, 627113, 891, 10.505937300000369
892, 3.3864763542366743, 38.74113753499502, 46.579264678382515, 0.4353588999999998, 55.0, 533, 627646, 892, 13.621021000000837
893, 2.5766671493032276, 38.70818996993748, 46.45410864263832, 0.43489089999999997, 80.0, 507, 628153, 893, 12.946952499998588
894, 4.853563877385099, 38.749293775639984, 46.585150148114586, 0.43403094999999975, 305.0, 1404, 629557, 894, 35.74693179999849
895, 5.2149809910776375, 38.689447026052875, 46.51675112756664, 0.4329482499999997, 285.0, 1002, 630559, 895, 25.59752479999952
896, 4.783416802806489, 38.54505564849501, 46.335388255257136, 0.43218595000000004, 185.0, 692, 631251, 896, 17.654120499999408
897, 7.7901392647388255, 38.5755361553138, 46.42160749532146, 0.43143084999999975, 280.0, 986, 632237, 897, 25.431349399999817
898, 4.132580670533336, 38.52630946792175, 46.258713599231754, 0.4305056499999999, 340.0, 1070, 633307, 898, 27.3382416000004
899, 4.249678541840592, 38.55888767645393, 46.32659167974767, 0.4295129500000001, 395.0, 1136, 634443, 899, 29.07894579999993
900, 4.465196430029934, 38.57015310836165, 46.37614892410905, 0.4288374999999999, 60.0, 365, 634808, 900, 9.490154999999504
901, 5.393380716736125, 38.42510628519909, 46.230686355106045, 0.42837580000000003, 130.0, 661, 635469, 901, 17.008393199999773
902, 6.543636397610573, 38.62033285655575, 46.42403728626849, 0.42779979999999984, 120.0, 619, 636088, 902, 15.942263299999468
903, 4.258099639415741, 38.48978998372843, 46.167296935699795, 0.42731650000000015, 65.0, 455, 636543, 903, 11.822822600001018
904, 5.431401648031814, 38.57383506774902, 46.372627868652344, 0.42679674999999984, 140.0, 700, 637243, 904, 18.10935249999966
905, 4.033612951016113, 38.6570471714517, 46.420651113086045, 0.42607089999999964, 340.0, 913, 638156, 905, 23.620972800001255
906, 5.0181299124766765, 38.62215559929609, 46.442386627197266, 0.42531444999999996, 120.0, 768, 638924, 906, 19.88604469999882
907, 2.496686563878655, 38.49102779608593, 46.256182950292796, 0.42458679999999965, 215.0, 849, 639773, 907, 22.010187300000325
908, 5.498529952585971, 38.587382127612415, 46.43506014951363, 0.42381415000000006, 280.0, 868, 640641, 908, 22.457629599999564
909, 5.342452405056871, 38.7247662861288, 46.53904791755753, 0.42275349999999956, 745.0, 1489, 642130, 909, 38.40203360000123
910, 6.936831379777886, 38.75164482128695, 46.578679075780904, 0.42151105, 305.0, 1272, 643402, 910, 32.93126990000019
911, 4.422591223989313, 38.6558621374812, 46.43858363900964, 0.4206276999999999, 150.0, 691, 644093, 911, 18.16608180000003
912, 6.005616015416977, 38.6191413004523, 46.38834850703685, 0.4200498999999999, 45.0, 593, 644686, 912, 15.44642980000026
913, 4.288826143318187, 38.64481096319813, 46.44991502605501, 0.41961835000000003, 105.0, 366, 645052, 913, 9.655019399999219
914, 4.239953463663728, 38.6332144500516, 46.41160118157136, 0.41926329999999995, 65.0, 423, 645475, 914, 11.040234500000224
915, 3.70587408107578, 38.58083084709049, 46.31548032774071, 0.41875390000000023, 145.0, 709, 646184, 915, 18.666688299999805
916, 3.002451771718203, 38.56759764223683, 46.28492814667371, 0.41825845, 35.0, 392, 646576, 916, 10.24844210000083
917, 6.296667240382152, 38.6834208243442, 46.57457095185347, 0.4176108999999996, 155.0, 1047, 647623, 917, 27.411189799999192
918, 4.790249024855439, 38.49670931696892, 46.278449314832685, 0.4168517499999999, 80.0, 640, 648263, 918, 16.899538100000427
919, 5.323567563575609, 38.758798716885494, 46.598854728367016, 0.4161186999999995, 370.0, 989, 649252, 919, 25.986146300001565
920, 8.16793177891674, 38.775461755147795, 46.63484706723593, 0.41545225, 50.0, 492, 649744, 920, 12.911213600000337
921, 6.209572427399943, 39.41265728680984, 47.39523160975912, 0.4148996499999998, 140.0, 736, 650480, 921, 19.364187999999558
922, 5.554405144339516, 39.81052538917178, 47.85080200195313, 0.41433219999999993, 165.0, 525, 651005, 922, 13.937259299998914
923, 6.5877630092364425, 39.854941665868964, 47.8872727593072, 0.41347045, 595.0, 1390, 652395, 923, 36.362483599999905
924, 6.829253571467722, 39.89349774536657, 47.955669714145905, 0.4124255500000001, 170.0, 932, 653327, 924, 24.612255699999878
925, 5.035664813194739, 39.73743734455196, 47.740486790637085, 0.4115116000000003, 340.0, 1099, 654426, 925, 29.002970800000185
926, 4.54181473565413, 39.742980404754185, 47.760329995226506, 0.41071554999999976, 80.0, 670, 655096, 926, 17.863059400000566
927, 3.9340156367950407, 39.69314930454117, 47.68523346495679, 0.40998835000000017, 215.0, 946, 656042, 927, 25.149686500000826
928, 4.068793820808211, 39.82420601136234, 47.837495313590786, 0.4093385499999998, 90.0, 498, 656540, 928, 13.193006100000275
929, 5.975520260097308, 39.74491240761497, 47.76858803872286, 0.40873825000000014, 250.0, 836, 657376, 929, 22.16223480000008
930, 2.6776344519733946, 39.76677268090909, 47.72640993067238, 0.4079921499999999, 215.0, 822, 658198, 930, 21.90151160000096
931, 4.196756572623674, 39.732456494094734, 47.70123253012062, 0.40738284999999996, 105.0, 532, 658730, 931, 14.083631199999218
932, 6.814094532752174, 39.77994602393373, 47.85221218971457, 0.4069085500000002, 50.0, 522, 659252, 932, 13.890305000000808
933, 2.9582470697082885, 39.68085482871696, 47.63676973107743, 0.40650939999999985, 50.0, 365, 659617, 933, 9.887455400001272
934, 8.528016756075342, 39.70152899237849, 47.81252136810336, 0.40593070000000026, 340.0, 921, 660538, 934, 24.717145200000232
935, 4.99043714107751, 39.18907949817714, 47.12307647448867, 0.4052750499999999, 110.0, 536, 661074, 935, 14.345510099999956
936, 4.708756675327982, 39.43884957526341, 47.37156351341689, 0.4045982500000004, 130.0, 968, 662042, 936, 26.09629390000009
937, 6.590853901717681, 39.55342742533999, 47.60564775132947, 0.40393134999999997, 35.0, 514, 662556, 937, 13.763477699998475
938, 7.71704735584455, 39.497536813396295, 47.558568207205155, 0.4035357999999998, 75.0, 365, 662921, 938, 9.831793800000014
939, 5.045673119406337, 39.4282002614892, 47.35775633687558, 0.4029575500000001, 350.0, 920, 663841, 939, 24.665957100000014
940, 2.855375866029436, 39.31133043739706, 47.19981195647722, 0.4023396999999999, 45.0, 453, 664294, 940, 12.32673910000085
941, 5.523564501010809, 39.37654949728511, 47.33693249092593, 0.4016116000000003, 375.0, 1165, 665459, 941, 31.272967299999436
942, 4.2682728116908, 39.345359404052225, 47.28213064556082, 0.4008717999999999, 50.0, 479, 665938, 942, 12.922079699999813
943, 6.207098451550996, 39.45737802809563, 47.431278705596924, 0.40015945000000014, 360.0, 1104, 667042, 943, 29.81646770000043
944, 5.658517461852514, 39.453735480969634, 47.41202291978144, 0.3993575499999998, 135.0, 678, 667720, 944, 18.397647199999483
945, 6.125661236165192, 39.47571381442065, 47.47597171990155, 0.39886974999999997, 35.0, 406, 668126, 945, 10.915668599998753
946, 4.665078553890169, 39.35074846923587, 47.271814719490386, 0.39823164999999994, 115.0, 1012, 669138, 946, 27.422959499999706
947, 5.809498302499882, 39.42169856371305, 47.407434797894126, 0.3973168000000002, 255.0, 1021, 670159, 947, 27.585157100000288
948, 6.331404227606308, 39.42506479859097, 47.39910229348216, 0.3962277999999999, 465.0, 1399, 671558, 948, 38.00505169999997
949, 4.295415793536323, 39.41347396019662, 47.36041213183513, 0.3950528499999997, 455.0, 1212, 672770, 949, 32.6053705000013
950, 5.379863811984395, 39.398333689424675, 47.3778630791544, 0.394075, 465.0, 961, 673731, 950, 26.317073100000925
951, 6.492259186481671, 39.425263467824685, 47.38213950732969, 0.3932609500000001, 205.0, 848, 674579, 951, 23.10416709999845
952, 4.672431881906691, 39.49050009563957, 47.4063602394992, 0.3925197999999998, 135.0, 799, 675378, 952, 22.02969110000049
953, 4.671999269389901, 39.47214883771436, 47.46273780691212, 0.39195145, 35.0, 464, 675842, 953, 12.754248200000802
954, 7.01749682774518, 39.481702701508354, 47.46678435277265, 0.3912012999999999, 340.0, 1203, 677045, 954, 32.79388950000066
955, 4.493829031022671, 39.47137099238518, 47.362825253504155, 0.39031704999999994, 375.0, 762, 677807, 955, 20.846072100001038
956, 3.4760348518396103, 39.44652234561089, 47.36759923091974, 0.3895322499999997, 135.0, 982, 678789, 956, 26.783087600000727
957, 6.424947340579171, 39.38576016964249, 47.40350554058245, 0.3887474499999999, 105.0, 762, 679551, 957, 20.756533499999932
958, 8.92829855137451, 39.29792174241298, 47.310413766923105, 0.3880454499999997, 170.0, 798, 680349, 958, 22.107061999999132
959, 5.047581759541213, 38.954116730462935, 46.78111300825262, 0.38742174999999984, 80.0, 588, 680937, 959, 16.22000450000087
960, 5.7334488664369125, 39.11501988832997, 46.96560858595222, 0.3867615999999997, 235.0, 879, 681816, 960, 24.334840299999996
961, 5.398586282640216, 39.0585244710763, 46.96043070936971, 0.38605869999999987, 185.0, 683, 682499, 961, 19.071871899999678
962, 10.652165431761533, 39.233335566342326, 47.235308735150646, 0.3855709000000001, 90.0, 401, 682900, 962, 11.139220500001102
963, 4.173730358004388, 39.058118750409385, 46.857164220112125, 0.38509525000000006, 135.0, 656, 683556, 963, 18.207946999998967
964, 4.902861501491953, 39.10351087632765, 46.99666688161226, 0.38442970000000004, 175.0, 823, 684379, 964, 22.864518100001078
965, 4.697475120459718, 39.03590718610787, 46.87286062593813, 0.38376775, 135.0, 648, 685027, 965, 18.038969799999904
966, 4.338845376409107, 39.07113030668977, 46.935971524292256, 0.38306035, 125.0, 924, 685951, 966, 25.568865900000674
967, 7.616862920802514, 39.11990974513629, 47.11574231213286, 0.3824087499999999, 65.0, 524, 686475, 967, 14.61901669999861
968, 7.015202358547671, 39.05714030359306, 46.92016437941906, 0.38198934999999995, 75.0, 408, 686883, 968, 11.366568800000096
969, 5.820600643436284, 39.26782252590285, 47.21240454391122, 0.38138364999999996, 140.0, 938, 687821, 969, 26.07132029999957
970, 3.6644655327142783, 39.10764958123741, 46.956720508119595, 0.38067534999999997, 150.0, 636, 688457, 970, 17.741890400000557
971, 5.421182997067376, 39.183677721180935, 47.081851264273766, 0.3797073999999999, 630.0, 1515, 689972, 971, 43.005566399999225
972, 5.079930630801567, 39.24396920615229, 47.13966982529081, 0.37860805000000003, 145.0, 928, 690900, 972, 26.022478200000478
973, 9.248942237016546, 39.236182334340214, 47.19212954753154, 0.37795734999999997, 50.0, 518, 691418, 973, 14.479731100000208
974, 8.001672321502681, 39.13843162430411, 47.048014249159955, 0.37733635000000004, 225.0, 862, 692280, 974, 24.125698300000295
975, 7.0837218311020145, 39.23064897555423, 47.18665392365599, 0.37633510000000037, 825.0, 1363, 693643, 975, 38.04097349999938
976, 6.28718293037745, 39.24766339594775, 47.17298435928798, 0.3752672499999997, 285.0, 1010, 694653, 976, 28.49327009999979
977, 2.7870209181137873, 39.1478080041895, 46.96493826185873, 0.37454590000000004, 100.0, 593, 695246, 977, 16.90692879999915
978, 6.10950150141716, 39.15728965454102, 47.023327392578125, 0.37399779999999994, 90.0, 625, 695871, 978, 17.622710699999516
979, 6.395937566360873, 39.23334535956383, 47.158960077497696, 0.37319814999999995, 310.0, 1152, 697023, 979, 32.24189690000094
980, 6.493461258365134, 39.16924237235416, 47.18666610435726, 0.37243630000000005, 135.0, 541, 697564, 980, 15.318176900000253
981, 7.031352542234966, 39.21950339110338, 47.18916322735212, 0.37174915, 185.0, 986, 698550, 981, 27.837975300000835
982, 4.539962460436643, 39.152551996213724, 47.01161441860835, 0.37086040000000026, 460.0, 989, 699539, 982, 28.146286099999998
983, 5.3326890987157824, 39.36500040690104, 47.28405443827311, 0.3700778499999999, 105.0, 750, 700289, 983, 21.316993500000535
984, 4.436775186407065, 39.53586491219744, 47.517762453618175, 0.36951579999999995, 245.0, 499, 700788, 984, 14.056495700000596
985, 10.576949863537058, 39.613701214184154, 47.719367988594065, 0.3688417, 440.0, 999, 701787, 985, 28.479354900000544
986, 5.382169989944106, 39.35754924435769, 47.271552624241, 0.36794575000000024, 440.0, 992, 702779, 986, 28.378637499999968
987, 4.5938870337705655, 39.46237545921689, 47.34049558773094, 0.36717804999999987, 110.0, 714, 703493, 987, 20.452571499999976
988, 7.349300935738877, 39.50327794471484, 47.4693597622132, 0.3665363499999999, 170.0, 712, 704205, 988, 20.252946399999928
989, 4.491703610759708, 39.63589672779474, 47.56364429904407, 0.3660445, 70.0, 381, 704586, 989, 10.996660299999348
990, 7.384713029380289, 39.40960058480883, 47.35864877497319, 0.36555669999999985, 105.0, 703, 705289, 990, 20.029135900000256
991, 9.258604422604357, 39.60171127319336, 47.71984852669354, 0.36493299999999984, 80.0, 683, 705972, 991, 19.745578000000023
992, 4.549784012825081, 39.49488241421549, 47.42678724150909, 0.3640784499999996, 330.0, 1216, 707188, 992, 34.454396399998586
993, 8.515428909572213, 39.52932161822833, 47.53951212518612, 0.3632851000000001, 65.0, 547, 707735, 993, 15.666506900000968
994, 5.450871284773692, 39.484102609309744, 47.400063808928145, 0.3627005499999998, 180.0, 752, 708487, 994, 21.65252110000074
995, 4.656782203579127, 39.53707125080165, 47.483763948127404, 0.36206065, 150.0, 670, 709157, 995, 19.36728519999997
996, 4.550539030689575, 39.44223859353378, 47.34490144801439, 0.36143649999999977, 130.0, 717, 709874, 996, 20.82524410000042
997, 5.0552148220397655, 39.72227937730692, 47.73371983544301, 0.3608483499999999, 135.0, 590, 710464, 997, 17.06963540000106
998, 6.34014091678891, 39.92742258633213, 47.957279596286845, 0.36027549999999997, 60.0, 683, 711147, 998, 19.835343499999
999, 3.0235568517711173, 39.88668209061199, 47.90087443613177, 0.35973505, 30.0, 518, 711665, 999, 14.93829949999963
1000, 5.655241579117391, 39.879692137374704, 47.9384599297372, 0.35930079999999986, 90.0, 447, 712112, 1000, 12.977638499998648
1001, 2.8281579239265566, 39.8075649823029, 47.76022449241677, 0.35892235, 70.0, 394, 712506, 1001, 11.483637499999531
1002, 8.977853837594465, 40.06652411655407, 48.28161056480597, 0.35856414999999997, 35.0, 402, 712908, 1002, 11.6398451999994
1003, 6.548449982172136, 39.87147313750375, 47.97061839642555, 0.35796115, 340.0, 938, 713846, 1003, 27.10097870000027
1004, 5.698000886154915, 39.8630597793978, 47.85924617293613, 0.35726364999999977, 75.0, 612, 714458, 1004, 17.98884100000032
1005, 6.745337522234589, 39.79448164309176, 47.84034011767695, 0.35670654999999996, 160.0, 626, 715084, 1005, 18.184059600000182
1006, 6.1517028983066275, 39.758537079392234, 47.80285465286439, 0.35601399999999994, 490.0, 913, 715997, 1006, 26.35125590000098
1007, 6.036656003600989, 39.94735278661479, 48.00326885345234, 0.35523684999999994, 210.0, 814, 716811, 1007, 23.53530359999968
1008, 4.960638933085789, 39.9897294965841, 48.0024427058333, 0.35460505, 110.0, 590, 717401, 1008, 17.209572199999457
1009, 3.590701514491584, 39.77306743559799, 47.76457493479659, 0.35389675000000015, 225.0, 984, 718385, 1009, 28.78232079999907
1010, 4.467129561536842, 39.88960198296441, 47.91551871405707, 0.3532514500000001, 105.0, 450, 718835, 1010, 13.181433600000673
1011, 8.593931219278119, 40.05102036056378, 48.22713409339526, 0.3528046000000002, 90.0, 543, 719378, 1011, 15.957784100000936
1012, 4.618702717897843, 39.5298279151138, 47.4561798811932, 0.3520089999999999, 320.0, 1225, 720603, 1012, 36.12700760000007
1013, 6.344340400770307, 39.37721739628518, 47.35468658550765, 0.35099335000000015, 415.0, 1032, 721635, 1013, 30.125167300000612
1014, 4.882802002747689, 39.184936357923775, 47.048804425011, 0.3503111499999999, 50.0, 484, 722119, 1014, 14.386821800000689
1015, 7.63165584593073, 39.35567849543856, 47.382258545333656, 0.34979319999999997, 140.0, 667, 722786, 1015, 19.68544649999967
1016, 7.981212861652579, 39.31510996231733, 47.32399840515749, 0.3489993999999999, 280.0, 1097, 723883, 1016, 32.34316769999896
1017, 5.639780388889576, 39.40596261671333, 47.37177194039675, 0.34789869999999995, 345.0, 1349, 725232, 1017, 39.818493699998726
1018, 4.196522876061499, 39.469555395299736, 47.39365054910833, 0.34689565000000006, 130.0, 880, 726112, 1018, 26.234188899999936
1019, 5.272118711729462, 39.431660498105565, 47.373274832505444, 0.34626565000000004, 50.0, 520, 726632, 1019, 15.556281600000148
1020, 9.235946282853494, 39.41199438673162, 47.51303549636685, 0.34572430000000015, 175.0, 683, 727315, 1020, 20.124174000000494
1021, 4.089903979282443, 39.33721617317985, 47.23248496663914, 0.34497955, 290.0, 972, 728287, 1021, 28.72118059999957
1022, 4.643092349565502, 39.34777947424442, 47.31526475365816, 0.34423570000000003, 45.0, 681, 728968, 1022, 20.240938200000528
1023, 6.110071617082969, 39.47165904689479, 47.45650062561035, 0.34376275, 50.0, 370, 729338, 1023, 11.010971499999869
1024, 6.077976271605036, 39.507601221655584, 47.533487737052255, 0.3431723499999998, 155.0, 942, 730280, 1024, 31.872793500000625
1025, 6.275715574199698, 39.799754651551396, 47.82961534716419, 0.34239924999999993, 200.0, 776, 731056, 1025, 26.35074760000134
1026, 4.421199944252615, 39.91162143060871, 47.939795264196285, 0.3418614999999999, 90.0, 419, 731475, 1026, 13.023847999998907
1027, 4.103140080333889, 39.70661871486128, 47.742080805294115, 0.34124680000000013, 345.0, 947, 732422, 1027, 35.456065399999716
1028, 5.17441271876747, 39.65347349687056, 47.68707254583185, 0.34057315, 60.0, 550, 732972, 1028, 19.62970730000052
1029, 5.40389185405703, 39.81813449119244, 47.82163928837521, 0.34008220000000006, 40.0, 541, 733513, 1029, 19.63589189999948
1030, 5.140173468623704, 39.78564307360145, 47.83266602182776, 0.3395619999999999, 75.0, 615, 734128, 1030, 21.315326600000844
1031, 5.929968765292974, 39.737444302071246, 47.74378689903365, 0.3386700999999998, 385.0, 1367, 735495, 1031, 47.19740779999847
1032, 5.010058226953646, 39.95637181761918, 48.02471883737358, 0.33777235, 155.0, 628, 736123, 1032, 19.487966199998482
1033, 3.7842119301833503, 39.79813063096551, 47.756376176631306, 0.33715539999999994, 310.0, 743, 736866, 1033, 24.773862400001235
1034, 3.42980648909978, 39.69273464331466, 47.640630271997345, 0.33650065000000007, 160.0, 712, 737578, 1034, 22.658128499999293
1035, 9.37293290199948, 39.87641361845491, 48.056263399795746, 0.33579685000000015, 165.0, 852, 738430, 1035, 29.501238400000148
1036, 10.046910962552433, 39.97109751093308, 48.078417157166754, 0.33514525000000006, 85.0, 596, 739026, 1036, 19.70223729999998
1037, 6.1605317614761725, 39.833058172801756, 47.88058476627997, 0.33449544999999986, 215.0, 848, 739874, 1037, 28.370958299999984
1038, 3.816113492612012, 40.0922603889909, 48.13192194870152, 0.3337192, 370.0, 877, 740751, 1038, 29.20718189999934
1039, 4.895428821414769, 40.114934197918856, 48.17770559725885, 0.33287365000000024, 540.0, 1002, 741753, 1039, 34.503179600000294
1040, 6.762349409825114, 40.28227547823527, 48.44339539255632, 0.33214059999999995, 225.0, 627, 742380, 1040, 22.522877899999003
1041, 4.562845587680847, 40.103694319460715, 48.167149562793405, 0.33145255000000007, 190.0, 902, 743282, 1041, 31.0906116999995
1042, 6.027208117683928, 40.16709666994948, 48.29246698312424, 0.3306884499999999, 90.0, 796, 744078, 1042, 27.189233199998853
1043, 4.889812637735491, 40.21762633699724, 48.34225421749079, 0.3299023, 245.0, 951, 745029, 1043, 35.44676240000081
1044, 7.356350168428093, 40.17419992679011, 48.31196639314951, 0.3292191999999998, 65.0, 567, 745596, 1044, 19.04567980000138
1045, 5.435642740537372, 40.239493452984355, 48.376819491386414, 0.32863285, 190.0, 736, 746332, 1045, 24.339251200000945
1046, 2.825374320996308, 40.286551427776665, 48.35824575669388, 0.32796909999999996, 160.0, 739, 747071, 1046, 24.19249679999848
1047, 6.881362902040177, 40.33009221407588, 48.49727798671985, 0.327277, 165.0, 799, 747870, 1047, 27.353604899999482
1048, 3.621448587799937, 40.13977879736708, 48.22281010286795, 0.32648319999999986, 205.0, 965, 748835, 1048, 31.983023900000262
1049, 10.770885109169846, 40.33392043199958, 48.67661168100914, 0.3258748000000001, 80.0, 387, 749222, 1049, 13.294219199999134
1050, 4.900489826456489, 40.253927983394284, 48.38036253014389, 0.32530375000000006, 195.0, 882, 750104, 1050, 29.834823499999402
1051, 6.9623037351279695, 40.26397016268818, 48.41604038847595, 0.32447845000000014, 280.0, 952, 751056, 1051, 32.109017500000846
1052, 6.535629051864996, 40.266455446642304, 48.41546064713176, 0.32363919999999996, 280.0, 913, 751969, 1052, 31.002325600000404
1053, 5.424967529945709, 40.303363576848454, 48.45222698881271, 0.32288994999999987, 460.0, 752, 752721, 1053, 25.81344530000024
1054, 5.274802185107837, 40.344548044402444, 48.49955428882459, 0.32226939999999993, 140.0, 627, 753348, 1054, 21.728731499999412
1055, 5.2463743970285055, 40.221912663279014, 48.34477933995864, 0.32164299999999996, 190.0, 765, 754113, 1055, 25.560449900000094
1056, 3.7079333689799356, 40.28790845688741, 48.39649552752258, 0.32101614999999994, 200.0, 628, 754741, 1056, 21.466600199999448
1057, 4.638431791991021, 40.29083666955003, 48.41671074982619, 0.3202165000000003, 565.0, 1149, 755890, 1057, 39.20464719999836
1058, 5.710798502589266, 40.245499434925264, 48.379572016852244, 0.31939704999999996, 120.0, 672, 756562, 1058, 22.350757399999566
1059, 6.351295395098616, 40.38911226940023, 48.59171062485311, 0.3187692999999999, 155.0, 723, 757285, 1059, 24.525566700000127
1060, 4.918774091039771, 40.246332094629224, 48.33321119697755, 0.31782879999999974, 415.0, 1367, 758652, 1060, 46.38241900000139
1061, 5.702789805935625, 40.34968741634224, 48.529606979104535, 0.3166448499999999, 195.0, 1264, 759916, 1061, 43.92397770000025
1062, 2.9748969441183357, 39.4087080313799, 47.291898865630664, 0.31585869999999994, 85.0, 483, 760399, 1062, 17.064614599999913
1063, 5.230377992981332, 39.33152087495897, 47.24140509591294, 0.3152156499999999, 255.0, 946, 761345, 1063, 31.31284400000004
1064, 6.213690933245518, 39.41227712361549, 47.34872899059567, 0.3142648, 410.0, 1167, 762512, 1064, 40.71643919999951
1065, 7.16649729608756, 39.289304650348164, 47.27112004168215, 0.3131911000000002, 200.0, 1219, 763731, 1065, 42.31227690000014
1066, 3.464973971311833, 39.34625536915561, 47.22433196150961, 0.31222449999999974, 305.0, 929, 764660, 1066, 31.966099700000996
1067, 6.263008686666903, 39.35532875171606, 47.286594379812044, 0.31103019999999976, 455.0, 1725, 766385, 1067, 58.729012100000546
1068, 3.973580186903789, 39.323275967210165, 47.20914536454499, 0.3099961000000001, 75.0, 573, 766958, 1068, 19.75452740000037
1069, 6.264924276732696, 39.472617806264644, 47.45627925619258, 0.30914244999999996, 440.0, 1324, 768282, 1069, 46.401022099998954
1070, 7.619304978572464, 39.31434918293911, 47.26509391794313, 0.30819069999999993, 135.0, 791, 769073, 1070, 26.912565800001175
1071, 5.583652168105332, 39.32272068538868, 47.280687815502674, 0.30753819999999993, 230.0, 659, 769732, 1071, 22.390253499999744
1072, 4.947809523254377, 39.384959261875096, 47.29710804630487, 0.30692754999999994, 180.0, 698, 770430, 1072, 24.219968499999595
1073, 5.430606010351431, 39.45870306349577, 47.40059900197586, 0.3061157500000002, 435.0, 1106, 771536, 1073, 37.556610000001456
1074, 4.470683157553837, 39.39326208522338, 47.278812230365574, 0.30525174999999977, 180.0, 814, 772350, 1074, 29.46683309999935
1075, 4.090532606053488, 39.47300467946784, 47.38404481323011, 0.30440979999999995, 300.0, 1057, 773407, 1075, 36.13205500000004
1076, 5.831730583069487, 39.41633265556509, 47.42277723513775, 0.3037167999999999, 45.0, 483, 773890, 1076, 17.033161800000016
1077, 10.038917304396078, 39.51669446921643, 47.52643111900047, 0.3032078499999999, 105.0, 648, 774538, 1077, 22.871779699999024
1078, 6.33973078205759, 39.467679029151036, 47.46315820906699, 0.3024401499999997, 245.0, 1058, 775596, 1078, 36.71723200000088
1079, 6.549979470160298, 39.571433303020754, 47.51516238455537, 0.30172734999999984, 55.0, 526, 776122, 1079, 18.338601700001163
1080, 4.922241939408108, 39.47075583592957, 47.41435083470117, 0.3009915999999997, 410.0, 1109, 777231, 1080, 37.88535409999895
1081, 6.534825983923985, 39.46970322451083, 47.42386243132507, 0.3000956500000001, 265.0, 882, 778113, 1081, 30.586679699999877
1082, 6.8323211343078825, 39.54233848935082, 47.52021379016695, 0.2990845000000003, 340.0, 1365, 779478, 1082, 51.3678476999994
1083, 5.799144682774981, 39.55433313742102, 47.54180917625883, 0.29790550000000005, 340.0, 1255, 780733, 1083, 44.13342499999999
1084, 4.014315535087843, 39.74053889536029, 47.7328117252777, 0.29710765000000006, 95.0, 518, 781251, 1084, 18.224272800000108
1085, 7.065006979058186, 39.73022656874223, 47.70879535097065, 0.29657755, 120.0, 660, 781911, 1085, 22.673833299999387
1086, 6.001502044249895, 39.76353033491374, 47.81098382841281, 0.29578240000000006, 275.0, 1107, 783018, 1086, 39.13899030000175
1087, 7.697510264726657, 39.77537150684508, 47.87651077199038, 0.29509209999999997, 75.0, 427, 783445, 1087, 15.110001799999736
1088, 5.680861688989116, 39.775960595014475, 47.840535029745915, 0.29460879999999995, 155.0, 647, 784092, 1088, 23.17384360000142
1089, 6.710957659974317, 39.765024933633924, 47.809814652310145, 0.29403324999999986, 175.0, 632, 784724, 1089, 22.51976150000155
1090, 2.9326135251356895, 39.80972018107832, 47.79289993990856, 0.2935247500000001, 35.0, 498, 785222, 1090, 21.336958500000037
1091, 4.6407616350774346, 39.71351716512971, 47.702320290046295, 0.29290555, 250.0, 878, 786100, 1091, 31.83242959999916
1092, 5.772355846955372, 39.78895426863635, 47.790910893812054, 0.29212839999999995, 125.0, 849, 786949, 1092, 28.87764689999858
1093, 8.394303976324741, 39.82651340399428, 47.904702468190536, 0.29138364999999994, 315.0, 806, 787755, 1093, 27.366115799999534
1094, 5.463201466921299, 39.84414504907209, 47.88258539256805, 0.29038824999999996, 400.0, 1406, 789161, 1094, 48.80083110000123
1095, 7.554145146260354, 39.791812136129366, 47.83265201592007, 0.2893154500000001, 275.0, 978, 790139, 1095, 36.21492709999984
1096, 5.259058797397512, 39.68410887048599, 47.649092709155795, 0.28834659999999973, 190.0, 1175, 791314, 1096, 41.65208330000132
1097, 6.200016352454494, 39.66808324984738, 47.734630737933266, 0.2873809000000001, 255.0, 971, 792285, 1097, 33.878812499999185
1098, 6.302303695445998, 39.68559122926342, 47.74723930262799, 0.28676529999999995, 75.0, 397, 792682, 1098, 13.984060299999328
1099, 5.78861682695501, 39.67924294795386, 47.71424610258767, 0.2860893999999999, 195.0, 1105, 793787, 1099, 39.716596299998855
1100, 4.779019654762628, 39.607695898974725, 47.55350129703438, 0.28522405, 270.0, 818, 794605, 1100, 31.238865400000577
1101, 3.7490041677112367, 39.66354528756259, 47.62213720258281, 0.28443609999999997, 200.0, 933, 795538, 1101, 33.15221510000083
1102, 4.2454420791746434, 39.642792063711404, 47.60040043364891, 0.28350234999999996, 495.0, 1142, 796680, 1102, 40.975661300000866
1103, 6.255078347518926, 39.80037177005387, 47.90631101564373, 0.2828124999999999, 30.0, 391, 797071, 1103, 14.121696999998676
1104, 4.295768908349066, 39.597847140703486, 47.53821052158281, 0.2823832, 90.0, 563, 797634, 1104, 20.394332099998792
1105, 4.79089015860533, 39.68174713174093, 47.64550540373497, 0.28195525, 90.0, 388, 798022, 1105, 13.520560799999657
1106, 3.489643285348219, 39.697292632245, 47.6891197143717, 0.28144224999999995, 230.0, 752, 798774, 1106, 26.81288610000047
1107, 4.394971240638904, 39.77271120242707, 47.74846603747694, 0.28065789999999996, 355.0, 991, 799765, 1107, 35.78272790000119
1108, 4.749938005095353, 39.54368160057627, 47.47544431826236, 0.2799050499999999, 120.0, 682, 800447, 1108, 24.443741600000067
1109, 4.9012449184384375, 39.41042561111055, 47.33706980492784, 0.2791639, 220.0, 965, 801412, 1109, 34.557162700000845
1110, 6.237212952297455, 39.440208299933076, 47.477653160407044, 0.27856449999999994, 45.0, 367, 801779, 1110, 13.100190099999963
1111, 4.343646949582317, 39.577245243168015, 47.53359978048018, 0.27809379999999995, 150.0, 679, 802458, 1111, 25.25493859999915
1112, 5.575571651564785, 39.459095679909176, 47.40720337007675, 0.2775682, 55.0, 489, 802947, 1112, 18.090751499999897
1113, 7.179977568576775, 39.48221112105806, 47.50020105151807, 0.2769233499999999, 265.0, 944, 803891, 1113, 34.70446439999978
1114, 6.586757190733317, 39.40832192470353, 47.36954511969213, 0.2759337999999999, 140.0, 1255, 805146, 1114, 45.136903799999345
1115, 4.241491932053208, 39.550239059569755, 47.49429634623696, 0.2749735, 305.0, 879, 806025, 1115, 31.900361500000145
1116, 7.756039888563924, 39.51652392766842, 47.53237356646843, 0.2740248999999999, 290.0, 1229, 807254, 1116, 42.81359920000068
1117, 4.200033392547404, 39.339019367995775, 47.1958731716119, 0.27324009999999993, 65.0, 515, 807769, 1117, 17.86978260000069
1118, 2.8444652736062026, 39.55955038730453, 47.531196146391224, 0.2727937, 60.0, 477, 808246, 1118, 16.651424899999256
1119, 5.964679977613119, 39.61783502507507, 47.60212406380048, 0.27214524999999995, 505.0, 964, 809210, 1119, 33.80097869999918
1120, 7.381472586439206, 39.65332071264307, 47.70518112849523, 0.27145404999999984, 55.0, 572, 809782, 1120, 20.253791699999056
1121, 5.8849135113759035, 38.982851623600155, 46.86801084085775, 0.27077409999999996, 225.0, 939, 810721, 1121, 32.83459760000005
1122, 5.639321409155108, 38.93071906459968, 46.7857163884767, 0.2700396999999998, 150.0, 693, 811414, 1122, 24.67520930000137
1123, 7.278959405933823, 38.856515872950744, 46.69547389420856, 0.26935299999999995, 165.0, 833, 812247, 1123, 29.64532980000149
1124, 6.365317259205782, 38.84806412635965, 46.68102141847002, 0.2685551499999999, 220.0, 940, 813187, 1124, 32.95526459999928
1125, 6.377946078295335, 38.82967706939067, 46.67576807164332, 0.2676313, 350.0, 1113, 814300, 1125, 39.10431670000071
1126, 4.840447594794024, 38.9292308645633, 46.794776214315576, 0.2666952999999998, 270.0, 967, 815267, 1126, 34.073146599999745
1127, 8.302814458490758, 38.8409600584107, 46.78750969655288, 0.2657799999999998, 330.0, 1067, 816334, 1127, 39.9678101999998
1128, 5.140490752393891, 38.86192270383593, 46.67208618613953, 0.2647503999999999, 400.0, 1221, 817555, 1128, 43.63656649999939
1129, 5.688018842009289, 38.8270320255302, 46.660799135159415, 0.2639719, 50.0, 509, 818064, 1129, 17.967539599998418
1130, 4.910497745807927, 38.8127359474821, 46.6034536377354, 0.26346879999999995, 80.0, 609, 818673, 1130, 21.641214700001
1131, 6.683846377436508, 38.918780551176965, 46.788818912526594, 0.2627758, 195.0, 931, 819604, 1131, 43.13974469999994
1132, 4.750913177920782, 38.59901690923444, 46.35353898289126, 0.2618451999999999, 340.0, 1137, 820741, 1132, 43.61840889999985
1133, 3.874679864188478, 38.40316300483266, 46.096606825567356, 0.2610509499999999, 90.0, 628, 821369, 1133, 24.49040319999949
1134, 5.990471040435264, 38.46349545513255, 46.220816481993, 0.2604816999999999, 170.0, 637, 822006, 1134, 24.355226500001663
1135, 5.272240905439074, 38.342885923111574, 46.08928434602146, 0.25956865000000007, 460.0, 1392, 823398, 1135, 54.80896650000068
1136, 7.868751771459284, 38.48773333330179, 46.259349458285385, 0.2587681, 45.0, 387, 823785, 1136, 15.220299499998873
1137, 7.103801524080336, 38.508869000843596, 46.30666174888611, 0.25834194999999993, 105.0, 560, 824345, 1137, 21.55596180000066
1138, 4.962624149118176, 38.38165152144289, 46.10636244848103, 0.2574887499999997, 460.0, 1336, 825681, 1138, 51.242201600000044
1139, 9.190313015278015, 38.4579098171658, 46.24525019857619, 0.25656355000000003, 195.0, 720, 826401, 1139, 30.802843100000246
1140, 5.639140208312075, 38.33676290953147, 46.057192795568234, 0.25580169999999997, 350.0, 973, 827374, 1140, 39.0880259000005
1141, 7.488274608297429, 38.411991308231165, 46.22265258637985, 0.2550457000000001, 205.0, 707, 828081, 1141, 28.401274899999407
1142, 6.281267887628671, 38.44792897199626, 46.200035316160665, 0.25434685, 175.0, 846, 828927, 1142, 34.24853559999974
1143, 9.00562034924825, 38.58911595662435, 46.4411055573963, 0.25372989999999995, 40.0, 525, 829452, 1143, 22.502099900000758
1144, 4.9278833058251195, 38.37731237189714, 46.07496617561163, 0.25318404999999977, 140.0, 688, 830140, 1144, 31.70512249999956
1145, 6.408289389523725, 38.42938831481595, 46.20090797999482, 0.2524685499999999, 75.0, 902, 831042, 1145, 39.94583099999909
1146, 5.193184440591616, 38.46442500554704, 46.2632303803771, 0.25144075000000016, 215.0, 1382, 832424, 1146, 56.12483810000049
1147, 6.764451532197514, 38.55537012286652, 46.34455408727316, 0.2503400499999998, 320.0, 1064, 833488, 1147, 49.24802940000154
1148, 7.267715905369683, 38.48979566623638, 46.21474747843557, 0.24958404999999997, 150.0, 616, 834104, 1148, 30.025738700000147
1149, 4.827857919076973, 38.49668642815123, 46.220530733149104, 0.24913764999999996, 65.0, 376, 834480, 1149, 16.336942899999485
1150, 5.385031235524483, 38.44524628116238, 46.26228641694592, 0.24874524999999995, 75.0, 496, 834976, 1150, 21.77308020000055
1151, 4.927823099046946, 38.46583219051361, 46.20329419136047, 0.2483420499999999, 45.0, 400, 835376, 1151, 19.39903350000168
1152, 5.062920961697298, 38.52281271408257, 46.29720118871508, 0.24765399999999985, 285.0, 1129, 836505, 1152, 47.9623773000003
1153, 6.464569136086776, 38.54945177195024, 46.377942358523, 0.24659470000000006, 595.0, 1225, 837730, 1153, 50.99473829999988
1154, 5.405245108067059, 38.487964190497976, 46.228545245002294, 0.2456685999999999, 155.0, 833, 838563, 1154, 33.916962900000726
1155, 4.1250897456407545, 38.53282716369629, 46.21038545227051, 0.24506874999999997, 10.0, 500, 839063, 1155, 20.447379799999908
1156, 6.927565493925805, 38.54821412124976, 46.401087713883065, 0.24464304999999992, 40.0, 446, 839509, 1156, 17.985529400000814
1157, 4.313091817393061, 38.44976937862846, 46.19147440564409, 0.24403419999999995, 155.0, 907, 840416, 1157, 34.99600890000147
1158, 8.879116632366852, 38.84544656596658, 46.8000427427746, 0.24341814999999992, 75.0, 462, 840878, 1158, 16.831288000001223
1159, 3.170999854244659, 38.72841407279291, 46.48518680068398, 0.24298209999999998, 110.0, 507, 841385, 1159, 18.41037150000011
1160, 6.578370925853543, 38.70320083078091, 46.506903135648336, 0.24225175000000002, 470.0, 1116, 842501, 1160, 40.35830639999949
1161, 5.382225269412661, 38.59100732603273, 46.361932327697325, 0.24149214999999996, 165.0, 572, 843073, 1161, 20.738456099999894
1162, 8.418982724348703, 38.76826221622222, 46.70886142351474, 0.24108084999999993, 40.0, 342, 843415, 1162, 12.583464100000128
1163, 6.133172344290591, 38.687003534490415, 46.54352525983538, 0.2407537, 50.0, 385, 843800, 1163, 14.025624400001107
1164, 11.46985767814517, 38.68384748077393, 46.63587367248535, 0.24035544999999997, 50.0, 500, 844300, 1164, 18.47324859999935
1165, 3.9004249468026027, 38.738522338867185, 46.49443833257111, 0.23981094999999994, 195.0, 710, 845010, 1165, 30.091867699999057
1166, 7.355376023846072, 38.629553718833655, 46.473967470822636, 0.23916969999999985, 150.0, 715, 845725, 1166, 28.10037790000024
1167, 4.902755767533434, 38.669402287760676, 46.439782626299106, 0.23856489999999989, 110.0, 629, 846354, 1167, 23.534732599999188
1168, 6.044160096656948, 38.723257756097496, 46.533532079302155, 0.2378075499999999, 205.0, 1054, 847408, 1168, 39.18870930000048
1169, 6.1543119942381415, 38.74660305606687, 46.5660346908628, 0.2367478, 625.0, 1301, 848709, 1169, 48.097464200000104
1170, 4.490422729679004, 38.79743736588166, 46.566902107131746, 0.23593779999999992, 60.0, 499, 849208, 1170, 18.558108700000957
1171, 7.123168165106135, 38.590454569551135, 46.43237269293402, 0.23549499999999995, 115.0, 485, 849693, 1171, 18.12352110000029
1172, 5.589832827448845, 39.23346124241008, 47.16644297073137, 0.23491494999999982, 185.0, 804, 850497, 1172, 29.77092839999932
1173, 4.558585819374638, 39.424551909236236, 47.42131642229875, 0.23438799999999999, 80.0, 367, 850864, 1173, 13.88157080000019
1174, 7.180787853042599, 39.674059751005515, 47.64555274450732, 0.23399514999999996, 100.0, 506, 851370, 1174, 20.4346074999994
1175, 7.660175316349551, 39.651149579907724, 47.67597545986428, 0.23339349999999995, 185.0, 831, 852201, 1175, 31.684245100001135
1176, 5.978305774130591, 39.6508614812465, 47.65840201651822, 0.23247910000000002, 395.0, 1201, 853402, 1176, 44.82696650000071
1177, 2.8197114872244686, 39.575602465409496, 47.44993874476506, 0.23170464999999998, 105.0, 520, 853922, 1177, 19.712786799998867
1178, 4.9926955823027175, 39.527802417461686, 47.483878966111405, 0.23117815, 125.0, 650, 854572, 1178, 24.457215300000826
1179, 6.078413183049809, 39.55634525514418, 47.55363386677158, 0.23066244999999988, 135.0, 496, 855068, 1179, 18.646488999998837
1180, 2.8946708392305256, 39.605468103814516, 47.531382838846746, 0.22997169999999995, 340.0, 1039, 856107, 1180, 38.74346120000337
1181, 6.558621410107905, 39.6148655239178, 47.658618947790494, 0.22917385, 240.0, 734, 856841, 1181, 30.385440499998367
1182, 3.400794531865295, 39.672502942905304, 47.618727416749216, 0.22856094999999982, 195.0, 628, 857469, 1182, 27.134083400000236
1183, 6.579259919905171, 39.66040193509475, 47.70278819834058, 0.22779819999999995, 280.0, 1067, 858536, 1183, 46.38481089999914
1184, 5.393804276732464, 39.57408582721859, 47.51367766782287, 0.22684509999999997, 530.0, 1051, 859587, 1184, 45.4914729000011
1185, 6.606392939136884, 39.67243133913369, 47.63808586317534, 0.22583169999999997, 310.0, 1201, 860788, 1185, 52.028136499997345
1186, 8.85588833861461, 39.88001495273381, 47.96762678602587, 0.22513509999999995, 60.0, 347, 861135, 1186, 15.164875599999505
1187, 6.44378303872196, 39.76137688627495, 47.789537305128924, 0.22465539999999995, 150.0, 719, 861854, 1187, 31.132881800000177
1188, 5.969042646649194, 39.717448524431994, 47.679986942959374, 0.22393359999999993, 215.0, 885, 862739, 1188, 38.15688700000101
1189, 7.585943870046841, 39.751102072852, 47.82331996645246, 0.22303134999999993, 120.0, 1120, 863859, 1189, 48.339467499998136
1190, 3.9271406229814474, 39.752286528306485, 47.715438713147805, 0.22224924999999984, 55.0, 618, 864477, 1190, 27.087754300002416
1191, 4.84188177605216, 39.77259238199754, 47.74959482568683, 0.22149594999999997, 450.0, 1056, 865533, 1191, 45.61562760000015
1192, 5.961296122938279, 39.804131279580844, 47.84894748820301, 0.22055455, 255.0, 1036, 866569, 1192, 44.8955547000005
1193, 6.148138434183936, 39.82520458213088, 47.87351185905072, 0.21967704999999993, 290.0, 914, 867483, 1193, 39.89196069999889
1194, 3.3311515459790826, 39.87668327851729, 47.860910719091244, 0.21910734999999992, 45.0, 352, 867835, 1194, 15.755034300000261
1195, 6.031805993327648, 39.70579091655922, 47.69653334025464, 0.21853585000000003, 200.0, 918, 868753, 1195, 40.048954000001686
1196, 5.0772175644499, 39.72145173749851, 47.73846119804757, 0.21771009999999996, 85.0, 917, 869670, 1196, 40.12625900000057
1197, 5.824394538633433, 39.88290573823338, 47.92801411481521, 0.21668229999999977, 265.0, 1367, 871037, 1197, 59.975438000001304
1198, 4.710434259573619, 39.810690820867364, 47.8361042693167, 0.21569590000000008, 225.0, 825, 871862, 1198, 36.16871269999683
1199, 4.6840820032664485, 39.75757784302281, 47.710636800565865, 0.2151145, 45.0, 467, 872329, 1199, 20.517411799999536
1200, 9.525308611882018, 39.77745781046279, 47.896134051870796, 0.21456594999999984, 425.0, 752, 873081, 1200, 33.324845999999525
1201, 3.7679589635367137, 39.773033352740796, 47.72846594967517, 0.21377934999999992, 345.0, 996, 874077, 1201, 43.36534230000325
1202, 4.574824316321679, 39.78963617608732, 47.73525457962004, 0.2131164999999999, 90.0, 477, 874554, 1202, 21.203686500000913
1203, 5.590418603708163, 39.84047239405628, 47.87829343772229, 0.21246444999999986, 475.0, 972, 875526, 1203, 42.775877399999445
1204, 5.630932845335494, 40.03997607897686, 48.145041568304904, 0.21169224999999994, 90.0, 744, 876270, 1204, 32.446810800000094
1205, 6.28314867998358, 39.88170745365569, 47.87201102334567, 0.21105954999999985, 200.0, 662, 876932, 1205, 29.000115700000606
1206, 7.4043661710691815, 39.823416898125096, 47.838154328496834, 0.21035124999999993, 350.0, 912, 877844, 1206, 40.129587500003254
1207, 5.62351828024889, 39.83448811905415, 47.8404622121247, 0.20949489999999998, 155.0, 991, 878835, 1207, 43.937111999999615
1208, 4.374865169033878, 39.7880737255146, 47.77044271140019, 0.20856384999999997, 300.0, 1078, 879913, 1208, 47.30755610000051
1209, 4.862204238361213, 39.657261833713015, 47.648213851793976, 0.2076710499999999, 285.0, 906, 880819, 1209, 40.44073809999827
1210, 5.765402227172298, 39.634246389008766, 47.63167124079011, 0.20697669999999996, 125.0, 637, 881456, 1210, 28.512048100001266
1211, 6.260978452226903, 39.71900044054088, 47.79270906353941, 0.2062355499999999, 445.0, 1010, 882466, 1211, 45.2951103000014
1212, 7.024193679052898, 39.63805728232392, 47.64231005320016, 0.20548314999999984, 345.0, 662, 883128, 1212, 29.389974400000938
1213, 4.769670218513803, 39.65822945460499, 47.59683859376748, 0.20499669999999998, 30.0, 419, 883547, 1213, 18.7087520999994
1214, 6.354508629752411, 39.52397056193764, 47.51116103254757, 0.20453229999999994, 55.0, 613, 884160, 1214, 27.354112299999542
1215, 4.018665978171627, 39.65590085744315, 47.61491950823669, 0.20346625000000007, 475.0, 1756, 885916, 1215, 78.02258410000286
1216, 9.329337153408044, 39.77399159377476, 47.94793650789081, 0.20248524999999992, 85.0, 424, 886340, 1216, 18.89639160000297
1217, 8.063056547473783, 39.73249472619237, 47.774513371634285, 0.20191599999999987, 90.0, 841, 887181, 1217, 37.73879319999833
1218, 4.615704615532733, 39.584273440615114, 47.5296714479123, 0.2012774499999999, 125.0, 578, 887759, 1218, 25.99627270000201
1219, 4.957871434270826, 39.657224791002406, 47.62618587091777, 0.20085939999999994, 65.0, 351, 888110, 1219, 15.70453500000076
1220, 4.254329694641961, 39.59060806074953, 47.55726349275876, 0.2004948999999999, 70.0, 459, 888569, 1220, 21.762447599998268
1221, 5.12153852827126, 39.672658884397116, 47.64520554901451, 0.19995354999999995, 165.0, 744, 889313, 1221, 33.526490000000194
1222, 3.351255009213854, 39.646863107378955, 47.56961486112831, 0.1994625999999999, 75.0, 347, 889660, 1222, 15.646816500000568
1223, 7.176609358960853, 39.41765783286336, 47.38769468172329, 0.19890639999999998, 195.0, 889, 890549, 1223, 40.385461300000316
1224, 4.621010311448957, 39.26224063850983, 47.13768888216967, 0.1981985499999999, 185.0, 684, 891233, 1224, 27.6752235999993
1225, 3.071407349002593, 39.1208127216228, 46.94239139556885, 0.19770534999999986, 35.0, 412, 891645, 1225, 16.086469699999725
1226, 5.914641031324382, 39.325684065194814, 47.26424919461203, 0.1969628499999999, 385.0, 1238, 892883, 1226, 48.39537960000234
1227, 5.094377064976258, 39.28365039520751, 47.13387689803736, 0.19612404999999994, 70.0, 626, 893509, 1227, 24.645874300000287
1228, 4.431509326996766, 39.1762354392705, 47.0391201259583, 0.19561374999999986, 75.0, 508, 894017, 1228, 20.03258519999872
1229, 4.137308296386633, 39.081174563472665, 46.89307248132048, 0.19504719999999998, 205.0, 751, 894768, 1229, 29.59632490000149
1230, 6.589231101289774, 39.315344365437824, 47.2854372269068, 0.1945337499999999, 15.0, 390, 895158, 1230, 15.632983299998159
1231, 6.119056818751514, 39.252121591325945, 47.23372440047675, 0.19418094999999988, 30.0, 394, 895552, 1231, 16.13944619999893
1232, 5.9530936546008135, 39.22222214614564, 47.138778588710686, 0.19368774999999994, 160.0, 702, 896254, 1232, 28.50251449999996
1233, 5.355147357879425, 39.2140043868738, 47.1188077435774, 0.19288224999999987, 285.0, 1088, 897342, 1233, 42.86096379999799
1234, 6.885361282014719, 39.35527159065329, 47.28537080108479, 0.1920578499999999, 110.0, 744, 898086, 1234, 29.374494600000617
1235, 4.192454649963701, 39.316744949312195, 47.17634536714536, 0.1914831999999999, 60.0, 533, 898619, 1235, 21.077645199999097
1236, 4.625675896601751, 39.27781507372856, 47.154048699140546, 0.19095535, 175.0, 640, 899259, 1236, 25.417359099999885
1237, 6.031161201892026, 39.258188412819074, 47.15120592158594, 0.19025154999999994, 105.0, 924, 900183, 1237, 37.195810500001244
1238, 9.083430127904222, 39.32476609925966, 47.31958740646775, 0.18941949999999988, 125.0, 925, 901108, 1238, 37.02453390000301
1239, 4.854033314569337, 39.23666780801128, 47.129738275953336, 0.18850284999999992, 190.0, 1112, 902220, 1239, 43.96842839999954
1240, 6.12240626782917, 39.08157182108876, 46.92411157590317, 0.18771174999999987, 110.0, 646, 902866, 1240, 27.702057099999365
1241, 3.636829466850239, 39.25982784402782, 47.11921602990766, 0.18704260000000003, 220.0, 841, 903707, 1241, 36.74009510000178
1242, 3.04233875283014, 39.19324362211138, 47.05656341124918, 0.1864233999999999, 65.0, 535, 904242, 1242, 22.33203539999886
1243, 4.058010362229818, 39.26786136722279, 47.15087697418, 0.18573129999999988, 140.0, 1003, 905245, 1243, 39.662995099999534
1244, 6.102318427541205, 39.259937730350174, 47.1578729924672, 0.18458784999999986, 495.0, 1538, 906783, 1244, 60.954165200000716
1245, 4.543656246120443, 39.31551748590534, 47.22288500535012, 0.18329859999999995, 395.0, 1327, 908110, 1245, 52.55880469999829
1246, 5.404693307363325, 39.20500484042697, 47.10059908972846, 0.18229644999999983, 230.0, 900, 909010, 1246, 38.09906029999911
1247, 5.88573693247896, 39.15452389626152, 47.06065304900818, 0.18139599999999992, 240.0, 1101, 910111, 1247, 49.88978119999956
1248, 4.2580695615088855, 39.45728552602503, 47.35419452973526, 0.18071559999999992, 110.0, 411, 910522, 1248, 18.621560399998998
1249, 4.1431690019192, 39.47490250540642, 47.36888558735219, 0.18018234999999985, 230.0, 774, 911296, 1249, 35.055306199999904
1250, 5.397913333209005, 39.496609551272684, 47.4804231050325, 0.17941599999999994, 215.0, 929, 912225, 1250, 42.11936539999806
1251, 4.5684454011242215, 39.451540510750675, 47.375386558840624, 0.17859655000000002, 215.0, 892, 913117, 1251, 40.54745489999914
1252, 3.880894122558219, 39.43844645293207, 47.339573235279055, 0.17776179999999997, 355.0, 963, 914080, 1252, 43.81135129999893
1253, 4.9290432326687785, 39.503667341376214, 47.45824280440978, 0.17685729999999994, 265.0, 1047, 915127, 1253, 47.46646429999964
1254, 5.030308741563365, 39.507942466118074, 47.44273777239719, 0.17594154999999984, 880.0, 988, 916115, 1254, 44.0410770999988
1255, 6.26181358255994, 39.52378807295388, 47.51142740344432, 0.17504425, 245.0, 1006, 917121, 1255, 41.3492731999977
1256, 5.648214590837474, 39.47858379122135, 47.42539192648495, 0.17400249999999992, 215.0, 1309, 918430, 1256, 53.75582139999824
1257, 3.9567214662751646, 39.3892781929443, 47.322080406944245, 0.17309979999999991, 105.0, 697, 919127, 1257, 28.53082699999868
1258, 5.269534972008104, 39.50280660889747, 47.43644312719942, 0.1724796999999999, 95.0, 681, 919808, 1258, 27.83727369999906
1259, 4.128864094184051, 39.39319666916195, 47.32663936411772, 0.17187759999999996, 135.0, 657, 920465, 1259, 26.824207400000887
1260, 5.3789317741741955, 39.227850911493995, 47.127147490679434, 0.17106849999999993, 535.0, 1141, 921606, 1260, 46.73422760000176
1261, 5.690889161014495, 39.36349334716797, 47.24258801158846, 0.17012079999999996, 245.0, 965, 922571, 1261, 39.85974390000047
1262, 6.17043893723272, 39.34623088686485, 47.30414229265348, 0.16940079999999996, 155.0, 635, 923206, 1262, 29.328577700001915
1263, 4.426037277682681, 39.2651366131772, 47.15392294317154, 0.1688711499999999, 135.0, 542, 923748, 1263, 25.882515899997088
1264, 5.253433190930471, 39.3793346686933, 47.304944356282554, 0.16805485, 545.0, 1272, 925020, 1264, 52.32757599999968
1265, 5.446453952336613, 39.30327495511806, 47.23559361191316, 0.16702029999999998, 430.0, 1027, 926047, 1265, 42.88104120000207
1266, 4.930684310646907, 39.235081311230246, 47.14824779284055, 0.1660653999999999, 155.0, 1095, 927142, 1266, 48.36520880000171
1267, 5.210940567139095, 39.17154008359065, 47.116343872376, 0.16530309999999998, 135.0, 599, 927741, 1267, 30.898696699998254
1268, 2.8220188742777608, 39.39236058415593, 47.290329758469404, 0.16488369999999994, 20.0, 333, 928074, 1268, 15.757307899999432
1269, 11.113330120537169, 39.34656882742812, 47.4494690194745, 0.16438149999999993, 50.0, 783, 928857, 1269, 33.78053500000169
1270, 4.9545051085642084, 39.345544484773775, 47.246998660463994, 0.1637406999999999, 155.0, 641, 929498, 1270, 26.91457570000057
1271, 6.86968188130308, 39.35223864360028, 47.3535588850458, 0.16315344999999998, 130.0, 664, 930162, 1271, 29.120262399999774
1272, 5.217928448955369, 39.75154940768926, 47.7394972859007, 0.16249824999999998, 180.0, 792, 930954, 1272, 33.719543899998826
1273, 6.989866111194953, 39.847080199476885, 47.86939239111503, 0.1617022, 240.0, 977, 931931, 1273, 41.53040229999897
1274, 7.601338702480535, 39.83002966230696, 47.90840478845545, 0.16096284999999994, 50.0, 666, 932597, 1274, 34.65751480000108
1275, 6.507453867164747, 39.73586510564712, 47.7459030709888, 0.1603557999999999, 40.0, 683, 933280, 1275, 28.75605120000182
1276, 3.1022014665617563, 39.629318076873496, 47.5531364155707, 0.15985584999999994, 35.0, 428, 933708, 1276, 19.642593900000065
1277, 4.523993082897214, 39.72875884596189, 47.75412727932787, 0.15934779999999998, 355.0, 701, 934409, 1277, 29.248443799999222
1278, 7.465160216241571, 39.73557438038651, 47.797286587342064, 0.15863319999999995, 225.0, 887, 935296, 1278, 37.1363640999989
1279, 5.31333167437464, 39.730954947471616, 47.69298372268677, 0.15787404999999993, 170.0, 800, 936096, 1279, 38.291086900000664
1280, 8.524692637698948, 39.823278572723154, 47.93222948127727, 0.15716034999999995, 395.0, 786, 936882, 1280, 37.88461330000064
1281, 5.483458942978592, 39.75887913758432, 47.776007454108296, 0.1561374999999999, 775.0, 1487, 938369, 1281, 71.39240549999886
1282, 7.586012879205496, 39.78839112585027, 47.79035671303261, 0.15519519999999995, 100.0, 607, 938976, 1282, 30.73027060000095
1283, 4.002991086548126, 39.7643267666852, 47.74762987913909, 0.15467904999999993, 105.0, 540, 939516, 1283, 25.802352799997607
1284, 5.486463774182027, 40.22925013108918, 48.34676106855661, 0.15376149999999994, 790.0, 1499, 941015, 1284, 62.11962780000249
1285, 5.713140778098762, 40.343175657126935, 48.478070269072894, 0.15278589999999995, 240.0, 669, 941684, 1285, 27.875680499997543
1286, 3.581076825272349, 40.42702356524968, 48.54742563290366, 0.1521027999999999, 265.0, 849, 942533, 1286, 35.26017989999673
1287, 6.5339019463829855, 40.33654904181534, 48.535972502686356, 0.15131259999999996, 215.0, 907, 943440, 1287, 37.782794300001115
1288, 5.0042501211061445, 40.45840084049064, 48.61323024857212, 0.15064884999999992, 60.0, 568, 944008, 1288, 23.753220800001145
1289, 5.211423073795216, 40.35061228458265, 48.46973203909017, 0.1500120999999999, 300.0, 847, 944855, 1289, 35.204001699999935
1290, 4.43046638080001, 40.29281027185186, 48.384424828271335, 0.1493298999999999, 105.0, 669, 945524, 1290, 27.791400499998417
1291, 6.297772564301965, 40.268299142211596, 48.394914553146954, 0.1486805499999999, 160.0, 774, 946298, 1291, 32.320167399997445
1292, 5.97297710429351, 40.42879401984751, 48.53179666700556, 0.14801994999999996, 170.0, 694, 946992, 1292, 28.85774980000133
1293, 3.6857986497698407, 40.380454133929625, 48.483649241129555, 0.14733639999999995, 90.0, 825, 947817, 1293, 37.83549679999851
1294, 6.995945994064529, 40.352527756386614, 48.561602649282904, 0.14654214999999987, 170.0, 940, 948757, 1294, 44.92140429999927
1295, 4.838179301820759, 40.33763812681888, 48.5082756107689, 0.1458032499999999, 160.0, 702, 949459, 1295, 33.35344619999887
1296, 3.1805507331753575, 40.345172946013555, 48.37903657838619, 0.1453262499999999, 75.0, 358, 949817, 1296, 18.393578100000013
1297, 4.577410680891128, 39.98380208403357, 48.049215782270565, 0.14480559999999995, 170.0, 799, 950616, 1297, 38.96703400000115
1298, 4.842256496136334, 39.83593597548837, 47.88334347441205, 0.1439438499999999, 325.0, 1116, 951732, 1298, 53.35370200000034
1299, 4.923317111255128, 39.84012743982218, 47.90965921595945, 0.14301684999999992, 180.0, 944, 952676, 1299, 45.30886580000151
1300, 6.824138783321591, 39.92362686340699, 48.04267117303455, 0.14236749999999998, 125.0, 499, 953175, 1300, 24.252587000002677
1301, 4.9298262394118035, 39.82742907350713, 47.901162546331236, 0.14174694999999998, 335.0, 880, 954055, 1301, 42.462085499999375
1302, 4.370037136981819, 39.89584724476795, 47.91046993095617, 0.14114709999999994, 45.0, 453, 954508, 1302, 21.88060620000033
1303, 2.8912183855211846, 39.887426394003406, 47.84093733187075, 0.14074884999999993, 70.0, 432, 954940, 1303, 21.052787000000535
1304, 4.101495099357788, 39.8434673067227, 47.84135192622451, 0.14002975, 170.0, 1166, 956106, 1304, 56.00245930000165
1305, 3.609043301352651, 39.87154829283774, 47.89384105528667, 0.13901364999999996, 230.0, 1092, 957198, 1305, 52.70263619999969
1306, 9.606978599981565, 39.881867005573056, 47.99283215282409, 0.13830084999999992, 45.0, 492, 957690, 1306, 23.673663500001567
1307, 7.790775965519912, 39.87877415435235, 47.96684554203274, 0.13765959999999997, 320.0, 933, 958623, 1307, 45.6041538999998
1308, 5.160706589082712, 39.89286913391846, 47.93236103920835, 0.1367523999999999, 170.0, 1083, 959706, 1308, 48.601796200000535
1309, 6.0498351575273945, 41.56402772078525, 49.987246345327975, 0.13587174999999996, 520.0, 874, 960580, 1309, 38.52835010000126
1310, 6.852337682651622, 42.33072729383196, 50.88877161298479, 0.1351634499999999, 140.0, 700, 961280, 1310, 31.909159999999247
1311, 4.508392139396344, 42.31308919234242, 50.82660141853732, 0.1344105999999999, 250.0, 973, 962253, 1311, 43.783149499999126
1312, 4.058802935879105, 42.30783679589679, 50.820667510883574, 0.13357179999999994, 490.0, 891, 963144, 1312, 39.796275500000775
1313, 9.058732499361193, 42.34882139101352, 50.95119988264676, 0.1328261499999999, 240.0, 766, 963910, 1313, 34.867733499999304
1314, 4.492704810166898, 42.374663616623444, 50.899393675628694, 0.13204359999999996, 280.0, 973, 964883, 1314, 43.43885450000016
1315, 4.39854173834452, 42.30527613037511, 50.81028723716736, 0.13119534999999996, 235.0, 912, 965795, 1315, 41.79138860000239
1316, 6.243390803830435, 42.34909488656427, 50.917284297404315, 0.13046634999999995, 250.0, 708, 966503, 1316, 33.80529910000041
1317, 7.251002629668862, 42.350389583181475, 50.9789698754655, 0.12973779999999993, 295.0, 911, 967414, 1317, 45.98739829999977
1318, 7.446426460921595, 42.30737721378153, 50.854071178219534, 0.12901104999999993, 180.0, 704, 968118, 1318, 32.5862793999986
1319, 4.870593808711321, 42.280597553696744, 50.78334085672614, 0.1281911499999999, 530.0, 1118, 969236, 1319, 50.95830319999732
1320, 3.0609358882041353, 42.24737739562988, 50.6912198919999, 0.12751704999999994, 105.0, 380, 969616, 1320, 17.73569950000092
1321, 5.750553598967495, 42.69386181324639, 51.30410437103188, 0.12701574999999996, 150.0, 734, 970350, 1321, 40.4892734999994
1322, 7.292737945133318, 43.05426762279472, 51.77881640691237, 0.12583539999999996, 695.0, 1889, 972239, 1322, 92.73892499999783
1323, 7.749005138168506, 43.10809667905172, 51.95932350736676, 0.12474774999999994, 40.0, 528, 972767, 1323, 25.0644386999993
1324, 6.38964146035374, 43.05343038585691, 51.722273965758525, 0.12396429999999993, 425.0, 1213, 973980, 1324, 53.92435620000106
1325, 4.962136881244157, 43.121734569491636, 51.8125999185889, 0.12300354999999995, 240.0, 922, 974902, 1325, 40.77991469999688
1326, 4.948138462765248, 43.009527243611544, 51.66905745114014, 0.12210399999999991, 360.0, 1077, 975979, 1326, 50.56459259999974
1327, 4.572200393575487, 43.08996398703566, 51.81639820395164, 0.1214339499999999, 75.0, 412, 976391, 1327, 19.919173899997986
1328, 3.364357926967469, 43.0443565141071, 51.695583554831416, 0.12093174999999992, 70.0, 704, 977095, 1328, 32.68985039999825
1329, 6.13174994496223, 43.09700388031329, 51.75392854944596, 0.12018924999999996, 190.0, 946, 978041, 1329, 43.31061159999808
1330, 6.737905530138614, 43.12556948256886, 51.79873042233543, 0.11940849999999996, 195.0, 789, 978830, 1330, 35.63743059999979
1331, 6.5112833177301965, 43.065486083834536, 51.75679053573484, 0.11877849999999993, 145.0, 611, 979441, 1331, 33.94244569999864
1332, 6.000330846884057, 43.08247740655883, 51.79165533668974, 0.11829294999999994, 30.0, 468, 979909, 1332, 22.67481670000052
1333, 7.003537350670785, 43.10818582100804, 51.844663295417625, 0.11761164999999991, 290.0, 1046, 980955, 1333, 48.888175899999624
1334, 6.431455285401102, 43.05947667018623, 51.76743963772071, 0.11692899999999994, 25.0, 471, 981426, 1334, 22.378935500000807
1335, 4.479718380654701, 43.03639957751057, 51.6603652491714, 0.1161379, 420.0, 1287, 982713, 1335, 58.634313999998994
1336, 7.585017575378385, 43.08164370748917, 51.79153105005909, 0.11530179999999993, 75.0, 571, 983284, 1336, 26.4566691
1337, 7.7010389293565495, 43.08073667709332, 51.846701389094896, 0.11467449999999994, 195.0, 823, 984107, 1337, 37.762802099998225
1338, 4.329836683463206, 43.06174592549822, 51.73857980238653, 0.11404989999999994, 125.0, 565, 984672, 1338, 27.247139200000674
1339, 5.062714314032122, 42.982742975993325, 51.60771419341306, 0.11349684999999994, 105.0, 664, 985336, 1339, 30.212338799999998
1340, 5.479470927419449, 43.1356379482178, 51.86558420774716, 0.11276559999999991, 400.0, 961, 986297, 1340, 42.991142499999114
1341, 5.175090889575308, 43.1112780713831, 51.806985748987564, 0.1120176999999999, 45.0, 701, 986998, 1341, 31.407844000001205
1342, 5.054246651643901, 43.021298242472916, 51.65706296687504, 0.11107674999999996, 245.0, 1390, 988388, 1342, 61.29041219999999
1343, 6.644567699655474, 43.09582478126715, 51.78028487550289, 0.10988739999999994, 340.0, 1253, 989641, 1343, 55.19662160000007
1344, 5.907750945366575, 43.65614345221816, 52.432840255553835, 0.10887444999999996, 295.0, 998, 990639, 1344, 44.10968639999919
1345, 8.30854206568359, 43.958441630022634, 52.87808851566766, 0.10802619999999999, 205.0, 887, 991526, 1345, 40.16092199999912
1346, 5.431638669588349, 44.08391144492409, 52.97713763150302, 0.10737954999999995, 40.0, 550, 992076, 1346, 24.353482700000313
1347, 3.2408259730853466, 43.96686439612731, 52.78939057382194, 0.10695789999999998, 50.0, 387, 992463, 1347, 22.010310199999367
1348, 4.0657951960656185, 44.089254558301576, 52.9525730670144, 0.10653444999999996, 105.0, 554, 993017, 1348, 31.49546410000039
1349, 3.2537510643402734, 44.02729253842849, 52.857217229798785, 0.10599489999999993, 160.0, 645, 993662, 1349, 37.806224299998576
1350, 4.648664721008894, 43.9798747129698, 52.826635160703916, 0.10528839999999998, 110.0, 925, 994587, 1350, 48.466211699997075
1351, 6.434509871276748, 44.02855887832504, 52.997109918234806, 0.10462149999999992, 145.0, 557, 995144, 1351, 28.275281899997935
1352, 6.750363255578195, 44.044270454876795, 53.01840796448043, 0.10389609999999995, 255.0, 1055, 996199, 1352, 53.17133699999977
1353, 7.35260874096967, 43.98898889974583, 52.84457824566613, 0.10312794999999993, 85.0, 652, 996851, 1353, 33.09421250000014
1354, 5.308694853598879, 44.0036502612043, 52.86399177945727, 0.10247769999999995, 355.0, 793, 997644, 1354, 36.95306100000016
1355, 3.909864538662796, 43.99567109602916, 52.84480631864523, 0.10176534999999998, 230.0, 790, 998434, 1355, 35.806793200001266
1356, 4.117023245166134, 44.02159886919586, 52.88806530084024, 0.10108764999999993, 175.0, 716, 999150, 1356, 32.507981599999766
1357, 5.072041948948158, 44.07652873359889, 52.96934349093086, 0.10045359999999992, 135.0, 693, 999843, 1357, 35.26310960000046
