,loss,mae,mean_q,mean_eps,episode_reward,nb_episode_steps,nb_steps,episode,duration
0,0,0,0,0,65.0,504,504,0,1.0270811999999996
1, 0, 0, 0, 0, 35.0, 376, 880, 1, 0.7690089000000011
2, 0, 0, 0, 0, 95.0, 730, 1610, 2, 1.4291491
3, 0, 0, 0, 0, 380.0, 710, 2320, 3, 1.6148490000000013
4, 0, 0, 0, 0, 80.0, 613, 2933, 4, 1.4578118
5, 0, 0, 0, 0, 210.0, 729, 3662, 5, 1.6269946000000015
6, 0, 0, 0, 0, 45.0, 409, 4071, 6, 0.8093441000000006
7, 0, 0, 0, 0, 240.0, 919, 4990, 7, 1.8117005000000006
8, 0, 0, 0, 0, 65.0, 507, 5497, 8, 1.0499296999999999
9, 0, 0, 0, 0, 105.0, 502, 5999, 9, 1.0573845000000013
10, 0, 0, 0, 0, 105.0, 636, 6635, 10, 1.3177104000000028
11, 0, 0, 0, 0, 160.0, 816, 7451, 11, 1.8031365999999984
12, 0, 0, 0, 0, 35.0, 529, 7980, 12, 1.1730313999999993
13, 0, 0, 0, 0, 45.0, 399, 8379, 13, 0.8536713999999996
14, 0, 0, 0, 0, 80.0, 759, 9138, 14, 1.6561568999999992
15, 0, 0, 0, 0, 335.0, 810, 9948, 15, 1.7490251000000008
16, 0, 0, 0, 0, 55.0, 384, 10332, 16, 0.7720570000000002
17, 0, 0, 0, 0, 285.0, 990, 11322, 17, 1.9140168000000024
18, 0, 0, 0, 0, 110.0, 470, 11792, 18, 1.0720719000000045
19, 0, 0, 0, 0, 45.0, 615, 12407, 19, 1.2597358000000014
20, 0, 0, 0, 0, 75.0, 637, 13044, 20, 1.3841014999999999
21, 0, 0, 0, 0, 240.0, 948, 13992, 21, 2.017197799999998
22, 0, 0, 0, 0, 215.0, 938, 14930, 22, 1.896167400000003
23, 0, 0, 0, 0, 65.0, 450, 15380, 23, 0.9133642999999978
24, 0, 0, 0, 0, 105.0, 693, 16073, 24, 1.4729316999999966
25, 0, 0, 0, 0, 120.0, 588, 16661, 25, 1.2319387000000006
26, 0, 0, 0, 0, 160.0, 711, 17372, 26, 1.522137100000002
27, 0, 0, 0, 0, 45.0, 590, 17962, 27, 1.2536189999999934
28, 0, 0, 0, 0, 120.0, 691, 18653, 28, 1.625056899999997
29, 0, 0, 0, 0, 125.0, 772, 19425, 29, 1.807862
30, 0, 0, 0, 0, 90.0, 558, 19983, 30, 1.1419657
31, 0, 0, 0, 0, 105.0, 566, 20549, 31, 1.131690600000006
32, 0, 0, 0, 0, 210.0, 562, 21111, 32, 1.126509800000001
33, 0, 0, 0, 0, 160.0, 713, 21824, 33, 1.5919904000000002
34, 0, 0, 0, 0, 105.0, 483, 22307, 34, 1.0985786999999974
35, 0, 0, 0, 0, 210.0, 732, 23039, 35, 1.596006299999999
36, 0, 0, 0, 0, 35.0, 411, 23450, 36, 0.9171733000000017
37, 0, 0, 0, 0, 160.0, 723, 24173, 37, 1.4461915999999988
38, 0, 0, 0, 0, 135.0, 800, 24973, 38, 1.5520071999999985
39, 0, 0, 0, 0, 110.0, 742, 25715, 39, 1.4232169
40, 0, 0, 0, 0, 355.0, 868, 26583, 40, 1.7061135000000078
41, 0, 0, 0, 0, 30.0, 548, 27131, 41, 1.0908517000000018
42, 0, 0, 0, 0, 145.0, 630, 27761, 42, 1.248611000000011
43, 0, 0, 0, 0, 90.0, 394, 28155, 43, 0.7841724000000028
44, 0, 0, 0, 0, 80.0, 552, 28707, 44, 1.0720660000000066
45, 0, 0, 0, 0, 210.0, 851, 29558, 45, 1.6535034999999993
46, 0, 0, 0, 0, 105.0, 498, 30056, 46, 1.0365666999999945
47, 0, 0, 0, 0, 80.0, 476, 30532, 47, 0.9398856000000109
48, 0, 0, 0, 0, 245.0, 980, 31512, 48, 1.951963500000005
49, 0, 0, 0, 0, 125.0, 491, 32003, 49, 1.0939381000000026
50, 0, 0, 0, 0, 380.0, 786, 32789, 50, 1.5136325
51, 0, 0, 0, 0, 210.0, 787, 33576, 51, 1.6314087000000086
52, 0, 0, 0, 0, 165.0, 688, 34264, 52, 1.463046900000009
53, 0, 0, 0, 0, 210.0, 792, 35056, 53, 1.5777830999999907
54, 0, 0, 0, 0, 35.0, 577, 35633, 54, 1.123398800000004
55, 0, 0, 0, 0, 210.0, 784, 36417, 55, 1.6699475000000064
56, 0, 0, 0, 0, 75.0, 530, 36947, 56, 1.1168220999999932
57, 0, 0, 0, 0, 210.0, 593, 37540, 57, 1.2155746999999906
58, 0, 0, 0, 0, 280.0, 795, 38335, 58, 1.766477199999997
59, 0, 0, 0, 0, 330.0, 1115, 39450, 59, 2.211088899999993
60, 0, 0, 0, 0, 65.0, 493, 39943, 60, 1.0406621999999999
61, 0, 0, 0, 0, 165.0, 759, 40702, 61, 1.5661725000000075
62, 0, 0, 0, 0, 105.0, 496, 41198, 62, 1.0188301000000024
63, 0, 0, 0, 0, 90.0, 655, 41853, 63, 1.4359050999999994
64, 0, 0, 0, 0, 40.0, 495, 42348, 64, 1.063149100000004
65, 0, 0, 0, 0, 100.0, 568, 42916, 65, 1.1762953000000067
66, 0, 0, 0, 0, 100.0, 623, 43539, 66, 1.2765416999999957
67, 0, 0, 0, 0, 75.0, 516, 44055, 67, 1.0652424000000025
68, 0, 0, 0, 0, 65.0, 813, 44868, 68, 1.5938830000000053
69, 0, 0, 0, 0, 95.0, 736, 45604, 69, 1.4098044999999928
70, 0, 0, 0, 0, 45.0, 621, 46225, 70, 1.2344359000000082
71, 0, 0, 0, 0, 90.0, 553, 46778, 71, 1.1087554000000068
72, 0, 0, 0, 0, 210.0, 1307, 48085, 72, 2.525287800000001
73, 0, 0, 0, 0, 65.0, 615, 48700, 73, 1.274261800000005
74, 0, 0, 0, 0, 210.0, 825, 49525, 74, 1.6596767999999997
75, 0, 0, 0, 0, 120.0, 716, 50241, 75, 1.4124130000000008
76, 0, 0, 0, 0, 65.0, 626, 50867, 76, 1.2189407999999986
77, 0, 0, 0, 0, 20.0, 476, 51343, 77, 0.9308769000000012
78, 0, 0, 0, 0, 165.0, 712, 52055, 78, 1.4398981999999876
79, 0, 0, 0, 0, 155.0, 770, 52825, 79, 1.5418255999999957
80, 0, 0, 0, 0, 120.0, 597, 53422, 80, 1.246420399999991
81, 0, 0, 0, 0, 210.0, 814, 54236, 81, 1.6603958000000034
82, 0, 0, 0, 0, 95.0, 582, 54818, 82, 1.1728061000000025
83, 0, 0, 0, 0, 5.0, 486, 55304, 83, 1.0188534999999916
84, 0, 0, 0, 0, 135.0, 719, 56023, 84, 1.4733826000000079
85, 0, 0, 0, 0, 35.0, 530, 56553, 85, 1.0664408000000094
86, 0, 0, 0, 0, 85.0, 598, 57151, 86, 1.2216705000000019
87, 0, 0, 0, 0, 210.0, 749, 57900, 87, 1.496114200000008
88, 0, 0, 0, 0, 135.0, 761, 58661, 88, 1.5242865000000165
89, 0, 0, 0, 0, 110.0, 673, 59334, 89, 1.2970344000000011
90, 0, 0, 0, 0, 575.0, 1082, 60416, 90, 2.175138099999998
91, 0, 0, 0, 0, 155.0, 774, 61190, 91, 1.526064099999985
92, 0, 0, 0, 0, 45.0, 609, 61799, 92, 1.1941909999999893
93, 0, 0, 0, 0, 155.0, 625, 62424, 93, 1.2571078
94, 0, 0, 0, 0, 80.0, 385, 62809, 94, 0.8012721000000056
95, 0, 0, 0, 0, 210.0, 814, 63623, 95, 1.6149600999999905
96, 0, 0, 0, 0, 85.0, 625, 64248, 96, 1.290418499999987
97, 0, 0, 0, 0, 180.0, 696, 64944, 97, 1.4134581999999796
98, 0, 0, 0, 0, 155.0, 621, 65565, 98, 1.2778552000000047
99, 0, 0, 0, 0, 90.0, 615, 66180, 99, 1.2129209999999944
100, 0, 0, 0, 0, 335.0, 1180, 67360, 100, 2.3032723999999973
101, 0, 0, 0, 0, 55.0, 442, 67802, 101, 0.887512600000008
102, 0, 0, 0, 0, 125.0, 519, 68321, 102, 1.0412371999999834
103, 0, 0, 0, 0, 105.0, 513, 68834, 103, 1.0729685000000018
104, 0, 0, 0, 0, 135.0, 765, 69599, 104, 1.532558100000017
105, 0, 0, 0, 0, 110.0, 480, 70079, 105, 1.0058621000000016
106, 0, 0, 0, 0, 140.0, 652, 70731, 106, 1.3289091000000042
107, 0, 0, 0, 0, 155.0, 682, 71413, 107, 1.3592211000000134
108, 0, 0, 0, 0, 55.0, 659, 72072, 108, 1.3403810000000078
109, 0, 0, 0, 0, 355.0, 795, 72867, 109, 1.557421799999986
110, 0, 0, 0, 0, 180.0, 783, 73650, 110, 1.5307603000000256
111, 0, 0, 0, 0, 430.0, 768, 74418, 111, 1.5501321999999789
112, 0, 0, 0, 0, 290.0, 1108, 75526, 112, 2.196206999999987
113, 0, 0, 0, 0, 215.0, 835, 76361, 113, 1.6835603999999762
114, 0, 0, 0, 0, 115.0, 792, 77153, 114, 1.627994799999982
115, 0, 0, 0, 0, 60.0, 750, 77903, 115, 1.4828768999999795
116, 0, 0, 0, 0, 60.0, 543, 78446, 116, 1.0939577999999983
117, 0, 0, 0, 0, 105.0, 491, 78937, 117, 0.977798799999988
118, 0, 0, 0, 0, 135.0, 629, 79566, 118, 1.2670889999999986
119, 0, 0, 0, 0, 180.0, 646, 80212, 119, 1.2713784000000032
120, 0, 0, 0, 0, 110.0, 545, 80757, 120, 1.0805686999999864
121, 0, 0, 0, 0, 245.0, 733, 81490, 121, 1.5048075999999924
122, 0, 0, 0, 0, 130.0, 804, 82294, 122, 1.5694386000000122
123, 0, 0, 0, 0, 105.0, 506, 82800, 123, 0.9998726999999974
124, 0, 0, 0, 0, 135.0, 515, 83315, 124, 1.0164318999999864
125, 0, 0, 0, 0, 160.0, 855, 84170, 125, 1.6941604000000154
126, 0, 0, 0, 0, 410.0, 771, 84941, 126, 1.5187516999999957
127, 0, 0, 0, 0, 115.0, 678, 85619, 127, 1.3334791999999993
128, 0, 0, 0, 0, 125.0, 620, 86239, 128, 1.272289900000004
129, 0, 0, 0, 0, 95.0, 507, 86746, 129, 1.038625699999983
130, 0, 0, 0, 0, 150.0, 802, 87548, 130, 1.5773868000000277
131, 0, 0, 0, 0, 135.0, 629, 88177, 131, 1.2405138999999963
132, 0, 0, 0, 0, 120.0, 514, 88691, 132, 1.0556085999999993
133, 0, 0, 0, 0, 135.0, 682, 89373, 133, 1.3961061999999913
134, 0, 0, 0, 0, 160.0, 885, 90258, 134, 1.7760340000000099
135, 0, 0, 0, 0, 185.0, 990, 91248, 135, 1.981057800000002
136, 0, 0, 0, 0, 180.0, 724, 91972, 136, 1.628349600000007
137, 0, 0, 0, 0, 100.0, 523, 92495, 137, 1.0780791999999906
138, 0, 0, 0, 0, 10.0, 542, 93037, 138, 1.141354299999989
139, 0, 0, 0, 0, 105.0, 602, 93639, 139, 1.2081321000000003
140, 0, 0, 0, 0, 65.0, 599, 94238, 140, 1.21043659999998
141, 0, 0, 0, 0, 135.0, 695, 94933, 141, 1.4237449000000026
142, 0, 0, 0, 0, 50.0, 368, 95301, 142, 0.7951016000000095
143, 0, 0, 0, 0, 135.0, 718, 96019, 143, 1.426735100000002
144, 0, 0, 0, 0, 105.0, 384, 96403, 144, 0.7607066000000202
145, 0, 0, 0, 0, 220.0, 1079, 97482, 145, 2.136368400000009
146, 0, 0, 0, 0, 50.0, 628, 98110, 146, 1.2451168999999993
147, 0, 0, 0, 0, 110.0, 776, 98886, 147, 1.5472343999999794
148, 0, 0, 0, 0, 110.0, 597, 99483, 148, 1.2027538000000106
149, 0, 0, 0, 0, 80.0, 406, 99889, 149, 0.8420321000000115
150, 24.944091142663634, 42.943368614583775, 53.812896945050376, 0.8192538999999998, 195.0, 940, 100829, 150, 7.706120299999981
151, 17.71535891489005, 42.86350673851109, 52.74057898740888, 0.8174331999999999, 210.0, 1195, 102024, 151, 10.526907600000015
152, 15.022193665271038, 42.7637847686981, 52.3153542027329, 0.8159716, 60.0, 429, 102453, 152, 3.953005300000001
153, 16.2667606940599, 42.86882183803775, 52.340380579475465, 0.8146999000000001, 195.0, 984, 103437, 153, 8.584162599999985
154, 15.059237344609866, 42.80941555095169, 52.18201044430523, 0.8130988000000002, 395.0, 795, 104232, 154, 6.960864399999991
155, 13.698521964446359, 42.82225749250772, 52.00881166319916, 0.8117622999999998, 110.0, 690, 104922, 155, 6.240202299999993
156, 16.933235855532658, 42.68560448108157, 51.883746436372704, 0.8105626, 85.0, 643, 105565, 156, 5.5575628999999935
157, 13.665104882689867, 42.748912859750675, 51.8664643167692, 0.8092756000000003, 180.0, 787, 106352, 157, 6.924240600000019
158, 18.46075968873011, 42.836887908308476, 52.01362960501893, 0.8079103000000002, 120.0, 730, 107082, 158, 6.495485200000019
159, 14.798453996517907, 42.78667043518191, 51.76887283637236, 0.8068132000000003, 35.0, 489, 107571, 159, 4.3306374000000005
160, 12.280349055926004, 42.699235184024076, 51.63569279551908, 0.8058384999999997, 95.0, 594, 108165, 160, 5.301575899999989
161, 15.707767155539646, 42.77514976841884, 51.79107682035351, 0.8049610000000003, 90.0, 381, 108546, 161, 3.3480246999999963
162, 13.48422443691099, 42.77088645106082, 51.683398139630455, 0.8036407, 220.0, 1086, 109632, 162, 9.622795999999994
163, 15.6142354189277, 42.82820933520947, 51.80679741984468, 0.8023132, 105.0, 389, 110021, 163, 3.501784100000009
164, 9.316370850166503, 45.418209475749954, 54.97369233357538, 0.8014392999999999, 30.0, 582, 110603, 164, 5.071277500000008
165, 11.051767293710887, 45.33003443960818, 54.9273774579445, 0.8003358999999998, 180.0, 644, 111247, 165, 5.7634808999999905
166, 11.573236922695212, 45.41075008862639, 55.024366949869, 0.7992964, 105.0, 511, 111758, 166, 4.5645489999999995
167, 7.614493469733977, 45.43601009670624, 55.056000892725365, 0.7981993000000003, 140.0, 708, 112466, 167, 6.415645300000051
168, 8.381773748818565, 45.30341110509985, 54.874463740517115, 0.7970725000000001, 45.0, 544, 113010, 168, 4.70110219999998
169, 8.327038438796997, 45.32637666015625, 54.80162239990234, 0.7960203999999997, 145.0, 625, 113635, 169, 5.483117499999992
170, 13.710817818840345, 45.366976369511, 55.0645821166761, 0.7949827, 90.0, 528, 114163, 170, 4.703838299999973
171, 7.251292202420478, 45.32720116385578, 54.85569219658845, 0.7938910000000001, 150.0, 685, 114848, 171, 6.137662799999987
172, 7.782825112169313, 45.35331649447112, 54.936819051550984, 0.7926562000000003, 100.0, 687, 115535, 172, 6.224306800000022
173, 7.859117218244886, 45.34904429185565, 54.797413588522595, 0.7913619999999996, 275.0, 751, 116286, 173, 6.750046099999963
174, 8.436583321846571, 45.3762840680628, 54.98218059667805, 0.7900156, 170.0, 745, 117031, 174, 7.196196499999985
175, 11.730665231269338, 45.39365074489427, 55.01726960223654, 0.7883100999999997, 215.0, 1150, 118181, 175, 10.20011969999996
176, 7.4023764166845325, 45.28461814260616, 54.761747803674695, 0.7869537999999998, 55.0, 357, 118538, 176, 3.014300100000014
177, 8.201366019202847, 45.37726103821391, 54.802953155635635, 0.7861671999999996, 15.0, 517, 119055, 177, 4.441643499999998
178, 7.890863706325662, 45.26588336462262, 54.689591120577404, 0.7853104000000001, 60.0, 435, 119490, 178, 3.8263495999999577
179, 10.509671092386077, 45.45082000867855, 55.05272453917554, 0.7843105, 85.0, 676, 120166, 179, 5.908077300000002
180, 8.418389959357926, 45.98275388925561, 55.53502409153075, 0.7833222999999997, 90.0, 422, 120588, 180, 3.6937300000000164
181, 9.336892481855253, 45.90037034724527, 55.40090995512301, 0.7819732000000005, 275.0, 1077, 121665, 181, 9.357129999999984
182, 7.940576605894715, 45.87042248767355, 55.305168584924964, 0.7802586999999995, 340.0, 828, 122493, 182, 7.2580829000000335
183, 8.00697532834377, 45.85162595689724, 55.34384605328811, 0.7783822, 290.0, 1257, 123750, 183, 11.039400300000011
184, 9.656377355333502, 45.92716180641233, 55.42192484586293, 0.7767793000000001, 50.0, 524, 124274, 184, 4.687451099999976
185, 7.145951753955776, 45.887950089018226, 55.30421673587679, 0.7755643000000003, 210.0, 826, 125100, 185, 7.278447200000016
186, 11.003987139608801, 45.91515747938699, 55.51036328571599, 0.7742674000000004, 185.0, 615, 125715, 186, 5.509145900000021
187, 10.15405833633507, 45.87793011758842, 55.453293496487184, 0.7729794999999999, 225.0, 816, 126531, 187, 7.279554800000028
188, 9.109487045288086, 45.8339257405599, 55.29712052408854, 0.7719075999999997, 60.0, 375, 126906, 188, 3.323835000000031
189, 11.292403895208853, 45.85358719425347, 55.4501591529555, 0.7710985000000001, 115.0, 524, 127430, 189, 4.6629917000000205
190, 8.163765487759065, 45.830496566137654, 55.26949322646131, 0.7700428000000002, 105.0, 649, 128079, 190, 5.774357399999985
191, 9.306041116349435, 45.833500860166, 55.32550739541253, 0.7681419999999999, 390.0, 1463, 129542, 191, 12.92714749999999
192, 9.08014688345175, 45.77598471868606, 55.14657436350666, 0.7661448999999996, 150.0, 756, 130298, 192, 6.790702199999998
193, 8.282150536432157, 45.74784625904508, 55.135046579163145, 0.7647615999999998, 210.0, 781, 131079, 193, 7.050403500000016
194, 7.886799546388479, 45.63898277282715, 54.93269807165796, 0.7637311, 30.0, 364, 131443, 194, 3.3861610000000155
195, 6.551237902233193, 45.66028034107105, 55.03119948790954, 0.762904, 75.0, 555, 131998, 195, 5.106458900000007
196, 7.493062881237485, 45.73231435983292, 55.19026063513879, 0.7615360000000001, 225.0, 965, 132963, 196, 8.750226299999952
197, 8.104752678802653, 45.68994994988873, 55.12044372237806, 0.7593832000000006, 395.0, 1427, 134390, 197, 12.775180599999942
198, 12.647195471011527, 45.68691342568333, 55.20702132558435, 0.7577668, 50.0, 369, 134759, 198, 3.349155499999938
199, 7.553053480400068, 45.58352737085398, 54.97094338265575, 0.7570324000000003, 55.0, 447, 135206, 199, 4.054690100000016
200, 8.259359490998248, 45.750239057743805, 55.157360634905224, 0.7562917, 50.0, 376, 135582, 200, 3.43532730000004
201, 7.247511724832261, 45.68045238268531, 55.07806448377507, 0.7553314, 140.0, 691, 136273, 201, 6.270135700000083
202, 5.779116709625101, 45.68817752220727, 55.05814945353249, 0.7540867000000001, 320.0, 692, 136965, 202, 6.2642104000000245
203, 7.808244790599041, 45.68621696257022, 55.12260043129745, 0.7526340999999998, 285.0, 922, 137887, 203, 8.417825899999912
204, 6.079225967901456, 45.65776413914643, 54.97411509342831, 0.7512120999999998, 85.0, 658, 138545, 204, 6.154677900000024
205, 6.736333766630673, 45.6959099750745, 55.11238309737094, 0.7499368, 210.0, 759, 139304, 205, 7.113223500000004
206, 6.605114927101036, 45.77729763260998, 55.18935296738718, 0.7483879000000004, 285.0, 962, 140266, 206, 8.676900600000067
207, 6.8145291267156205, 45.96466416385657, 55.455848800684315, 0.7469758, 155.0, 607, 140873, 207, 5.7985409000000345
208, 7.002115103272126, 46.046621062091944, 55.5914122001412, 0.7457311000000001, 170.0, 776, 141649, 208, 7.502425899999935
209, 7.38674492296129, 45.89570454362863, 55.376309282101765, 0.7444693, 160.0, 626, 142275, 209, 5.984618800000021
210, 6.873201155035453, 45.96131807381998, 55.44233760367545, 0.7430590000000007, 210.0, 941, 143216, 210, 8.887597300000039
211, 5.991027156377438, 46.00705553715188, 55.519127755377234, 0.7417468, 65.0, 517, 143733, 211, 4.9208443999999645
212, 8.211580973040808, 46.04768794076592, 55.57302358024193, 0.7407208000000002, 135.0, 623, 144356, 212, 5.944326199999978
213, 5.04965843785165, 46.00369669216782, 55.42276751959502, 0.7395570999999997, 125.0, 670, 145026, 213, 6.384705800000006
214, 6.785373089084546, 45.979961474902446, 55.54832533356541, 0.7385229999999999, 125.0, 479, 145505, 214, 4.582212199999958
215, 6.316364701256292, 46.006918163474545, 55.48852669427154, 0.7376995, 70.0, 436, 145941, 215, 4.205390700000066
216, 6.014027290974562, 45.97456796176898, 55.486545318993514, 0.7367436999999997, 85.0, 626, 146567, 216, 6.2852914000000055
217, 5.347047336758807, 46.062680954203415, 55.54853676849941, 0.7357509999999999, 80.0, 477, 147044, 217, 5.240046599999914
218, 4.9483937930511175, 46.050082650965464, 55.50253537880029, 0.7347556000000002, 155.0, 629, 147673, 218, 6.419347499999958
219, 5.89825673621106, 46.077157508121445, 55.58908085340864, 0.7329079, 495.0, 1424, 149097, 219, 14.270625399999972
220, 5.378488052629066, 46.01183662339606, 55.47187496402643, 0.7311681999999995, 80.0, 509, 149606, 220, 4.89816129999997
221, 5.180507102228225, 46.13588971424972, 55.63345225603747, 0.7301179, 155.0, 658, 150264, 221, 6.361931499999969
222, 7.382633489034019, 46.33637450406544, 55.96456304687691, 0.7289515000000001, 155.0, 638, 150902, 222, 6.975410899999929
223, 6.771488648886973, 46.337255035244155, 55.86841194621532, 0.7278499000000003, 60.0, 586, 151488, 223, 5.796386600000005
224, 5.08473411306091, 46.35144486911055, 55.91973360034003, 0.7267014999999999, 135.0, 690, 152178, 224, 6.754210700000044
225, 5.127016254208767, 46.34102729213432, 55.876122516550716, 0.7253632000000001, 410.0, 797, 152975, 225, 7.80478370000003
226, 4.561882413407209, 46.26130793675655, 55.746605973283785, 0.7237890999999993, 255.0, 952, 153927, 226, 9.412904300000037
227, 7.977120735558563, 46.29445080122343, 55.93154133657922, 0.7223509000000005, 120.0, 646, 154573, 227, 6.321948799999973
228, 5.3133532258275995, 46.33222822042612, 55.84955411690932, 0.7212078999999996, 145.0, 624, 155197, 228, 6.158510300000103
229, 6.411042885893027, 46.31477264282643, 55.87631420231083, 0.7198561, 170.0, 878, 156075, 229, 8.6423463000001
230, 5.000725261257453, 46.25157344991511, 55.75534332448786, 0.7186698999999998, 60.0, 440, 156515, 230, 4.347032799999965
231, 7.6315157104137485, 46.388394832611084, 56.055152855667416, 0.7179067, 80.0, 408, 156923, 231, 4.058458400000063
232, 5.639001680757079, 46.345457880851754, 55.84257658165526, 0.7166746, 245.0, 961, 157884, 232, 9.821556299999997
233, 3.718706684642947, 46.28028898305826, 55.745044094699246, 0.7152949000000003, 95.0, 572, 158456, 233, 6.636075900000037
234, 7.218975774135934, 46.39383525733488, 56.02100594646959, 0.7141824999999998, 185.0, 664, 159120, 234, 6.919693199999983
235, 6.655453645763918, 46.35295040607453, 55.983115541934964, 0.7130088999999997, 155.0, 640, 159760, 235, 6.303754200000071
236, 6.4876185003228075, 47.14840837413558, 56.861414251052175, 0.7120900000000002, 60.0, 381, 160141, 236, 3.829755900000009
237, 7.206654854934171, 48.96417419145692, 59.082102685604454, 0.7112701000000003, 115.0, 530, 160671, 237, 5.332410399999958
238, 6.29225130715136, 48.84610460806584, 58.89630965449384, 0.7102341999999997, 135.0, 621, 161292, 238, 6.314551000000051
239, 5.910426254213696, 48.95007350594378, 59.026905772933276, 0.7089724, 210.0, 781, 162073, 239, 8.016910800000005
240, 5.546858559122504, 48.86488996619206, 58.92275494151345, 0.7076340999999999, 200.0, 706, 162779, 240, 7.353531799999928
241, 5.506991332402392, 48.87893649590829, 58.93693986207866, 0.7063921, 65.0, 674, 163453, 241, 7.365001600000028
242, 7.248792151839747, 48.903869083161986, 59.082725695791964, 0.7051627000000001, 160.0, 692, 164145, 242, 7.254539099999988
243, 6.530650627479084, 48.86970777731764, 58.93063464344345, 0.7037992000000005, 180.0, 823, 164968, 243, 8.347150800000009
244, 6.170973293346688, 48.95089376725393, 59.01692114245382, 0.7026166, 105.0, 491, 165459, 244, 4.972029200000065
245, 8.933262127106179, 48.929494929425594, 59.20552920847432, 0.7017912999999997, 50.0, 426, 165885, 245, 4.3655392000000575
246, 8.645439737426337, 48.93230894218636, 59.15106640067152, 0.7009057, 65.0, 558, 166443, 246, 5.717695800000001
247, 3.6021062035191185, 48.96327985326449, 58.92581731081009, 0.7000579000000001, 35.0, 384, 166827, 247, 3.9345263999999815
248, 4.865973229858914, 48.9126420445198, 58.951889243729994, 0.6990444999999996, 80.0, 742, 167569, 248, 7.646844099999953
249, 8.80669755094024, 48.99929360996925, 59.1925378948963, 0.697906, 90.0, 523, 168092, 249, 5.3533350000000155
250, 6.289452940165273, 48.877979382812256, 58.9407345312327, 0.6965461, 525.0, 988, 169080, 250, 10.140754899999934
251, 3.6189555134155937, 48.75572778805426, 58.70703756142127, 0.6945472000000003, 260.0, 1233, 170313, 251, 12.87305420000007
252, 6.06860038520226, 48.35807207566273, 58.33997167514849, 0.6928687000000003, 90.0, 632, 170945, 252, 6.657769500000086
253, 4.4593443374695445, 48.35377178969428, 58.23306127924904, 0.6917257, 95.0, 638, 171583, 253, 6.583535900000015
254, 6.671901370377042, 48.37185310541197, 58.34795887969261, 0.6907645, 65.0, 430, 172013, 254, 4.524853499999949
255, 6.483350702738833, 48.40398770665366, 58.428498328678195, 0.6894703000000005, 305.0, 1008, 173021, 255, 10.384608299999968
256, 6.117320716183445, 48.41970137133206, 58.36861123203915, 0.6882238, 75.0, 377, 173398, 256, 3.9659158999999136
257, 8.595789995840471, 48.466285499072825, 58.47341506501548, 0.6872527, 210.0, 702, 174100, 257, 7.179671199999916
258, 5.00966690400218, 48.39042820494591, 58.291007377434305, 0.6859711000000001, 155.0, 722, 174822, 258, 7.506866800000012
259, 5.056718703403452, 48.34372819528072, 58.2223969239455, 0.6847128999999996, 65.0, 676, 175498, 259, 7.146838099999968
260, 4.729253424854761, 48.32596566703882, 58.202984075867725, 0.6834636999999998, 95.0, 712, 176210, 260, 7.729752500000018
261, 5.255421397997095, 48.32303940063785, 58.22672022776097, 0.6817554999999996, 360.0, 1186, 177396, 261, 12.224400599999967
262, 4.992051586613321, 48.36183474022045, 58.2434119442053, 0.6796621, 150.0, 1140, 178536, 262, 12.143370599999912
263, 6.435489416282377, 48.389490103678966, 58.31639754921464, 0.6781329999999999, 125.0, 559, 179095, 263, 5.784176600000023
264, 3.5359322093768952, 48.35938913450329, 58.225891047661456, 0.6768451, 260.0, 872, 179967, 264, 8.898450600000047
265, 7.385605642036535, 48.66628006696701, 58.70535137057304, 0.6754842999999999, 120.0, 640, 180607, 265, 6.458719799999926
266, 4.593401718908136, 48.59368588189659, 58.60846311341292, 0.6743359000000001, 185.0, 636, 181243, 266, 6.5888688
267, 4.4252522827428615, 48.61528613461051, 58.58641612909402, 0.6731983000000001, 85.0, 628, 181871, 267, 6.47935659999996
268, 7.215664548217155, 48.63205345617831, 58.6712266687288, 0.6719968, 185.0, 707, 182578, 268, 7.246270100000061
269, 7.7966521442289185, 48.538402038213064, 58.59650515945705, 0.6709041999999997, 75.0, 507, 183085, 269, 5.233967699999994
270, 7.191316609977391, 48.62880154724779, 58.69000660139939, 0.6696127000000002, 200.0, 928, 184013, 270, 9.548837899999967
271, 4.412804653238933, 48.625113806192964, 58.590740965527424, 0.6682365999999998, 110.0, 601, 184614, 271, 6.260487799999964
272, 3.7724193317946675, 48.556398164241685, 58.46695372671891, 0.6671071, 65.0, 654, 185268, 272, 6.7705475999998725
273, 3.9936939669141442, 48.57674953558926, 58.47468610689875, 0.6656797, 205.0, 932, 186200, 273, 9.834094900000082
274, 5.839379085662386, 48.58907321001512, 58.578179290886936, 0.6641272, 165.0, 793, 186993, 274, 8.393474799999922
275, 4.841473667348941, 48.6017625011884, 58.51588506283967, 0.6629374000000001, 35.0, 529, 187522, 275, 5.523659100000032
276, 4.635073550037294, 48.59810487350615, 58.54241342827825, 0.6616432000000005, 140.0, 909, 188431, 276, 9.48984930000006
277, 4.775751790700068, 48.62391692882276, 58.563494488665164, 0.6602356, 155.0, 655, 189086, 277, 6.830710700000054
278, 7.139800714965666, 48.5991774740964, 58.605378354862616, 0.6589432000000003, 150.0, 781, 189867, 278, 8.172963299999992
279, 4.676254824912012, 48.34924437341858, 58.18962526414726, 0.6577804000000004, 80.0, 511, 190378, 279, 5.26733379999996
280, 7.499176322458931, 48.37127069282816, 58.35245707209171, 0.6567165999999995, 120.0, 671, 191049, 280, 7.11344310000004
281, 5.3742725146827155, 48.263160189077546, 58.13917820895913, 0.6552684999999999, 185.0, 938, 191987, 281, 9.723931699999866
282, 3.3227002919614317, 48.30378896331787, 58.19535843658447, 0.6539742999999998, 110.0, 500, 192487, 282, 5.307282900000018
283, 4.639152476071913, 48.155179907246975, 58.00923998140571, 0.6529861, 155.0, 598, 193085, 283, 6.661890000000085
284, 4.0451216984271445, 48.270233713627974, 58.171223512446815, 0.6512877999999996, 270.0, 1289, 194374, 284, 13.869733400000086
285, 8.517536665303538, 48.391174185396444, 58.47174563937717, 0.6496821999999998, 20.0, 495, 194869, 285, 5.341212300000052
286, 3.4649191741941308, 48.223128714852564, 58.02768526216673, 0.6481899999999994, 225.0, 1163, 196032, 286, 12.597802700000102
287, 3.6139585292643335, 48.271803577311076, 58.083807979153335, 0.646561, 165.0, 647, 196679, 287, 6.97461989999988
288, 7.794747476284349, 48.341960942413046, 58.33114531903813, 0.6453972999999996, 105.0, 646, 197325, 288, 6.936663999999837
289, 5.00402803075342, 48.325522611704535, 58.20232561607634, 0.6444387999999999, 35.0, 419, 197744, 289, 4.643943800000216
290, 5.502226081479396, 48.2425515872329, 58.09552648743587, 0.6434587000000003, 190.0, 670, 198414, 290, 8.797342899999876
291, 5.176916577691173, 48.343812368612376, 58.25199971719477, 0.6422455000000002, 105.0, 678, 199092, 291, 7.630973099999892
292, 4.298342584058586, 48.32442790741005, 58.20853226397238, 0.6409180000000001, 95.0, 797, 199889, 292, 9.078631900000119
293, 3.1856501952924474, 48.39589719597968, 58.25677866338845, 0.6395607999999999, 305.0, 711, 200600, 293, 8.102338700000018
294, 4.689659351032178, 48.43959669503217, 58.35975270154999, 0.6379615, 205.0, 1066, 201666, 294, 12.688588799999934
295, 4.293923153824705, 48.41037089484079, 58.33846013035093, 0.6361957000000003, 185.0, 896, 202562, 295, 10.136296900000161
296, 5.304865827845843, 48.41933580035529, 58.31470422658315, 0.6347935, 135.0, 662, 203224, 296, 7.32126449999987
297, 3.290613304422753, 48.47451129422726, 58.35104422181297, 0.6335119000000001, 140.0, 762, 203986, 297, 8.647318000000041
298, 4.9014787445764005, 48.403082795304975, 58.34666691872221, 0.6324814000000001, 55.0, 383, 204369, 298, 4.688739700000042
299, 4.191429016403124, 48.467078481935985, 58.384351969700234, 0.6316776999999999, 135.0, 510, 204879, 299, 5.923775500000147
300, 5.021703010703635, 48.380314203697864, 58.30571460273322, 0.6300757000000002, 470.0, 1270, 206149, 300, 15.73029500000007
301, 3.0743657082545033, 48.401470479098236, 58.19964627930612, 0.6283387, 170.0, 660, 206809, 301, 7.60178400000018
302, 5.381476474104709, 48.414857433688255, 58.339521618299585, 0.6270750999999999, 185.0, 744, 207553, 302, 9.161940800000139
303, 6.835687381918214, 48.48225014626315, 58.53176758989525, 0.6254370999999995, 280.0, 1076, 208629, 303, 12.377708199999915
304, 5.630473405004337, 48.41981308791811, 58.269059308791, 0.6237892000000003, 200.0, 755, 209384, 304, 8.751965100000007
305, 5.393386363912083, 48.45306797967616, 58.322837641584094, 0.6225436000000002, 135.0, 629, 210013, 305, 7.558906100000058
306, 3.8865141792274596, 47.8702018989457, 57.64563986990187, 0.6214590999999997, 100.0, 576, 210589, 306, 6.817404000000124
307, 4.865997719185495, 47.85872719850255, 57.65476356075452, 0.6203988999999999, 130.0, 602, 211191, 307, 7.111962799999901
308, 4.336617275607214, 47.81856276952715, 57.56613304254243, 0.6187330000000002, 330.0, 1249, 212440, 308, 15.172483199999988
309, 5.109372370286297, 47.78192482285827, 57.5487583344826, 0.6172552, 30.0, 393, 212833, 309, 4.666472300000123
310, 7.186429103951042, 47.82752062724187, 57.699515511439394, 0.6164335000000001, 95.0, 520, 213353, 310, 6.210823100000198
311, 6.287260278973276, 47.76836704702506, 57.58299902179108, 0.6154984, 120.0, 519, 213872, 311, 6.161678200000097
312, 3.1969634760171175, 47.762397498415226, 57.49430093430636, 0.6146208999999999, 135.0, 456, 214328, 312, 5.5841554000001
313, 4.90512277930975, 47.809850521941684, 57.61662868670563, 0.6136075, 210.0, 670, 214998, 313, 7.6575824999999895
314, 6.5046519625470625, 47.83219734445738, 57.722311562839586, 0.6120306999999998, 285.0, 1082, 216080, 314, 11.982125200000155
315, 2.7352208181551574, 47.70809074763136, 57.386798646124625, 0.6107338, 30.0, 359, 216439, 315, 3.9955089000000044
316, 4.491328092278589, 47.78543632649623, 57.552594413374216, 0.6097834000000002, 105.0, 697, 217136, 316, 7.7410591999998815
317, 4.418015721850876, 47.775900551020584, 57.576568833429725, 0.6084244000000002, 125.0, 813, 217949, 317, 9.048431200000095
318, 5.501902870571898, 47.75324181665348, 57.55196602736847, 0.6070528000000003, 105.0, 711, 218660, 318, 7.984304199999997
319, 6.230804455751923, 47.78746136752042, 57.6499870955342, 0.6058782999999999, 105.0, 594, 219254, 319, 6.67456500000003
320, 5.749676696750827, 47.840392548268234, 57.66703760342335, 0.6048865, 150.0, 508, 219762, 320, 5.684798699999874
321, 5.344668278677596, 47.59863603850942, 57.37559126237783, 0.6039919000000001, 30.0, 486, 220248, 321, 5.453245700000025
322, 3.9138279166872514, 47.355589135292846, 56.95702349188869, 0.6032610999999998, 10.0, 326, 220574, 322, 3.679860899999994
323, 5.101491358641743, 47.42390896947251, 57.112299953015324, 0.6026130999999999, 55.0, 394, 220968, 323, 4.431308100000024
324, 5.603872120169337, 47.42769235929754, 57.16914534096002, 0.6016231000000001, 125.0, 706, 221674, 324, 8.246051999999963
325, 4.692600463028121, 47.34583626790171, 57.006494091695394, 0.6002298999999998, 295.0, 842, 222516, 325, 10.236585099999957
326, 3.1798197411545894, 47.35963127322313, 56.96950081615913, 0.5991030999999998, 85.0, 410, 222926, 326, 4.682775900000024
327, 3.85320486795057, 47.41895417304377, 57.09622521621965, 0.598366, 80.0, 409, 223335, 327, 4.71088050000003
328, 4.122453960349829, 47.53894936659311, 57.274774915337986, 0.5974884999999999, 55.0, 566, 223901, 328, 6.4936195000000225
329, 4.365505947838531, 47.44999697600563, 57.130061053813286, 0.5963607999999998, 65.0, 687, 224588, 329, 7.813482600000043
330, 3.9674147966917506, 47.44852445930181, 57.100450448614716, 0.5953078000000002, 50.0, 483, 225071, 330, 5.536013099999991
331, 3.8337944531580774, 47.47645344783206, 57.17709478302674, 0.5942602000000001, 160.0, 681, 225752, 331, 7.857365900000104
332, 5.284370587863414, 47.412343865392764, 57.16244223479346, 0.5931784000000002, 65.0, 521, 226273, 332, 5.915247500000078
333, 4.771082586814872, 47.37602245139513, 57.020175810057154, 0.5920992999999998, 105.0, 678, 226951, 333, 7.663991699999997
334, 5.266203881534013, 47.446950944803525, 57.156982531292655, 0.5907987999999997, 135.0, 767, 227718, 334, 8.688217500000064
335, 3.580438766540331, 47.46875178884472, 57.12673330589159, 0.5895000999999999, 280.0, 676, 228394, 335, 7.637923699999874
336, 3.1666545415805145, 47.40952747518366, 57.06409114490856, 0.5884957, 75.0, 440, 228834, 336, 4.965488300000061
337, 6.243815595552041, 47.44698373407797, 57.155486412643356, 0.5875804000000002, 60.0, 577, 229411, 337, 6.567579999999907
338, 2.989538119079774, 47.45495509097451, 57.13893239874589, 0.5865480999999998, 50.0, 570, 229981, 338, 6.474709000000075
339, 5.165553797519844, 47.34638332531956, 57.03219591873596, 0.5856814000000001, 45.0, 393, 230374, 339, 4.47762879999982
340, 6.366778187360485, 47.35259350284582, 57.10719534352691, 0.5846806000000001, 170.0, 719, 231093, 340, 8.161139200000207
341, 4.098416419284378, 47.34532412979529, 56.96058148903241, 0.5832829, 210.0, 834, 231927, 341, 9.51043279999999
342, 4.846980350199188, 47.3224717264339, 57.0280989484277, 0.5816404000000001, 190.0, 991, 232918, 342, 11.530711200000042
343, 3.239792493080257, 47.272084511580175, 56.91374852939918, 0.5802094000000001, 215.0, 599, 233517, 343, 7.616017499999998
344, 4.351070566133849, 47.36335602088688, 57.001138112461284, 0.5791834, 50.0, 541, 234058, 344, 6.461782300000095
345, 5.141557276965751, 47.357993751503635, 57.08137995995168, 0.5780790999999996, 240.0, 686, 234744, 345, 8.03182310000011
346, 5.158521845210659, 47.315355591854804, 56.92545015259651, 0.5768245, 135.0, 708, 235452, 346, 8.976494799999955
347, 5.477523392604979, 47.37445476704466, 57.13039940915273, 0.5753313999999998, 230.0, 951, 236403, 347, 11.562665799999877
348, 4.249650475831881, 47.31962623596191, 56.93995669639274, 0.5738184999999998, 135.0, 730, 237133, 348, 9.321104100000184
349, 5.877056454035995, 47.32748959813307, 57.00062034964992, 0.5726629, 115.0, 554, 237687, 349, 6.420569299999897
350, 5.2086838101942226, 47.419548629718236, 57.089792936957316, 0.5718411999999999, 80.0, 359, 238046, 350, 4.340438500000118
351, 5.969398275225964, 47.349944848472894, 57.02430822380766, 0.5704876, 185.0, 1145, 239191, 351, 14.155819300000076
352, 4.554884989430075, 47.35452848240949, 57.062041777458745, 0.5688361000000001, 240.0, 690, 239881, 352, 8.817085299999917
353, 3.983233828486632, 47.12901816961591, 56.76552479734407, 0.5675860000000003, 195.0, 699, 240580, 353, 8.699141499999996
354, 4.15104038928767, 47.08082021570602, 56.69347680638702, 0.5663071000000003, 160.0, 722, 241302, 354, 8.945421900000156
355, 4.3324387147893075, 47.01792217088782, 56.63264229152514, 0.5651398, 120.0, 575, 241877, 355, 6.8230919000000085
356, 4.147879623941013, 46.99635359056953, 56.58660957440227, 0.5640930999999999, 20.0, 588, 242465, 356, 6.994735799999944
357, 3.637596282967419, 47.06415496168111, 56.61571874387181, 0.5628960999999999, 195.0, 742, 243207, 357, 8.975762900000063
358, 4.780694267298612, 47.09377934535345, 56.70233799351586, 0.5617098999999999, 95.0, 576, 243783, 358, 6.915342699999883
359, 4.052578317630568, 47.10402577760204, 56.765210840086276, 0.5606479000000002, 65.0, 604, 244387, 359, 7.230190900000025
360, 4.202452228473173, 47.04402216834835, 56.59425891557809, 0.5595543999999999, 120.0, 611, 244998, 360, 7.251119900000049
361, 3.8138548658398386, 47.02055618833389, 56.59694983888779, 0.5581512999999996, 225.0, 948, 245946, 361, 11.368969899999911
362, 5.8395642190478565, 47.064989471435545, 56.7742726821308, 0.5567176, 135.0, 645, 246591, 362, 7.785962800000107
363, 3.6682725156566027, 47.02672351318689, 56.588619239044874, 0.5551371999999997, 330.0, 1111, 247702, 363, 13.741633999999976
364, 3.397194733020741, 47.02409932520482, 56.622176424249425, 0.5535829000000002, 95.0, 616, 248318, 364, 7.481691800000135
365, 4.867548579688555, 47.07882579230016, 56.65320738250134, 0.5523400000000002, 210.0, 765, 249083, 365, 9.248636900000065
366, 6.947191747843878, 47.09435100409821, 56.84367567892293, 0.5511798999999998, 70.0, 524, 249607, 366, 6.378232000000025
367, 5.935328216049144, 47.44226810719707, 57.12921277918044, 0.5501629, 95.0, 606, 250213, 367, 7.911609100000078
368, 4.421790697232006, 48.13498545368825, 57.933051726574035, 0.549046, 80.0, 635, 250848, 368, 7.7577647000000525
369, 3.433822880480352, 47.97672212768743, 57.677118339715456, 0.5478922, 125.0, 647, 251495, 369, 7.955521600000111
370, 5.270698440021758, 48.14056942070143, 57.96279898820619, 0.5464522000000003, 300.0, 953, 252448, 370, 11.624234699999988
371, 5.390361513101285, 48.099068988852785, 57.892557724280294, 0.5452038999999999, 125.0, 434, 252882, 371, 5.317366200000151
372, 4.435472096885379, 48.10949430207948, 57.96032326672528, 0.5441472999999998, 235.0, 740, 253622, 372, 9.001964099999896
373, 3.9923326349969392, 48.11982173545688, 57.939891154470004, 0.5429304999999998, 115.0, 612, 254234, 373, 7.461163899999974
374, 3.1595144477885775, 48.03643058938202, 57.7835675841732, 0.5414859999999997, 215.0, 993, 255227, 374, 12.13795170000003
375, 3.8041384620879723, 48.11347741848085, 57.90578275230842, 0.5400387999999997, 75.0, 615, 255842, 375, 7.942009899999903
376, 5.686516697113925, 48.116601079184484, 57.904244529880806, 0.5389156, 105.0, 633, 256475, 376, 8.072860700000092
377, 6.069645583832128, 48.048301582172705, 57.878687682581564, 0.5377168, 105.0, 699, 257174, 377, 8.972751300000027
378, 4.223270431799963, 48.0733957495141, 57.82511309201722, 0.5366259999999999, 80.0, 513, 257687, 378, 6.484192299999904
379, 4.609559418278278, 48.12924107788615, 57.88901301477686, 0.5355415, 155.0, 692, 258379, 379, 8.605415900000025
380, 6.00961316427801, 48.155904107101044, 57.999135256175386, 0.5343255999999997, 115.0, 659, 259038, 380, 8.129088499999853
381, 7.0195947827707075, 48.159136142636754, 58.04415266384632, 0.5330016999999999, 450.0, 812, 259850, 381, 9.844841200000019
382, 6.696092509705087, 49.38793173643762, 59.50349542369013, 0.5318776, 55.0, 437, 260287, 382, 5.50787379999997
383, 3.4996712541999146, 49.83676182804778, 59.95930387722417, 0.5309209, 105.0, 626, 260913, 383, 8.053068500000109
384, 3.198808547035909, 49.95470595561283, 60.09282807900872, 0.5297185000000003, 120.0, 710, 261623, 384, 9.621366099999932
385, 5.495850139973759, 49.980688563878275, 60.1875929197272, 0.5285998000000001, 35.0, 533, 262156, 385, 7.720540800000208
386, 3.7791842877690893, 49.86022320610076, 59.95238883764363, 0.5276575, 115.0, 514, 262670, 386, 7.699661399999968
387, 3.4358214864629777, 49.80509932230913, 59.92753011710091, 0.5266746999999999, 80.0, 578, 263248, 387, 7.670406299999968
388, 6.6590551981783435, 50.031926677538, 60.286595808941385, 0.5253265000000001, 185.0, 920, 264168, 388, 12.258907299999919
389, 5.38246924103422, 49.95227281295042, 60.06392062794078, 0.5241619, 45.0, 374, 264542, 389, 4.983592599999838
390, 7.282491250511478, 50.01581403239609, 60.307889548104136, 0.5231214999999998, 215.0, 782, 265324, 390, 10.34728670000004
391, 4.458037189269512, 49.87555865149141, 59.94065659056676, 0.5216004999999999, 175.0, 908, 266232, 391, 11.714114000000109
392, 5.799224284574805, 49.96661051500669, 60.166058095559215, 0.5199130000000001, 155.0, 967, 267199, 392, 12.389833400000043
393, 3.0822803202985734, 49.92484932891593, 60.00561391657049, 0.5184982000000001, 135.0, 605, 267804, 393, 7.8331376000001
394, 4.416494948379064, 49.93389739990234, 60.06480841555838, 0.5174227, 115.0, 590, 268394, 394, 7.796581699999933
395, 4.2806175783573215, 49.89721856694126, 60.030666035861, 0.5163039999999999, 95.0, 653, 269047, 395, 8.56950299999994
396, 3.9071123106676398, 49.99476972598474, 60.15019353848059, 0.5149746999999998, 225.0, 824, 269871, 396, 10.76958710000008
397, 4.044867750219433, 49.53903608273734, 59.604942142660846, 0.5135238999999998, 230.0, 788, 270659, 397, 10.040233899999976
398, 5.09294962264195, 49.5674346270286, 59.771164579764424, 0.5123314, 50.0, 537, 271196, 398, 6.940845000000309
399, 4.0750917346580415, 49.466477651585016, 59.516929591102645, 0.5110714000000001, 215.0, 863, 272059, 399, 10.859840000000077
400, 5.392068693377145, 49.509086442729306, 59.57943496081011, 0.5093028999999998, 270.0, 1102, 273161, 400, 14.017594500000087
401, 3.8713624556416923, 49.388826806535604, 59.444328261773116, 0.5074219, 295.0, 988, 274149, 401, 12.561692100000073
402, 6.4364000986441505, 49.49779998131518, 59.565867801882185, 0.5059603000000003, 170.0, 636, 274785, 402, 8.180413699999917
403, 7.532271786554325, 49.56668157972528, 59.7851599913377, 0.5047794999999998, 155.0, 676, 275461, 403, 8.964475300000231
404, 4.387730902108948, 49.445206133738644, 59.45760857082243, 0.5033692, 225.0, 891, 276352, 404, 11.86108430000013
405, 2.9553436611000516, 49.44159042919542, 59.458848098042665, 0.5019309999999998, 165.0, 707, 277059, 405, 9.884152699999959
406, 6.197788766977635, 49.51002029662437, 59.58207611327476, 0.5004487000000002, 540.0, 940, 277999, 406, 12.16236170000002
407, 3.128166278441747, 49.42133275349935, 59.46247554524739, 0.4992651999999998, 35.0, 375, 278374, 407, 5.107691000000159
408, 5.939976082749344, 49.456635863016665, 59.548267994200785, 0.4985514999999998, 35.0, 418, 278792, 408, 5.934228999999959
409, 4.207763435090918, 49.590984735018154, 59.66696672596487, 0.4976830000000001, 210.0, 547, 279339, 409, 7.996616500000073
410, 3.2961926742134358, 49.48149290979873, 59.49598343858441, 0.4966344999999998, 100.0, 618, 279957, 410, 8.664007700000184
411, 4.882255916350963, 49.961268008376884, 60.15811705340654, 0.49530159999999984, 185.0, 863, 280820, 411, 12.439301299999897
412, 4.12743507191762, 49.952824984533024, 60.09532760899396, 0.4939839999999999, 125.0, 601, 281421, 412, 8.03256220000003
413, 7.852592626678285, 50.03598894282202, 60.24691047476764, 0.4925475999999998, 340.0, 995, 282416, 413, 13.007526299999881
414, 3.7610071304692956, 49.90274646065452, 60.01522180856752, 0.4912165, 55.0, 484, 282900, 414, 6.508743500000037
415, 6.6444210055474064, 50.05171921917555, 60.273219694130674, 0.4900348, 395.0, 829, 283729, 415, 11.096053499999925
416, 2.8153461310719945, 49.88510570226539, 59.981773686034515, 0.48894489999999985, 75.0, 382, 284111, 416, 5.150766100000055
417, 4.432051556301303, 49.92436676791736, 60.09493673699243, 0.48779469999999986, 155.0, 896, 285007, 417, 11.879465099999834
418, 5.563413983435957, 49.96556805939654, 60.10625454987328, 0.48637000000000025, 155.0, 687, 285694, 418, 8.996568300000035
419, 6.093305798433219, 49.897029013003944, 60.06976618599699, 0.48541779999999984, 45.0, 371, 286065, 419, 5.09146469999996
420, 3.063684963839395, 50.01773591177804, 60.09997376578195, 0.4847689, 95.0, 350, 286415, 420, 4.707633800000167
421, 4.143388561128873, 49.92245546753644, 60.029184539973386, 0.4836844, 370.0, 855, 287270, 421, 11.498891299999741
422, 4.619688993836401, 49.95715747560774, 60.11569603751688, 0.4820581000000001, 285.0, 952, 288222, 422, 13.954677400000037
423, 4.7160873068732965, 49.95887720040258, 60.12688218034464, 0.4804921000000003, 185.0, 788, 289010, 423, 10.28462219999983
424, 3.4757236854897604, 49.97320497878874, 60.14271749149669, 0.4790701000000001, 210.0, 792, 289802, 424, 10.363749699999971
425, 7.803622855157569, 49.520091085908504, 59.68139135933229, 0.4777966000000002, 70.0, 623, 290425, 425, 8.226059600000099
426, 5.451039962337485, 49.379023620060515, 59.38533567246937, 0.47693349999999995, 40.0, 336, 290761, 426, 4.449586499999896
427, 6.166334563030831, 49.35409306897335, 59.43924609279133, 0.4761154000000001, 100.0, 573, 291334, 427, 7.452095099999951
428, 4.230903171356308, 49.326131744674306, 59.3242125610699, 0.47512540000000003, 45.0, 527, 291861, 428, 6.9194658000001255
429, 5.480634973089919, 49.33600120404701, 59.37491450234065, 0.4739139999999997, 260.0, 819, 292680, 429, 10.757655399999749
430, 4.182216600419763, 49.258205054518214, 59.270787508549816, 0.47272779999999986, 45.0, 499, 293179, 430, 6.745246099999804
431, 4.1106468233835916, 49.33081063991639, 59.33514476707353, 0.47142999999999985, 240.0, 943, 294122, 431, 13.078942600000119
432, 4.952988006183843, 49.316525660000586, 59.349412673437136, 0.46985859999999985, 360.0, 803, 294925, 432, 10.510727699999734
433, 4.3909473075316505, 49.3503965694412, 59.359768238144845, 0.46869130000000003, 20.0, 494, 295419, 433, 6.794637499999681
434, 5.60819496261305, 49.46855594228948, 59.57226263386556, 0.4676463999999999, 195.0, 667, 296086, 434, 9.002953299999717
435, 6.9629616446784, 49.409476109457074, 59.47737868723713, 0.46630720000000014, 210.0, 821, 296907, 435, 10.820581299999958
436, 4.821001821377781, 49.28288597546441, 59.28328413519585, 0.4649589999999999, 140.0, 677, 297584, 436, 8.98988989999998
437, 4.232097758283902, 49.33629491418574, 59.325987462490254, 0.4633174, 225.0, 1147, 298731, 437, 15.11407569999983
438, 6.856098956359576, 49.38030572133521, 59.5202174356539, 0.46195659999999994, 35.0, 365, 299096, 438, 4.891226000000188
439, 3.5356864655700524, 49.357017979699904, 59.349500375257534, 0.46069300000000013, 315.0, 1039, 300135, 439, 13.890331400000377
440, 4.421926597727018, 49.300269413515515, 59.34592499585317, 0.45876969999999984, 290.0, 1098, 301233, 440, 14.518878500000028
441, 3.651588863057355, 49.3108468727207, 59.30713809960241, 0.45677169999999995, 205.0, 1122, 302355, 441, 14.746386100000109
442, 2.623494549266087, 49.17979159478332, 59.137394352592665, 0.45527409999999996, 50.0, 542, 302897, 442, 7.216306699999677
443, 4.124561657557103, 49.35960849251334, 59.43057727062796, 0.4543291, 35.0, 508, 303405, 443, 6.764841400000023
444, 7.461431854591596, 49.37374200041984, 59.51400780835689, 0.4530564999999998, 325.0, 906, 304311, 444, 11.966211200000089
445, 8.51675119268966, 49.442965088120424, 59.5781496576516, 0.4516434999999997, 95.0, 664, 304975, 445, 8.864141800000198
446, 4.4478583529154045, 49.23984793101362, 59.211894659592495, 0.45052480000000006, 30.0, 579, 305554, 446, 7.7252824000001965
447, 3.1495529879827666, 49.33135750927502, 59.284843511219265, 0.4494349000000001, 130.0, 632, 306186, 447, 8.434441699999752
448, 5.151375742797429, 49.31039753957709, 59.37219069007837, 0.4482982000000002, 160.0, 631, 306817, 448, 8.433076099999653
449, 6.854364353196788, 49.30315768405926, 59.3648983924799, 0.44711290000000004, 150.0, 686, 307503, 449, 9.1939268000001
450, 3.698309460830746, 49.40440743656482, 59.4292954174716, 0.4461237999999999, 65.0, 413, 307916, 450, 5.576504300000124
451, 2.9046240572584225, 49.24086561922319, 59.22554030035534, 0.4453821999999999, 55.0, 411, 308327, 451, 5.549751700000343
452, 3.5699202449128613, 49.29764288719362, 59.27756465791102, 0.4440457000000001, 190.0, 1074, 309401, 452, 14.389978400000018
453, 4.20555642936825, 49.30371213530532, 59.33216389371047, 0.44236539999999996, 105.0, 793, 310194, 453, 10.663468300000204
454, 3.3872715251054615, 49.35759450991949, 59.333744863669075, 0.4413061, 5.0, 384, 310578, 454, 5.169514600000184
455, 3.264666508144093, 49.357016601259744, 59.377981617337184, 0.4405068999999999, 55.0, 504, 311082, 455, 6.827280999999857
456, 5.193378108227207, 49.32142434469083, 59.35783269683877, 0.4393521999999999, 250.0, 779, 311861, 456, 10.487072200000057
457, 3.7059328027850107, 49.40619815644764, 59.51603983561198, 0.4381785999999999, 95.0, 525, 312386, 457, 7.069584500000019
458, 3.3098967848387777, 49.3415583873766, 59.35440284418305, 0.4373083, 80.0, 442, 312828, 458, 6.002212800000052
459, 7.28007203677944, 49.397974764714476, 59.482598957468255, 0.43603209999999987, 295.0, 976, 313804, 459, 14.279146999999739
460, 3.2887170615883425, 49.36918446865488, 59.33851863475556, 0.43447689999999994, 155.0, 752, 314556, 460, 11.303045699999984
461, 8.385576899144239, 49.377761780365525, 59.4568839881764, 0.43323219999999985, 165.0, 631, 315187, 461, 9.51835119999987
462, 4.807853505618964, 49.33936058720456, 59.374123488800436, 0.4323088000000001, 45.0, 395, 315582, 462, 5.979489299999841
463, 4.444432705370844, 49.33419630492943, 59.32056871358899, 0.4314565, 135.0, 552, 316134, 463, 8.413112100000035
464, 3.299974744618645, 49.312784918111646, 59.29006506029464, 0.43020010000000014, 395.0, 844, 316978, 464, 12.759351600000173
465, 3.3458450541174485, 49.3350515775154, 59.36741633034923, 0.42870700000000006, 165.0, 815, 317793, 465, 12.238408700000036
466, 4.098527882853315, 49.37439751660593, 59.40243398947794, 0.42736960000000007, 70.0, 671, 318464, 466, 10.123278199999731
467, 3.1549484259067633, 49.34047355367883, 59.366477729664844, 0.42640299999999987, 45.0, 403, 318867, 467, 6.080172699999821
468, 6.648010403171139, 49.431947184014255, 59.603782761873674, 0.42572259999999995, 35.0, 353, 319220, 468, 5.446605900000122
469, 2.8943005173327303, 49.33169066124688, 59.31419991136353, 0.4249791999999999, 80.0, 473, 319693, 469, 7.186434299999746
470, 4.562371865237082, 49.504462463791306, 59.49397387117953, 0.42422049999999994, 45.0, 370, 320063, 470, 5.739710400000149
471, 4.46735983376614, 49.80758711690888, 59.975592366765056, 0.42332679999999995, 160.0, 623, 320686, 471, 9.497447300000204
472, 4.2303595319525025, 49.671740168042035, 59.72637386908367, 0.42226839999999993, 45.0, 553, 321239, 472, 8.507824100000107
473, 3.1497779480792993, 49.699572223827154, 59.73456384506694, 0.4211838999999999, 90.0, 652, 321891, 473, 10.099963500000285
474, 5.019912662180039, 49.70202079009089, 59.8045359428599, 0.41985100000000003, 225.0, 829, 322720, 474, 13.113726399999905
475, 4.13867537351405, 49.719104312091915, 59.818911796164144, 0.4180554999999998, 390.0, 1166, 323886, 475, 17.73790629999985
476, 3.092197291914504, 49.770446587123, 59.83605822848502, 0.41633829999999983, 175.0, 742, 324628, 476, 11.590121799999906
477, 2.9668511687239807, 49.69106346212661, 59.77105075148478, 0.41508639999999986, 155.0, 649, 325277, 477, 10.431523499999912
478, 4.472991659703446, 49.71022378179874, 59.80432838785636, 0.4136481999999998, 170.0, 949, 326226, 478, 14.383342900000116
479, 3.255676121523906, 49.71893375514852, 59.79278278177119, 0.4118059, 270.0, 1098, 327324, 479, 16.76285710000002
480, 4.610085408687592, 49.804192253748575, 59.930021635691325, 0.40973769999999976, 285.0, 1200, 328524, 480, 18.31149830000004
481, 4.406613801822629, 49.73866837730939, 59.84087660772426, 0.40820499999999993, 45.0, 503, 329027, 481, 7.694590399999925
482, 3.842396174124309, 49.82657107979911, 59.94538713291713, 0.4069648, 335.0, 875, 329902, 482, 13.332887199999732
483, 4.341434153592265, 49.05971114699905, 59.0247478519474, 0.4056777999999999, 140.0, 555, 330457, 483, 8.634595499999705
484, 4.845444861744028, 48.93872320151942, 58.91811341426369, 0.4045131999999999, 215.0, 739, 331196, 484, 11.415915600000062
485, 3.3165894074852047, 48.90648056271837, 58.80583009745011, 0.4035070000000001, 75.0, 379, 331575, 485, 5.863783200000398
486, 7.909073491914115, 48.93210863737467, 58.90633571642335, 0.40258000000000005, 100.0, 651, 332226, 486, 10.080640300000141
487, 3.968649140904459, 48.8956720427181, 58.77501058042719, 0.40135329999999997, 115.0, 712, 332938, 487, 11.055507400000351
488, 4.276828161459797, 48.99210792852908, 58.917813375044844, 0.40027149999999995, 95.0, 490, 333428, 488, 7.583989300000212
489, 3.2016719250617194, 48.929259824659496, 58.797018234043904, 0.3989107000000001, 265.0, 1022, 334450, 489, 15.846017100000154
490, 5.5817716170403715, 48.94061034394624, 58.87932236059192, 0.397468, 115.0, 581, 335031, 490, 9.250615399999788
491, 4.340038591759459, 48.964123532251655, 58.90274898412869, 0.3962359000000001, 130.0, 788, 335819, 491, 12.511024599999928
492, 3.3824096915353885, 48.925860568527185, 58.85880397303438, 0.39484450000000015, 155.0, 758, 336577, 492, 11.949299699999756
493, 4.420333979796851, 48.89499880373478, 58.86050786823034, 0.39370150000000004, 35.0, 512, 337089, 493, 8.130444300000363
494, 4.561510298737335, 48.99732551161563, 58.94909494448225, 0.3927420999999999, 35.0, 554, 337643, 494, 8.776417499999752
495, 3.1676016069882738, 48.91556807661478, 58.8771886167273, 0.39173499999999994, 105.0, 565, 338208, 495, 8.91819469999973
496, 4.032598222542129, 48.96325361008612, 58.878171616112624, 0.390556, 175.0, 745, 338953, 496, 11.886020700000245
497, 3.240398378504255, 48.93203250830772, 58.87107101096926, 0.3891259000000001, 135.0, 844, 339797, 497, 13.438253999999688
498, 4.237039123715806, 48.78769404300745, 58.71024941361469, 0.3873726999999999, 340.0, 1104, 340901, 498, 17.565417799999977
499, 3.131309352215885, 48.74075577038677, 58.58508961598555, 0.3856293999999998, 230.0, 833, 341734, 499, 13.276813599999969
500, 4.321451134907896, 48.695110290955284, 58.566761020189, 0.38385279999999994, 240.0, 1141, 342875, 500, 18.313339799999994
501, 3.3477758364325263, 48.712658374418766, 58.55991535277163, 0.38225619999999993, 205.0, 633, 343508, 501, 10.145011800000248
502, 4.169274125894382, 48.714631461193214, 58.60907900480297, 0.38073700000000016, 460.0, 1055, 344563, 502, 16.87530629999992
503, 3.830684166720089, 48.756549873124534, 58.66211459650908, 0.37888209999999983, 170.0, 1006, 345569, 503, 16.201630000000023
504, 3.336007037624884, 48.75780601930082, 58.64842533583052, 0.3775762000000001, 45.0, 445, 346014, 504, 7.263779599999907
505, 2.9084555641208216, 48.75051374007966, 58.59271242003168, 0.37659339999999997, 195.0, 647, 346661, 505, 11.171809400000257
506, 5.357634660579621, 48.8356476956188, 58.775765233902035, 0.3747915999999999, 340.0, 1355, 348016, 506, 23.208544699999948
507, 3.3426620246666783, 48.7810884979536, 58.65887163630072, 0.3726181, 280.0, 1060, 349076, 507, 16.314782800000103
508, 3.899848190321625, 48.76604359212825, 58.63641961644308, 0.37091350000000006, 310.0, 834, 349910, 508, 12.499506900000142
509, 5.288626232935827, 48.93138524299658, 58.90996314246873, 0.3694176999999999, 175.0, 828, 350738, 509, 12.379913999999644
510, 5.542610320897722, 49.01158112471521, 59.023921606136994, 0.36771039999999994, 200.0, 1069, 351807, 510, 16.04645309999978
511, 4.765016685430429, 48.88559921865839, 58.78423179426068, 0.3657888999999999, 305.0, 1066, 352873, 511, 15.861229099999946
512, 4.237381305861473, 48.87829273071289, 58.81017123413086, 0.3642669999999999, 160.0, 625, 353498, 512, 9.549587900000006
513, 6.330288838278624, 48.95405915204216, 58.86879410463221, 0.3631536999999998, 90.0, 612, 354110, 513, 9.317568199999641
514, 7.007865905552646, 48.9033926749716, 58.93374906754007, 0.3618972999999999, 155.0, 784, 354894, 514, 11.922969199999898
515, 5.7000466135017245, 48.99232874063611, 58.96211129929516, 0.36019899999999994, 275.0, 1103, 355997, 515, 16.600352700000258
516, 4.218027606306661, 48.89537029151226, 58.820581785390075, 0.3587589999999998, 115.0, 497, 356494, 516, 7.58066480000025
517, 5.451289532571578, 48.865100592261484, 58.76703659028608, 0.35783830000000005, 60.0, 526, 357020, 517, 8.045814200000223
518, 3.0653637224808334, 48.87255306243897, 58.75069487094879, 0.3567888999999999, 145.0, 640, 357660, 518, 9.797421100000065
519, 5.2168453608206065, 48.94918919488582, 58.92586121800858, 0.3554316999999999, 220.0, 868, 358528, 519, 13.22364460000017
520, 5.068999845287127, 48.9423771467596, 58.89960738389694, 0.3536749, 300.0, 1084, 359612, 520, 16.52059559999998
521, 6.170202360285222, 48.999823585783616, 59.025792392146705, 0.35214670000000003, 110.0, 614, 360226, 521, 9.677939599999718
522, 4.509151182165381, 49.07819446595777, 59.02613768743581, 0.3508443999999999, 165.0, 833, 361059, 522, 13.88464279999971
523, 3.39455933217576, 49.08578535842054, 59.04950780636954, 0.34968699999999986, 15.0, 453, 361512, 523, 7.627942799999801
524, 4.594560217006502, 49.14885940893883, 59.134500187074124, 0.34867719999999996, 220.0, 669, 362181, 524, 11.185085800000252
525, 3.693343518633857, 49.09682939419934, 59.06477663092023, 0.34747929999999994, 180.0, 662, 362843, 525, 11.06645810000009
526, 5.260018374955937, 49.03554363127146, 59.00868233336743, 0.34605009999999997, 180.0, 926, 363769, 526, 15.501084999999875
527, 6.082034876540394, 49.201771961984456, 59.15919734276145, 0.3444832, 95.0, 815, 364584, 527, 13.616560400000253
528, 4.2292991607130155, 49.140172373234776, 59.104976518546806, 0.3429136000000001, 185.0, 929, 365513, 528, 15.605903300000136
529, 3.680147735387218, 49.12049421738948, 59.04638198650881, 0.34105599999999986, 410.0, 1135, 366648, 529, 19.004454299999907
530, 3.8346621122477886, 49.12848348472744, 59.11966227450753, 0.3392046999999998, 380.0, 922, 367570, 530, 15.47034020000001
531, 3.155573722927545, 49.0608900650186, 58.975572969837735, 0.33777999999999986, 160.0, 661, 368231, 531, 11.197239099999933
532, 5.50849943511176, 49.06839240305305, 59.081046849919744, 0.3366244, 150.0, 623, 368854, 532, 10.550992300000416
533, 3.6935162979601115, 49.04552006381592, 58.95741835242619, 0.33517989999999986, 445.0, 982, 369836, 533, 16.466638899999907
534, 3.1047710651012155, 48.88845406498345, 58.78084560267276, 0.33351219999999987, 120.0, 871, 370707, 534, 14.605891200000315
535, 3.0216850008710927, 48.84675495155944, 58.749358504688765, 0.33189490000000016, 320.0, 926, 371633, 535, 15.552789700000176
536, 4.014590313029756, 48.896047101920864, 58.807848037964845, 0.3301651, 325.0, 996, 372629, 536, 16.8000162000003
537, 6.394411249739396, 48.80129058020456, 58.731406701075564, 0.3287142999999999, 95.0, 616, 373245, 537, 10.381914300000062
538, 6.830570914890877, 48.88561405137528, 58.83593307539474, 0.32785029999999993, 80.0, 344, 373589, 538, 5.813484400000107
539, 4.397946392689698, 48.90656473107839, 58.83419758243783, 0.3266154999999998, 215.0, 1028, 374617, 539, 17.27180499999986
540, 5.152131768330508, 48.7970806173145, 58.730786322121844, 0.3250881999999999, 170.0, 669, 375286, 540, 11.297707000000173
541, 3.9928076401330608, 48.836503477909105, 58.69550208304138, 0.3238839999999999, 170.0, 669, 375955, 541, 11.267931899999894
542, 4.578594203554947, 48.865050925917295, 58.77138191397864, 0.32269239999999993, 170.0, 655, 376610, 542, 11.06473700000015
543, 3.1671049615163955, 48.92983696722215, 58.821764619888796, 0.3214054, 155.0, 775, 377385, 543, 13.084331700000348
544, 3.861966627464637, 48.8590794522456, 58.748133320652265, 0.3199933, 140.0, 794, 378179, 544, 13.367430199999944
545, 4.3216192502340505, 48.90191720571999, 58.76285478269311, 0.31867209999999996, 130.0, 674, 378853, 545, 11.41700179999998
546, 5.2087731911523925, 48.827107905482386, 58.74397799517657, 0.31756599999999996, 125.0, 555, 379408, 546, 9.399961699999949
547, 3.7689830423031334, 48.971798910647436, 58.93219637650322, 0.31638519999999987, 115.0, 757, 380165, 547, 12.816654199999903
548, 4.027836317949149, 49.40243313847756, 59.40690049151985, 0.3150424, 225.0, 735, 380900, 548, 13.142152500000066
549, 5.7573088404555355, 49.431173094725, 59.55247363066062, 0.3136788999999999, 235.0, 780, 381680, 549, 13.989246200000252
550, 4.405553988211757, 49.315928874871666, 59.30718233297159, 0.31248549999999986, 70.0, 546, 382226, 550, 10.267077999999856
551, 6.195157549136699, 49.39250094391579, 59.39654859118287, 0.3114523, 120.0, 602, 382828, 551, 12.537570200000118
552, 6.091580711363077, 49.45472493624057, 59.53527865254119, 0.31033179999999994, 85.0, 643, 383471, 552, 11.198912899999868
553, 3.845450042474569, 49.415221934199, 59.41841167991872, 0.3091068999999999, 400.0, 718, 384189, 553, 12.033040100000107
554, 4.959900473850751, 49.41779725241199, 59.4611176519843, 0.3078109, 160.0, 722, 384911, 554, 12.89812830000028
555, 4.485113543563152, 49.33355863088996, 59.35963631956369, 0.3059541999999999, 345.0, 1341, 386252, 555, 22.845091799999864
556, 4.17261689707767, 49.263538460544105, 59.24165585780248, 0.30433509999999997, 15.0, 458, 386710, 556, 8.337265099999968
557, 4.603417159297637, 49.37352557863508, 59.392559710003084, 0.30316689999999996, 250.0, 840, 387550, 557, 14.504566000000068
558, 4.913009268611118, 49.28750329547458, 59.2907135280562, 0.3018277, 155.0, 648, 388198, 558, 11.075548400000116
559, 3.5382222098094025, 49.3053895277249, 59.271963167720905, 0.30035439999999997, 240.0, 989, 389187, 559, 16.91459739999982
560, 3.5530947625161486, 49.2500060906647, 59.220714247818535, 0.2984490999999999, 225.0, 1128, 390315, 560, 20.18204710000009
561, 3.8575118302187623, 48.85350346765598, 58.7217810935333, 0.2965770999999999, 195.0, 952, 391267, 561, 16.38304210000024
562, 2.787826714672709, 48.74794907928795, 58.59297406596522, 0.2953017999999999, 115.0, 465, 391732, 562, 8.582771600000342
563, 3.717882336564727, 48.821419449413526, 58.72609160928165, 0.29414889999999994, 170.0, 816, 392548, 563, 13.892763099999684
564, 2.7376208621384968, 48.80107289943112, 58.663576189954554, 0.29279619999999995, 130.0, 687, 393235, 564, 12.106970499999989
565, 3.2831248438043845, 48.85188076650496, 58.74593742516973, 0.29142729999999994, 230.0, 834, 394069, 565, 14.623600099999749
566, 4.129286259021236, 48.884050790825064, 58.83725673080043, 0.2900943999999999, 110.0, 647, 394716, 566, 12.810336000000007
567, 4.6669194418894735, 48.82106280164654, 58.741825272436856, 0.2887183, 165.0, 882, 395598, 567, 18.339898100000028
568, 5.622811558772487, 48.863460546055, 58.77848621484645, 0.28727469999999994, 140.0, 722, 396320, 568, 13.778042400000231
569, 4.679015765344563, 48.82327261377944, 58.71047309534111, 0.2857599999999999, 160.0, 961, 397281, 569, 17.50339619999977
570, 2.8323504451817, 48.75639521366552, 58.64309131523843, 0.28409319999999993, 190.0, 891, 398172, 570, 15.604919099999734
571, 5.50034232132123, 48.896806147191434, 58.872955194873136, 0.2828062, 80.0, 539, 398711, 571, 10.728862800000115
572, 6.228538502539907, 48.94295884290867, 58.865634795875664, 0.2817036999999999, 135.0, 686, 399397, 572, 14.557956900000136
573, 3.4062759427408453, 48.73651620467808, 58.59318964386961, 0.28038159999999995, 275.0, 783, 400180, 573, 16.03044329999966
574, 4.102999880776476, 48.80233263613573, 58.716909243455575, 0.27907390000000004, 65.0, 670, 400850, 574, 13.4400270000001
575, 5.694292538214945, 48.68376780507834, 58.59224233183258, 0.2780649999999999, 60.0, 451, 401301, 575, 8.975861299999906
576, 3.8621537621781927, 48.72112380898817, 58.602899465319915, 0.27666189999999996, 555.0, 1108, 402409, 576, 19.749326599999677
577, 4.509064658606522, 48.75107032840262, 58.65074390030444, 0.2743849, 500.0, 1422, 403831, 577, 26.778573099999903
578, 4.755920641784337, 48.71247637260645, 58.56757355095866, 0.2721501999999999, 200.0, 1061, 404892, 578, 20.707668600000034
579, 3.969230017681239, 48.77567290176045, 58.67193424701691, 0.27024489999999995, 355.0, 1056, 405948, 579, 20.91363150000052
580, 4.054238625020261, 48.74250205341085, 58.64762488086221, 0.26844219999999996, 380.0, 947, 406895, 580, 18.912487900000087
581, 2.7338277119196066, 48.779979253219345, 58.65890852071471, 0.2672713, 30.0, 354, 407249, 581, 6.650198700000146
582, 2.5997151137859213, 48.70586309585979, 58.543071434034594, 0.26644779999999996, 70.0, 561, 407810, 582, 10.314875500000198
583, 3.5039313532559975, 48.797013556820225, 58.69468539087501, 0.2650815999999999, 265.0, 957, 408767, 583, 17.243416000000252
584, 5.232798928550333, 48.80773145702592, 58.78343242307376, 0.26351919999999995, 170.0, 779, 409546, 584, 14.264123500000096
585, 3.026571957031862, 48.40932812396676, 58.2011813494718, 0.26207379999999986, 135.0, 827, 410373, 585, 15.14918630000011
586, 5.722546533397099, 47.919189576007405, 57.695388761889035, 0.26068689999999994, 85.0, 714, 411087, 586, 11.942208600000413
587, 3.856907724684805, 47.93894917666001, 57.64542661311065, 0.2594557, 245.0, 654, 411741, 587, 10.85081430000082
588, 7.050219706207845, 48.114136670086836, 58.020854088763556, 0.25830099999999995, 135.0, 629, 412370, 588, 10.5048067000007
589, 5.042020493532613, 48.00831762049486, 57.794174865176885, 0.25713099999999994, 185.0, 671, 413041, 589, 11.180625500000133
590, 3.6122317773753183, 47.999676458026904, 57.725719394918485, 0.2555028999999999, 350.0, 1138, 414179, 590, 19.017052799999874
591, 3.7176065812588597, 48.0027252875891, 57.7196402913905, 0.25347699999999995, 405.0, 1113, 415292, 591, 18.53039549999994
592, 5.55818819754117, 48.05101356826015, 57.849362623758154, 0.2518308999999999, 95.0, 716, 416008, 592, 12.010367800000495
593, 3.629227562307814, 47.97749711675783, 57.65802861653688, 0.2503242999999999, 305.0, 958, 416966, 593, 16.098607799999627
594, 2.4793831701748648, 48.0203862452245, 57.70928154410897, 0.24913449999999987, 15.0, 364, 417330, 594, 6.128989699999693
595, 2.985538036106574, 48.04912772771418, 57.75547628958758, 0.24798879999999995, 285.0, 909, 418239, 595, 15.356276399999842
596, 3.9351305092374482, 48.03713518281223, 57.772493980450335, 0.24620409999999998, 390.0, 1074, 419313, 596, 18.187471299999743
597, 3.0866176607966165, 47.95246793408415, 57.65290734097039, 0.24419799999999992, 365.0, 1155, 420468, 597, 19.478380900000047
598, 5.202044239401025, 47.921282992528745, 57.657632804355735, 0.24227829999999995, 355.0, 978, 421446, 598, 17.30172020000009
599, 4.415952803043837, 47.841573925232616, 57.5328489839361, 0.2405970999999999, 465.0, 890, 422336, 599, 16.46743670000069
600, 4.855461067827788, 47.9540038760013, 57.70129263453546, 0.23918319999999998, 185.0, 681, 423017, 600, 12.749762999999803
601, 3.5532030450966623, 47.86967855947989, 57.536993990297674, 0.23796279999999984, 125.0, 675, 423692, 601, 12.563880499999868
602, 4.700245832135521, 47.86618626951084, 57.59162961965636, 0.2367630999999999, 145.0, 658, 424350, 602, 12.106700999999703
603, 5.00904317326019, 47.971490572427065, 57.67979407492485, 0.23522769999999996, 185.0, 1048, 425398, 603, 19.55579510000007
604, 4.1025557377331, 47.95629404112035, 57.660481092137935, 0.23327109999999995, 420.0, 1126, 426524, 604, 20.94905910000034
605, 4.408564760184743, 48.076457197724636, 57.82026167201736, 0.23192739999999992, 80.0, 367, 426891, 605, 6.842284300000756
606, 5.0484922654701005, 47.9744486311068, 57.713988300927156, 0.23106249999999995, 120.0, 594, 427485, 606, 11.069231899999977
607, 5.463872356982116, 47.8443150807576, 57.55101443371141, 0.22978089999999993, 170.0, 830, 428315, 607, 15.654421499999444
608, 4.064491156571179, 47.995576055744024, 57.65948958940144, 0.22846509999999995, 105.0, 632, 428947, 608, 11.828214399999524
609, 3.742510737581346, 47.70132324995395, 57.36964865359003, 0.22639330000000008, 525.0, 1670, 430617, 609, 31.217048299999988
610, 2.5786161335974183, 47.29600172946716, 56.83251348823828, 0.22442499999999999, 105.0, 517, 431134, 610, 9.75811690000046
611, 3.158807212696494, 47.31347830987746, 56.873837244724285, 0.22270419999999985, 570.0, 1395, 432529, 611, 26.157738799999606
612, 5.41759646678951, 47.319270735755964, 56.92743165735255, 0.22077549999999999, 130.0, 748, 433277, 612, 14.038600799999585
613, 3.473200529540746, 47.387690960728676, 56.9571433770852, 0.21916899999999995, 355.0, 1037, 434314, 613, 19.37242140000035
614, 4.965074132461527, 47.323142099240656, 56.96265100943378, 0.21762189999999987, 180.0, 682, 434996, 614, 12.894549300000108
615, 4.3017774443020445, 47.369210413119575, 56.95528650623602, 0.21625029999999992, 210.0, 842, 435838, 615, 15.988919800000076
616, 4.127568373155026, 47.370418466014776, 56.97043715307723, 0.2144529999999999, 475.0, 1155, 436993, 616, 21.894948099999965
617, 5.348958550192416, 47.43066333770752, 57.10282280349731, 0.2125134999999999, 245.0, 1000, 437993, 617, 18.90083290000075
618, 3.634052441570595, 47.319367014178795, 56.87969187379793, 0.21102399999999996, 150.0, 655, 438648, 618, 12.445884100000512
619, 2.9016251351567917, 47.408227044343946, 56.981904023885726, 0.2098584999999999, 150.0, 640, 439288, 619, 12.203361900000345
620, 3.7220095592456293, 47.36764333104174, 56.94144548126805, 0.20867139999999995, 100.0, 679, 439967, 620, 12.96854970000004
621, 2.996729813641477, 47.435889662983264, 57.04022460652289, 0.20757879999999992, 75.0, 535, 440502, 621, 10.463077200000043
622, 2.868230516086367, 47.30520881198476, 56.84739296016267, 0.2063718999999999, 90.0, 806, 441308, 622, 15.443093200000476
623, 4.3200174853793545, 47.39983962044299, 56.99500454596753, 0.20512179999999988, 125.0, 583, 441891, 623, 11.23269049999999
624, 4.956824086862017, 47.456046989720406, 57.08079334059825, 0.20344239999999988, 500.0, 1283, 443174, 624, 24.75316500000008
625, 4.169670597604632, 47.40153665805825, 56.99638805672874, 0.20143989999999992, 170.0, 942, 444116, 625, 18.160589000000073
626, 2.841751808892105, 47.26831166043554, 56.79871044873721, 0.2001358, 75.0, 507, 444623, 626, 9.849401200000102
627, 3.5460649800697412, 47.40364441891484, 57.02602038337189, 0.19903059999999997, 180.0, 721, 445344, 627, 13.857052399999702
628, 5.313624916012798, 47.407756038847424, 57.04998654683431, 0.19743669999999997, 390.0, 1050, 446394, 628, 20.3229637000004
629, 2.6653615925144374, 47.37370303240957, 56.938288398282786, 0.1959093999999999, 120.0, 647, 447041, 629, 12.567072100000587
630, 4.044858246890931, 47.28384303564165, 56.82985714273951, 0.19479339999999998, 100.0, 593, 447634, 630, 11.445583900000202
631, 5.406700840394115, 47.397531354749525, 57.08989790918426, 0.19382679999999985, 65.0, 481, 448115, 631, 9.384747900000548
632, 2.820843769883623, 47.41761448140047, 56.94475363128039, 0.19295289999999984, 140.0, 490, 448605, 632, 9.777888899999198
633, 3.7878926346549107, 47.36840553110559, 56.97315100065338, 0.191917, 95.0, 661, 449266, 633, 12.885363399999733
634, 3.9081772783565483, 47.36183213371882, 56.9301836657487, 0.19074339999999995, 140.0, 643, 449909, 634, 12.511980599999333
635, 3.604431330023708, 47.58510444904196, 57.198338639013265, 0.18940780000000004, 140.0, 841, 450750, 635, 16.503653799999483
636, 5.3371113584656795, 47.57313570047822, 57.25644700423531, 0.18817479999999992, 105.0, 529, 451279, 636, 10.414050599999428
637, 5.280790987381783, 47.692221608470284, 57.398595121717946, 0.18673839999999992, 375.0, 1067, 452346, 637, 20.940045000000282
638, 3.8484897318803055, 47.522113775905176, 57.113794020962615, 0.1849248999999999, 345.0, 948, 453294, 638, 18.518132900000637
639, 4.627183528818252, 47.48348922940833, 57.20787464680764, 0.1837467999999999, 30.0, 361, 453655, 639, 7.117181200000232
640, 4.656190334157923, 47.49406391774927, 57.104611158021896, 0.18280719999999995, 180.0, 683, 454338, 640, 13.398525999999947
641, 2.8135139824937303, 47.49112559494814, 57.067532055750846, 0.18181269999999994, 70.0, 422, 454760, 641, 8.401602400000229
642, 2.651485229041546, 47.526235896310986, 57.097155212596725, 0.18086769999999994, 110.0, 628, 455388, 642, 12.37591489999977
643, 6.826916919062066, 47.58045435181251, 57.32235654990643, 0.17936739999999993, 300.0, 1039, 456427, 643, 20.561122999999498
644, 2.9934198868304565, 47.51247962435385, 57.08176745268934, 0.17807319999999996, 75.0, 399, 456826, 644, 7.922004500000185
645, 2.742603658324918, 47.553113211795214, 57.14551353813789, 0.17675829999999995, 345.0, 1062, 457888, 645, 21.12386570000035
646, 11.355297346715531, 47.62885892536937, 57.37337210359084, 0.17543439999999996, 45.0, 409, 458297, 646, 8.157497199999852
647, 5.279435532433646, 47.70015123155382, 57.34772977206652, 0.17455599999999988, 70.0, 567, 458864, 647, 11.391116800000418
648, 8.05632960705877, 47.60131141056364, 57.23488931498606, 0.17344539999999992, 150.0, 667, 459531, 648, 13.364569600000323
649, 5.473435746192817, 47.542245313419656, 57.22322270183969, 0.17144739999999992, 220.0, 1553, 461084, 649, 31.13919950000036
650, 6.647846026417649, 47.623047222552, 57.330263206909045, 0.16922979999999993, 300.0, 911, 461995, 650, 18.257913600000393
651, 4.703568396248457, 47.57574741862645, 57.19551259037861, 0.16725429999999997, 315.0, 1284, 463279, 651, 25.769021899999643
652, 3.5621732920044806, 47.662711678481685, 57.2848776235813, 0.16536069999999994, 190.0, 820, 464099, 652, 16.597092599999996
653, 3.0381118571676975, 47.60501162084198, 57.21345760373378, 0.16326999999999992, 625.0, 1503, 465602, 653, 30.199651599999925
654, 4.655134204585907, 47.55039563799829, 57.19247533387865, 0.16094259999999985, 290.0, 1083, 466685, 654, 21.837415699999838
655, 6.376470923907222, 47.60324815063917, 57.26451361669253, 0.15871959999999993, 390.0, 1387, 468072, 655, 27.80598159999954
656, 3.146404502774013, 47.58206684025189, 57.220744970190616, 0.15688179999999993, 110.0, 655, 468727, 656, 13.314147500000217
657, 4.810237632272181, 47.56419784476303, 57.197879064857894, 0.15550299999999995, 430.0, 877, 469604, 657, 17.883441900000435
658, 2.6955293276200845, 47.45516272035905, 57.040682329826815, 0.15419259999999993, 110.0, 579, 470183, 658, 11.909539700000096
659, 5.676992889027544, 47.44512456394134, 57.082145229890386, 0.15282999999999997, 395.0, 935, 471118, 659, 18.9706769000004
660, 2.9726170762236337, 47.412617966831924, 56.96192171870465, 0.1510920999999999, 185.0, 996, 472114, 660, 20.31586299999981
661, 5.3331844895969045, 47.50775583795964, 57.13384476475834, 0.1492119999999999, 335.0, 1093, 473207, 661, 22.39353200000005
662, 5.125021192618512, 47.514593513477884, 57.181594424172914, 0.14759739999999996, 65.0, 701, 473908, 662, 14.466026499999316
663, 3.8741043812106875, 47.36589339772525, 56.9170072211383, 0.14643279999999997, 80.0, 593, 474501, 663, 12.35455649999949
664, 3.6311177813484075, 47.42164809937358, 57.02949088146583, 0.14510889999999993, 300.0, 878, 475379, 664, 18.10571179999988
665, 4.943715734902872, 47.54511701368046, 57.21701242289412, 0.14373009999999992, 145.0, 654, 476033, 665, 13.606340100000125
666, 5.374404202274819, 47.528772377315626, 57.13766175128044, 0.1425492999999999, 140.0, 658, 476691, 666, 13.572576900000058
667, 8.901064645868676, 47.52314098008716, 57.290165442546815, 0.14148549999999993, 5.0, 524, 477215, 667, 10.930140700000265
668, 3.992047385365107, 47.50352729883363, 57.12558949665555, 0.14045499999999994, 85.0, 621, 477836, 668, 12.85130720000052
669, 4.359547737651858, 47.47892057046123, 57.05207573024706, 0.13950459999999992, 65.0, 435, 478271, 669, 9.093223100000614
670, 5.667622858836448, 47.29504237141643, 56.92215336174954, 0.13834089999999993, 260.0, 858, 479129, 670, 17.913762000000133
671, 4.24224110185767, 47.4337674018391, 57.02575737297868, 0.13676319999999995, 325.0, 895, 480024, 671, 18.69090739999956
672, 5.56307383501027, 47.36999239174717, 56.96265584187335, 0.1352106999999999, 150.0, 830, 480854, 672, 17.340198099999725
673, 4.0326017840927815, 47.327524219119255, 56.91041078262057, 0.13345209999999993, 305.0, 1124, 481978, 673, 23.556316100000004
674, 3.0289789288249236, 47.34589845771032, 56.88420486450195, 0.13203279999999995, 30.0, 453, 482431, 674, 9.461454899999808
675, 3.012327354649703, 47.226598813798695, 56.80825061798096, 0.13130109999999992, 75.0, 360, 482791, 675, 7.602996999999959
676, 3.4701159474298215, 47.285957000920305, 56.82859470766683, 0.12995379999999995, 415.0, 1137, 483928, 676, 23.82659909999984
677, 3.3613788425783455, 47.269280298050745, 56.810855376414764, 0.12854439999999995, 60.0, 429, 484357, 677, 9.610118099999454
678, 4.551221686696937, 47.40541614488114, 57.03135427578475, 0.12722949999999994, 280.0, 1032, 485389, 678, 21.262992399999348
679, 4.622045076916467, 47.413457728143946, 57.022714418439726, 0.12509469999999992, 345.0, 1340, 486729, 679, 27.99020930000006
680, 5.160576483504712, 47.378782251606815, 57.01679868974547, 0.12289509999999995, 340.0, 1104, 487833, 680, 23.2450587000003
681, 4.659273770571824, 47.3803094564532, 56.931775559224356, 0.12089799999999994, 510.0, 1115, 488948, 681, 24.085333900000478
682, 2.7796207705224063, 47.36932960474435, 57.002353936853545, 0.11951110000000001, 20.0, 426, 489374, 682, 9.821348300000864
683, 4.120002697656552, 47.56606732474433, 57.2008824383771, 0.11815569999999992, 240.0, 1080, 490454, 683, 26.26219190000029
684, 4.0218786166729865, 47.64978423693501, 57.28397790760013, 0.1166760999999999, 65.0, 564, 491018, 684, 13.377823000000717
685, 6.8388285080318685, 47.80505521252601, 57.49197511907597, 0.11554659999999994, 160.0, 691, 491709, 685, 14.86068399999931
686, 5.072215026080772, 47.80417547121153, 57.4930694601038, 0.11459709999999994, 125.0, 364, 492073, 686, 7.739284200000839
687, 4.25216524632644, 47.67756087691696, 57.31340156986467, 0.11334609999999992, 285.0, 1026, 493099, 687, 22.8710200000005
688, 5.130732025195159, 47.694413966246515, 57.373314500729435, 0.11205459999999992, 75.0, 409, 493508, 688, 8.865648599999986
689, 3.986033229429023, 47.73516665580578, 57.38068322203213, 0.1110879999999999, 145.0, 665, 494173, 689, 13.447424499999215
690, 6.2890448903975384, 47.805903842051826, 57.51909562945366, 0.11014389999999996, 25.0, 384, 494557, 690, 7.745487000000139
691, 4.644249613204085, 47.775663306551145, 57.49369122594077, 0.10922859999999991, 110.0, 633, 495190, 691, 13.23147489999974
692, 4.136738197935274, 47.75254713982824, 57.44834985356031, 0.10804419999999987, 170.0, 683, 495873, 692, 14.439636100000826
693, 8.130657909021258, 47.79251484283029, 57.51865942968081, 0.10644399999999996, 320.0, 1095, 496968, 693, 21.749301199999536
694, 4.195528574685609, 47.82665226213449, 57.489245465641766, 0.10495269999999995, 85.0, 562, 497530, 694, 11.398228600000039
695, 4.28767847187588, 47.80190559235447, 57.49668861513327, 0.1039491999999999, 105.0, 553, 498083, 695, 11.160114499999509
696, 6.358094426228182, 47.85372678102368, 57.63016494416843, 0.10283499999999986, 135.0, 685, 498768, 696, 17.066995700000007
697, 5.1883997268958115, 47.78757698263898, 57.437014603241444, 0.10141389999999993, 145.0, 894, 499662, 697, 20.067309000000023
698, 2.9050953905948957, 47.45795288535607, 57.04058780183024, 0.10020260078585502, 80.0, 509, 500171, 698, 10.86486430000059
699, 3.913670033639347, 47.2966527577993, 56.869547776918154, 0.1000000000000001, 120.0, 740, 500911, 699, 15.542252099999132
700, 5.287195674505197, 47.336213762921176, 56.941704441998624, 0.0999999999999978, 325.0, 1229, 502140, 700, 26.944195400000353
701, 2.753780712184166, 47.30728407725848, 56.84125190910803, 0.10000000000000085, 60.0, 477, 502617, 701, 10.496364200000244
702, 3.880600250888579, 47.11796370276524, 56.64816586963414, 0.10000000000000098, 165.0, 606, 503223, 702, 16.20815269999912
703, 5.651094036915305, 47.322742761552576, 56.912259815510296, 0.1000000000000001, 260.0, 739, 503962, 703, 20.989022400000067
704, 6.171508713796431, 47.274626624827484, 56.90573719245236, 0.09999999999999795, 380.0, 1176, 505138, 704, 25.443565799999305
705, 4.9255131859684465, 47.25917918646513, 56.8535327753222, 0.10000000000000098, 95.0, 603, 505741, 705, 12.783088499999394
706, 4.3780206159624475, 47.21263043169832, 56.77163638093064, 0.09999999999999809, 385.0, 1134, 506875, 706, 22.979318200000307
707, 3.9731867572228454, 47.30449219955795, 56.84108777429866, 0.10000000000000046, 185.0, 696, 507571, 707, 14.153204199999891
708, 3.0842674832189716, 47.17618125179865, 56.6845076365693, 0.09999999999999895, 375.0, 923, 508494, 708, 19.040372800000114
709, 4.121459960993414, 47.218463725936346, 56.76685829949871, 0.10000000000000091, 95.0, 533, 509027, 709, 10.847638299999744
710, 3.8815201964332826, 47.173936746738576, 56.73619801909835, 0.09999999999999927, 225.0, 864, 509891, 710, 17.680157300000246
711, 3.72100176741607, 47.42758017769695, 57.01577768813085, 0.10000000000000056, 115.0, 685, 510576, 711, 13.827700199999526
712, 4.616163483010003, 47.49389168279088, 57.113451450025266, 0.10000000000000075, 90.0, 402, 510978, 712, 8.595515199999681
713, 4.3119995913324125, 47.45959169794825, 57.071873732690534, 0.09999999999999878, 320.0, 956, 511934, 713, 21.012910399999782
714, 3.790733362240422, 47.38608396970309, 56.95668447934664, 0.09999999999999916, 250.0, 884, 512818, 714, 19.068990799999483
715, 4.477053582014335, 47.370450220137926, 56.94706906644528, 0.100000000000001, 115.0, 638, 513456, 715, 12.908554100000401
716, 4.5577338270782946, 47.360666773396154, 56.94833420784243, 0.09999999999999777, 495.0, 1240, 514696, 716, 25.708451099999365
717, 5.615227434285513, 47.37874567978025, 57.022736421720246, 0.1000000000000009, 50.0, 508, 515204, 717, 10.334699
718, 7.906609498569505, 47.57952670437834, 57.275398270531156, 0.09999999999999794, 325.0, 1182, 516386, 718, 24.188213700000233
719, 8.861973471645461, 47.560047132927075, 57.27035770081637, 0.10000000000000082, 150.0, 456, 516842, 719, 9.300538200000119
720, 5.192267480192903, 47.439989961592175, 57.02509061930566, 0.09999999999999909, 145.0, 895, 517737, 720, 18.259145799999715
721, 4.841508431952045, 47.4648356479389, 57.0493483529494, 0.10000000000000055, 110.0, 686, 518423, 721, 14.538097799999377
722, 5.333763020098892, 47.43801076903598, 56.99228081448388, 0.10000000000000091, 75.0, 524, 518947, 722, 11.563091500000155
723, 6.804261017572228, 47.5956050626081, 57.23524517799491, 0.10000000000000075, 55.0, 402, 519349, 723, 8.650074199999835
724, 4.542466908081894, 47.385091560247496, 56.952526776759875, 0.09999999999999933, 185.0, 853, 520202, 724, 17.81843040000058
725, 4.1652502223770735, 47.48637080402072, 57.070527323101025, 0.10000000000000095, 100.0, 569, 520771, 725, 12.159036899999592
726, 2.988125533881093, 47.43614369785919, 57.01705920326961, 0.09999999999999962, 565.0, 807, 521578, 726, 16.774590699999862
727, 6.219699193713486, 47.49009650094168, 57.11666954497588, 0.10000000000000088, 120.0, 651, 522229, 727, 13.710561200000484
728, 5.0302922399793735, 47.541526200075666, 57.20796782842101, 0.10000000000000066, 65.0, 353, 522582, 728, 7.465686800000185
729, 4.190927043565059, 47.54295341847307, 57.11747827772367, 0.09999999999999885, 245.0, 944, 523526, 729, 20.513853599999493
730, 3.8382386340883365, 47.49511611235497, 57.083675884188246, 0.09999999999999817, 295.0, 1107, 524633, 730, 23.038607100000263
731, 6.326069679567701, 47.493212217398785, 57.142517591182425, 0.09999999999999855, 350.0, 1012, 525645, 731, 21.54317599999922
732, 4.578599923878693, 47.52725474154476, 57.11634550886464, 0.09999999999999817, 360.0, 1108, 526753, 732, 23.657427199999802
733, 4.702997143421736, 47.584519418080646, 57.178613360722856, 0.10000000000000026, 105.0, 720, 527473, 733, 16.15668199999982
734, 3.268833013466221, 47.60347178552729, 57.26697433261576, 0.10000000000000096, 40.0, 581, 528054, 734, 12.889760000000024
735, 5.008217747640057, 47.59626721844231, 57.2210261944643, 0.10000000000000073, 25.0, 388, 528442, 735, 8.458568600000035
736, 5.237030437334203, 47.58259288324833, 57.192130009930835, 0.09999999999999891, 185.0, 931, 529373, 736, 21.818947099999605
737, 6.883328221216101, 47.54588706471095, 57.177965413744204, 0.10000000000000098, 155.0, 642, 530015, 737, 14.019010699999853
738, 3.1182430772054377, 47.17296285821934, 56.65820507088093, 0.09999999999999971, 115.0, 792, 530807, 738, 19.187122600000293
739, 3.9491607605824215, 47.255050103742995, 56.84597973596482, 0.09999999999999823, 315.0, 1092, 531899, 739, 23.686409200000526
740, 7.591439481915334, 47.35641630497787, 57.02236128412355, 0.09999999999999817, 530.0, 1109, 533008, 740, 23.70520470000065
741, 5.926407810203474, 47.26449693156731, 56.8637288902052, 0.09999999999999877, 125.0, 959, 533967, 741, 20.363859400000365
742, 3.781080880147088, 47.243836790650754, 56.77961008260538, 0.09999999999999902, 305.0, 910, 534877, 742, 19.669657399999778
743, 7.539873280653767, 47.323755239349566, 57.02281306148355, 0.10000000000000053, 15.0, 306, 535183, 743, 7.274191299999984
744, 3.616920222291829, 47.22574903063206, 56.75013423583668, 0.09999999999999985, 220.0, 772, 535955, 744, 17.434376500000326
745, 5.1622616306682225, 47.33268510727655, 56.89733333328143, 0.10000000000000096, 35.0, 588, 536543, 745, 12.553517199999987
746, 4.484524451690701, 47.240224703223305, 56.79237562365237, 0.10000000000000082, 60.0, 452, 536995, 746, 9.907083000000057
747, 5.153881813937806, 47.2442995839452, 56.82845280889593, 0.10000000000000067, 150.0, 673, 537668, 747, 14.998091499999646
748, 4.911797283702754, 47.25019996283933, 56.780340056742375, 0.09999999999999923, 165.0, 871, 538539, 748, 20.172487999999248
749, 4.334287539436167, 47.35249012874892, 56.96750991182973, 0.09999999999999858, 445.0, 1004, 539543, 749, 25.940061900000728
750, 4.456859063647658, 46.999784845182795, 56.51159731301562, 0.09999999999999763, 555.0, 1295, 540838, 750, 32.316493000000264
751, 3.166751765476241, 46.80721189172228, 56.244827407499706, 0.10000000000000067, 25.0, 362, 541200, 751, 8.006669200000033
752, 4.660284800704013, 46.79039536787001, 56.237900555858296, 0.09999999999999905, 335.0, 905, 542105, 752, 19.57411300000058
753, 6.520175387340364, 46.72778508097855, 56.22488999120968, 0.099999999999998, 240.0, 1164, 543269, 753, 25.272510200000397
754, 4.134334477952847, 46.776709048547474, 56.19385834275005, 0.1000000000000008, 115.0, 428, 543697, 754, 9.517949999999473
755, 3.205269814558057, 46.85272143461523, 56.332448531298745, 0.09999999999999784, 375.0, 1212, 544909, 755, 26.697382199999993
756, 4.064140123238129, 46.79096595506023, 56.26548759202312, 0.09999999999999834, 245.0, 1064, 545973, 756, 23.568908800000827
757, 3.5141325791191065, 46.7286162590145, 56.17081004968968, 0.0999999999999978, 300.0, 1227, 547200, 757, 27.019941600000493
758, 4.515092057149961, 46.77178038638901, 56.25384775670876, 0.09999999999999858, 300.0, 1004, 548204, 758, 22.23214949999965
759, 4.8513815662611215, 46.75169086874577, 56.258236132170026, 0.099999999999999, 165.0, 912, 549116, 759, 20.159735700000056
760, 4.2647281369734635, 46.77779271592309, 56.24102896735782, 0.09999999999999895, 230.0, 924, 550040, 760, 20.386027499999727
761, 3.224669250643369, 46.73861004727558, 56.1384065202139, 0.1000000000000009, 25.0, 515, 550555, 761, 11.994403200000306
762, 3.689390420941847, 46.76646014965451, 56.255837836854106, 0.0999999999999997, 160.0, 794, 551349, 762, 19.346945100000084
763, 5.758687138068613, 46.87473731066184, 56.410989194193846, 0.09999999999999884, 215.0, 945, 552294, 763, 22.766134100000272
764, 5.643673923381535, 46.723277090792344, 56.215862616210025, 0.09999999999999964, 160.0, 803, 553097, 764, 18.154048100000182
765, 2.945565367933959, 46.76616919009391, 56.17754348494562, 0.09999999999999992, 270.0, 762, 553859, 765, 17.82181120000041
766, 2.8399909805683863, 46.80633266663654, 56.264630982370086, 0.10000000000000084, 25.0, 462, 554321, 766, 10.184995399999934
767, 3.903829559676228, 46.78805503224939, 56.275201184962825, 0.09999999999999866, 300.0, 984, 555305, 767, 22.330940999999257
768, 5.045423984967294, 46.71046621604044, 56.18580189272354, 0.09999999999999899, 165.0, 915, 556220, 768, 20.8606963000002
769, 7.049284586855093, 46.85499220134831, 56.35477962013052, 0.10000000000000085, 80.0, 476, 556696, 769, 10.69002029999956
770, 4.0526111219606715, 46.75732939970409, 56.22074346677631, 0.0999999999999981, 370.0, 1128, 557824, 770, 25.429872699999578
771, 4.242528148883365, 46.80513750382656, 56.26794466799405, 0.09999999999999874, 275.0, 965, 558789, 771, 23.613504699999794
772, 5.211429209677045, 46.775883079900815, 56.2571051461356, 0.09999999999999798, 280.0, 1169, 559958, 772, 27.055677500000456
773, 3.5597394290744075, 46.482468954932614, 55.85219840750789, 0.09999999999999998, 85.0, 755, 560713, 773, 17.506977999999435
774, 3.3366996646042053, 46.4817079602755, 55.87116470043476, 0.09999999999999762, 670.0, 1300, 562013, 774, 29.735382400000162
775, 4.240926514204361, 46.386463248301645, 55.77956313173711, 0.09999999999999896, 225.0, 919, 562932, 775, 21.403211499999998
776, 4.306420400969028, 46.46082140231243, 55.844696357408665, 0.10000000000000092, 125.0, 647, 563579, 776, 14.888123499999892
777, 5.622932923243302, 46.614597182227314, 56.13766492793084, 0.10000000000000028, 195.0, 717, 564296, 777, 16.402329599999575
778, 4.686204882359505, 46.407444262695314, 55.77604843444824, 0.09999999999999774, 425.0, 1250, 565546, 778, 28.690425400000095
779, 5.575448459148407, 46.43290129852295, 55.88339557647705, 0.10000000000000088, 5.0, 500, 566046, 779, 11.357487500000389
780, 7.708949428481551, 46.59471126703116, 56.097625787441544, 0.10000000000000077, 105.0, 416, 566462, 780, 9.648626100000001
781, 4.868213813588412, 46.47835920409737, 55.87666488249769, 0.09999999999999726, 370.0, 1458, 567920, 781, 35.168787700000394
782, 6.011666517520845, 46.52219905539448, 55.93862270306408, 0.09999999999999823, 425.0, 1094, 569014, 782, 26.43815749999976
783, 6.145484589450941, 46.60261462354285, 56.05917100681095, 0.10000000000000099, 75.0, 635, 569649, 783, 14.74049080000077
784, 5.621983871852756, 46.5957429763052, 56.06100057835021, 0.09999999999999994, 160.0, 761, 570410, 784, 17.651766299999508
785, 6.036930192009058, 46.410763156335086, 55.80561755035097, 0.09999999999999785, 440.0, 1208, 571618, 785, 27.812809600000037
786, 6.061342804905093, 46.5597619619983, 56.00041098901403, 0.10000000000000057, 95.0, 684, 572302, 786, 15.362553800000569
787, 3.785619327460813, 46.42432637056645, 55.75710235283389, 0.09999999999999848, 265.0, 1026, 573328, 787, 23.610466900000574
788, 5.07109068513779, 46.4760085838784, 55.84551369645588, 0.10000000000000099, 125.0, 622, 573950, 788, 14.517209200000252
789, 3.969519211716522, 46.436513070973746, 55.80060307713074, 0.10000000000000078, 95.0, 662, 574612, 789, 15.402677699999913
790, 3.8637921668532855, 46.43430898721936, 55.823199011875715, 0.09999999999999892, 385.0, 927, 575539, 790, 21.372221100000388
791, 4.237772078391003, 46.328855315498686, 55.70326434702113, 0.10000000000000052, 165.0, 690, 576229, 791, 15.974142999999458
792, 6.861493802315016, 46.482014236936145, 55.931790151413836, 0.10000000000000099, 135.0, 628, 576857, 792, 14.988677999999709
793, 2.79650324751009, 46.34905769378142, 55.67746235158778, 0.09999999999999992, 200.0, 763, 577620, 793, 17.630673700000443
794, 3.2918148579873465, 46.36425376370695, 55.67955136797917, 0.10000000000000028, 120.0, 717, 578337, 794, 17.145389199999954
795, 4.077052087634334, 46.334501104534795, 55.677513380470515, 0.10000000000000099, 85.0, 636, 578973, 795, 14.93939539999974
796, 6.598206674213548, 46.597796964182436, 56.10093794887506, 0.1000000000000009, 115.0, 515, 579488, 796, 12.201991599999928
797, 4.915508479162385, 46.48762571018286, 55.88442657650672, 0.09999999999999792, 385.0, 1187, 580675, 797, 29.049352699999872
798, 5.3922368014885365, 46.61141779839754, 56.07469884161956, 0.10000000000000003, 75.0, 749, 581424, 798, 17.883300000000418
799, 4.826405979027907, 46.52848470806174, 55.947622746454606, 0.10000000000000078, 75.0, 661, 582085, 799, 15.51633319999928
800, 3.690917695349884, 46.627070348666145, 56.016408351597875, 0.0999999999999979, 280.0, 1194, 583279, 800, 27.673200400000496
801, 3.7028320031662436, 46.631427552226526, 56.03503393157711, 0.09999999999999928, 145.0, 861, 584140, 801, 20.068474900000183
802, 4.3946177725406255, 46.5955229695638, 56.039095716289445, 0.09999999999999767, 410.0, 1275, 585415, 802, 29.754293599999983
803, 5.259844375260778, 46.56678682275721, 56.00978034766945, 0.10000000000000069, 25.0, 370, 585785, 803, 8.778450599999815
804, 4.400515425865926, 46.57961711042402, 56.017591819717715, 0.09999999999999941, 125.0, 839, 586624, 804, 20.461073800000122
805, 5.4274927626284875, 46.59225452810094, 56.0871974360622, 0.09999999999999874, 210.0, 966, 587590, 805, 24.395485400000325
806, 5.691491026309768, 46.641960041536706, 56.066493036193265, 0.10000000000000091, 130.0, 521, 588111, 806, 12.35653100000036
807, 4.572330392255034, 46.59713184097967, 56.015476197627414, 0.09999999999999651, 460.0, 1961, 590072, 807, 52.40292969999973
808, 3.739315941849444, 47.38816182075838, 56.936569205636985, 0.09999999999999892, 175.0, 927, 590999, 808, 24.351093700000092
809, 2.7374043409503246, 47.31346097103385, 56.811861740526304, 0.1000000000000009, 100.0, 516, 591515, 809, 12.534903900000245
810, 3.0647334037403735, 47.46346107460338, 57.007339872552095, 0.10000000000000064, 180.0, 676, 592191, 810, 18.09167239999988
811, 4.054120041643209, 47.243478747733256, 56.7951668040362, 0.10000000000000099, 80.0, 629, 592820, 811, 15.154009799999585
812, 5.419410094470083, 47.45926981486246, 57.093880613406974, 0.09999999999999859, 220.0, 1002, 593822, 812, 29.480683799999497
813, 5.8978243908513965, 47.34898993565046, 56.928501260691675, 0.10000000000000073, 135.0, 667, 594489, 813, 17.270751199999722
814, 4.121978147282745, 47.41475955693409, 56.98423877292209, 0.10000000000000088, 130.0, 495, 594984, 814, 13.678948699999637
815, 3.8371402825260983, 47.3783231757153, 56.95531387329102, 0.09999999999999923, 350.0, 870, 595854, 815, 21.885154700000385
816, 5.576019980765524, 47.4796130225772, 57.0976566133045, 0.10000000000000091, 40.0, 525, 596379, 816, 13.895885399999315
817, 5.435112364040125, 47.380767961247884, 56.99344121872636, 0.09999999999999842, 555.0, 1043, 597422, 817, 26.88594440000088
818, 3.485700563017118, 47.310789003720714, 56.882609750741345, 0.09999999999999787, 310.0, 1204, 598626, 818, 30.89902649999931
819, 4.239692233652475, 47.43632934754153, 57.09144053018716, 0.10000000000000088, 145.0, 498, 599124, 819, 14.625163499998962
820, 3.6865307007835604, 47.4823677663728, 57.05752337598425, 0.10000000000000099, 155.0, 635, 599759, 820, 17.374563999999737
821, 3.005407867761089, 47.72082653465581, 57.30614673442111, 0.09999999999999927, 275.0, 863, 600622, 821, 25.52395289999913
822, 4.876126054227126, 47.81937035093916, 57.51284852940986, 0.09999999999999758, 480.0, 1316, 601938, 822, 33.88508179999917
823, 3.6659854431613463, 47.819761114927076, 57.456212646332546, 0.09999999999999963, 165.0, 804, 602742, 823, 20.532874399999855
824, 5.197678970083213, 47.890458432711085, 57.55710204295623, 0.0999999999999987, 140.0, 975, 603717, 824, 25.037416600000142
825, 6.988525581346754, 47.813907606510824, 57.49705708970772, 0.10000000000000059, 75.0, 682, 604399, 825, 19.5472295999989
826, 2.40653273044289, 47.77115355781887, 57.4301231937132, 0.10000000000000064, 50.0, 345, 604744, 826, 11.364293500000713
827, 6.923077287641297, 47.92430522728434, 57.680117821556955, 0.09999999999999781, 535.0, 1223, 605967, 827, 33.15940000000046
828, 4.542827777649085, 47.76096847168584, 57.391009923639096, 0.09999999999999971, 435.0, 793, 606760, 828, 23.12796619999972
829, 4.447680188827432, 47.92652747219599, 57.654532072664196, 0.09999999999999785, 260.0, 1211, 607971, 829, 35.34199509999962
830, 3.03952191940867, 47.88587493896485, 57.535940586970405, 0.1000000000000009, 165.0, 650, 608621, 830, 17.215309600000182
831, 6.706287487876847, 47.92055003383929, 57.63019663000067, 0.09999999999999792, 445.0, 1187, 609808, 831, 31.911962300000596
832, 3.8857868055366658, 47.533831923755244, 57.12160072200136, 0.09999999999999787, 435.0, 1206, 611014, 832, 35.662791599999764
833, 6.153472751928968, 47.27761858921688, 56.835951397833796, 0.10000000000000095, 75.0, 569, 611583, 833, 17.244736299999204
834, 3.9949944512603954, 47.34717556270393, 56.905054833437944, 0.09999999999999792, 215.0, 1184, 612767, 834, 33.65665269999954
835, 4.435957515025666, 47.36986729321559, 56.93761321325987, 0.10000000000000023, 85.0, 724, 613491, 835, 19.445915700000114
836, 2.980491302728205, 47.340498070967826, 56.85430459617672, 0.10000000000000074, 135.0, 665, 614156, 836, 17.933112700000493
837, 3.558506352738511, 47.4178221229169, 56.950017898888895, 0.10000000000000046, 155.0, 695, 614851, 837, 18.692370500000834
838, 3.82961466220709, 47.365224231671796, 56.911777053990676, 0.09999999999999923, 150.0, 871, 615722, 838, 21.333960600000864
839, 4.877436762600276, 47.36946015918416, 56.96743393311841, 0.09999999999999844, 295.0, 1038, 616760, 839, 24.575108700000783
840, 4.985119509710694, 47.30717042140697, 56.86454971594745, 0.09999999999999826, 275.0, 1085, 617845, 840, 29.793948099999398
841, 3.478714982536074, 47.306118987568034, 56.834552199241266, 0.09999999999999819, 525.0, 1106, 618951, 841, 33.01699370000097
842, 6.46547961345533, 47.33702292465582, 57.0111815140887, 0.09999999999999849, 345.0, 1025, 619976, 842, 26.71426260000044
843, 5.148162800082751, 46.61397693277683, 56.028496746629884, 0.10000000000000087, 165.0, 653, 620629, 843, 17.1006653000004
844, 4.312129410146888, 46.81283958285463, 56.24733248941259, 0.09999999999999991, 250.0, 765, 621394, 844, 21.95991529999992
845, 4.620893809997993, 46.74592780723846, 56.15943621903015, 0.09999999999999816, 335.0, 1112, 622506, 845, 31.364524900000106
846, 3.991791865421099, 46.601826153618546, 55.990004354953065, 0.10000000000000063, 100.0, 677, 623183, 846, 18.498580600000423
847, 2.799868729748002, 46.74435333066153, 56.13885194090403, 0.09999999999999758, 500.0, 1314, 624497, 847, 39.04223069999898
848, 3.1798656313819507, 46.767861864830564, 56.21016096499892, 0.09999999999999895, 320.0, 922, 625419, 848, 25.15024960000119
849, 4.896184879282247, 46.77824916010318, 56.19118318419525, 0.10000000000000064, 80.0, 345, 625764, 849, 8.873582100000931
850, 5.003084935824823, 46.670972258643765, 56.17469834437412, 0.09999999999999905, 320.0, 904, 626668, 850, 25.480358000000706
851, 3.2138897514483635, 46.76846412990404, 56.15417432785034, 0.10000000000000094, 140.0, 552, 627220, 851, 14.752755100000286
852, 4.775855765514302, 46.774239890358665, 56.20439672759085, 0.0999999999999995, 205.0, 825, 628045, 852, 23.107010300000184
853, 5.5975410688025224, 46.773864623038996, 56.19020288311779, 0.10000000000000091, 60.0, 527, 628572, 853, 14.92534489999889
854, 4.881377519509476, 46.82426442403552, 56.28440371995178, 0.10000000000000069, 120.0, 671, 629243, 854, 20.348791799999162
855, 5.3068345391383716, 46.56045936100067, 55.991907767644, 0.09999999999999772, 195.0, 1260, 630503, 855, 37.38001509999958
856, 2.830723202051112, 46.40631177538417, 55.72684137666107, 0.09999999999999903, 100.0, 907, 631410, 856, 24.500169000000824
857, 3.424704463450337, 46.49568077634057, 55.844354035326994, 0.10000000000000098, 60.0, 642, 632052, 857, 17.369663800000126
858, 3.1566642958033193, 46.44012836078266, 55.75990960061013, 0.10000000000000094, 105.0, 555, 632607, 858, 14.95827190000091
859, 3.7341285729548304, 46.36870791733528, 55.716850588850335, 0.1000000000000006, 145.0, 681, 633288, 859, 18.446211100001165
860, 6.887462933331728, 46.42623125076294, 55.85223897171021, 0.09999999999999859, 245.0, 1000, 634288, 860, 26.8087891999985
861, 2.983555150385256, 46.42080238624855, 55.75692741111473, 0.10000000000000066, 175.0, 675, 634963, 861, 18.218461799999204
862, 4.509891097513189, 46.510735665210035, 55.948827265188896, 0.09999999999999769, 300.0, 1268, 636231, 862, 34.22007090000079
863, 5.134478942777365, 46.428288571246256, 55.8495231933924, 0.09999999999999895, 240.0, 924, 637155, 863, 24.96254190000036
864, 6.047144976903838, 46.315688741946694, 55.67479370069052, 0.09999999999999881, 205.0, 951, 638106, 864, 25.836620199999743
865, 3.2916393901866217, 46.48697497905829, 55.81056247002039, 0.10000000000000099, 140.0, 624, 638730, 865, 17.353242299999692
866, 3.8717241255636847, 46.4523152400644, 55.80653151348176, 0.09999999999999762, 330.0, 1297, 640027, 866, 39.91825939999944
867, 4.868534096436626, 46.034989367601725, 55.313953958941426, 0.09999999999999865, 155.0, 989, 641016, 867, 33.06555320000007
868, 8.943991661469672, 46.24747306100517, 55.63741721139253, 0.10000000000000003, 170.0, 749, 641765, 868, 22.3055803999996
869, 4.653126757959554, 46.117221455861966, 55.39220395881754, 0.10000000000000062, 110.0, 679, 642444, 869, 20.649174899999707
870, 4.733485083181289, 46.09589389208881, 55.41559476358964, 0.09999999999999883, 190.0, 947, 643391, 870, 29.2064074000009
871, 2.9127703886179677, 46.17180617599242, 55.41015539138647, 0.10000000000000099, 100.0, 622, 644013, 871, 19.507770399999572
872, 4.1628210891141935, 45.97082373181229, 55.227907148225825, 0.09999999999999816, 380.0, 1113, 645126, 872, 33.85992609999994
873, 3.926844411180834, 46.07366492293663, 55.34982076364944, 0.10000000000000019, 145.0, 729, 645855, 873, 21.089992100000018
874, 4.3486292673096765, 46.05905449989356, 55.378967773585885, 0.09999999999999779, 630.0, 1234, 647089, 874, 35.574349299999085
875, 4.758315791506224, 46.063328382264764, 55.36769270691023, 0.09999999999999801, 240.0, 1158, 648247, 875, 35.66648249999889
876, 4.026568985099778, 46.098907447663535, 55.40303691571082, 0.09999999999999801, 350.0, 1159, 649406, 876, 33.090773300000365
877, 3.8324987945120657, 45.82781278019976, 55.0959771344119, 0.09999999999999978, 155.0, 782, 650188, 877, 22.031030299998747
878, 4.484980141487242, 45.19593109865418, 54.300741913542964, 0.09999999999999899, 315.0, 914, 651102, 878, 25.57349129999966
879, 5.900002912076753, 45.23062458703684, 54.424925565719604, 0.10000000000000053, 190.0, 688, 651790, 879, 21.374457800000528
880, 4.292751878111778, 45.13302899744802, 54.23654834923142, 0.0999999999999986, 375.0, 998, 652788, 880, 30.960531500000798
881, 7.426042386114737, 45.42600414624538, 54.610725876319044, 0.10000000000000078, 70.0, 427, 653215, 881, 12.534429299999829
882, 3.821727587613317, 45.18035063619916, 54.298301949624715, 0.10000000000000048, 115.0, 694, 653909, 882, 20.09960510000019
883, 4.656569798206456, 45.23711039780957, 54.353992501383885, 0.09999999999999981, 275.0, 778, 654687, 883, 21.127672099999472
884, 5.1019764916493076, 45.15795851398159, 54.29127220849733, 0.10000000000000096, 125.0, 592, 655279, 884, 16.812839400001394
885, 3.861312516558338, 45.209365860077455, 54.30178463818802, 0.10000000000000088, 25.0, 497, 655776, 885, 13.969282600000952
886, 4.6541071272554015, 45.12531772272547, 54.23254354572829, 0.10000000000000028, 75.0, 716, 656492, 886, 20.12914710000041
887, 5.104746552428534, 45.1536855404876, 54.304919532953306, 0.0999999999999983, 255.0, 1075, 657567, 887, 30.15136480000001
888, 2.91268415066859, 45.17514615929645, 54.246669692993166, 0.09999999999999803, 255.0, 1150, 658717, 888, 33.09221080000134
889, 4.44065188973779, 45.14491642881205, 54.26275768681354, 0.09999999999999905, 360.0, 903, 659620, 889, 26.300672200000918
890, 4.890322021098607, 44.62439434803108, 53.61727969938938, 0.09999999999999751, 765.0, 1345, 660965, 890, 39.0556059999999
891, 6.4770204399159566, 44.4597288869494, 53.46767910364052, 0.09999999999999813, 480.0, 1122, 662087, 891, 32.33052789999965
892, 6.176157942058356, 44.472306283825006, 53.50905683248863, 0.10000000000000094, 55.0, 561, 662648, 892, 16.38574030000018
893, 7.231853736653214, 44.35457149323963, 53.29928274608794, 0.0999999999999984, 350.0, 1050, 663698, 893, 28.537464900000487
894, 5.060567083859431, 44.37126035179947, 53.306852134552486, 0.0999999999999988, 215.0, 953, 664651, 894, 25.613196599999355
895, 5.233487310310672, 44.52558004053919, 53.501178084777926, 0.100000000000001, 100.0, 639, 665290, 895, 17.15857169999981
896, 4.912139763168041, 44.307277326135825, 53.230545453577236, 0.10000000000000006, 170.0, 745, 666035, 896, 19.914586700000655
897, 6.335883805161372, 44.39874572825814, 53.405369430527614, 0.09999999999999835, 215.0, 1061, 667096, 897, 28.44850199999928
898, 3.698811990585865, 44.381005315652956, 53.28683167603922, 0.09999999999999871, 175.0, 971, 668067, 898, 26.126634399999602
899, 2.760714964344475, 44.42403993101837, 53.32378423047929, 0.10000000000000027, 120.0, 718, 668785, 899, 19.281128500000705
900, 3.135922088560998, 44.37787398329293, 53.29370470377925, 0.10000000000000099, 180.0, 634, 669419, 900, 17.193689199999426
901, 4.810477313020187, 44.391323703882584, 53.40679468471263, 0.10000000000000099, 125.0, 621, 670040, 901, 16.737437100000534
902, 4.713474809832405, 44.171802811324596, 53.159352734684944, 0.1000000000000009, 105.0, 512, 670552, 902, 13.861503699999957
903, 4.957250246484029, 44.084983261347155, 52.953436991229, 0.1000000000000004, 75.0, 703, 671255, 903, 18.840120599999864
904, 4.545117204517987, 44.08056050861786, 52.9925243157342, 0.09999999999999817, 270.0, 1108, 672363, 904, 29.920093700000507
905, 4.394145299260523, 44.100240258609546, 53.00124126322129, 0.10000000000000075, 60.0, 408, 672771, 905, 11.410867399999916
906, 4.531854872174426, 44.11174990493382, 52.98750182132739, 0.09999999999999838, 250.0, 1051, 673822, 906, 31.679974700000457
907, 5.54048616568408, 44.04333847657711, 52.952025371850574, 0.09999999999999688, 500.0, 1671, 675493, 907, 50.561259100000825
908, 3.937940986375177, 44.04612841650066, 52.92253420858081, 0.09999999999999869, 180.0, 977, 676470, 908, 29.839701000000787
909, 4.094711717084158, 44.10145723631056, 52.988013864421156, 0.10000000000000046, 110.0, 695, 677165, 909, 21.072485400000005
910, 5.509886651337907, 44.11098737619361, 53.02290347644261, 0.09999999999999977, 180.0, 784, 677949, 910, 23.964132700000846
911, 4.199347288083331, 43.951398584577774, 52.78396750673836, 0.10000000000000092, 110.0, 648, 678597, 911, 19.885067999999592
912, 3.8131820531616434, 44.11710961845651, 52.96889139290674, 0.09999999999999848, 185.0, 1026, 679623, 912, 31.433174400001008
913, 3.5906031235921225, 44.24956611599691, 53.12477092322799, 0.09999999999999809, 285.0, 1135, 680758, 913, 34.48095310000099
914, 3.706152807851176, 44.30954688277274, 53.192183512486594, 0.09999999999999878, 215.0, 958, 681716, 914, 29.36472539999886
915, 4.856587041048454, 44.297822413506445, 53.21756382731648, 0.10000000000000098, 130.0, 616, 682332, 915, 18.91598189999968
916, 5.232989823282589, 44.35406940214096, 53.31984224627095, 0.09999999999999924, 75.0, 868, 683200, 916, 26.774404100000538
917, 5.541876831578398, 44.207424719356794, 53.12130066214256, 0.1000000000000009, 105.0, 515, 683715, 917, 15.754741200000353
918, 4.926096645710585, 44.36982441043949, 53.33833372938979, 0.0999999999999986, 355.0, 999, 684714, 918, 30.70915199999945
919, 3.535137394632813, 44.46512723556796, 53.45688181853627, 0.0999999999999989, 280.0, 933, 685647, 919, 29.81095069999901
920, 4.291399678129905, 44.3156504961826, 53.24689535346586, 0.09999999999999888, 215.0, 937, 686584, 920, 29.300865299999714
921, 4.66825970837777, 44.44043638723014, 53.4500825042571, 0.09999999999999862, 235.0, 993, 687577, 921, 30.67465810000067
922, 6.395509491236145, 44.31921112742211, 53.27146649770311, 0.099999999999998, 245.0, 1164, 688741, 922, 36.12559610000062
923, 3.631853190643831, 44.30272755689447, 53.22522216452692, 0.09999999999999891, 530.0, 931, 689672, 923, 28.988090200000443
924, 5.5604269891863565, 44.103023861018755, 53.0856963295973, 0.10000000000000085, 170.0, 655, 690327, 924, 20.360907899999802
925, 8.842136931617892, 43.86677034277665, 52.854522937222534, 0.10000000000000098, 125.0, 608, 690935, 925, 18.82642979999946
926, 5.41502472051326, 43.74382449659102, 52.55954009136052, 0.10000000000000087, 90.0, 489, 691424, 926, 15.294087000000218
927, 3.5132479431130084, 43.82062863400799, 52.61625327998308, 0.099999999999998, 240.0, 1162, 692586, 927, 37.403513699999166
928, 4.005356891089242, 43.81867947861484, 52.64651733119738, 0.0999999999999992, 210.0, 876, 693462, 928, 27.593314300000202
929, 4.9655605599949055, 43.8313931042128, 52.641943163133355, 0.10000000000000071, 35.0, 381, 693843, 929, 11.819487300001128
930, 5.495085670384567, 43.745170565861656, 52.56488182025249, 0.09999999999999773, 315.0, 1253, 695096, 930, 39.194775399999344
931, 5.28509853921748, 43.81671638347659, 52.66824629156863, 0.09999999999999959, 145.0, 811, 695907, 931, 25.560105399999884
932, 5.256082442588089, 43.87423537159694, 52.73072608606636, 0.09999999999999898, 225.0, 917, 696824, 932, 28.654532700000345
933, 4.921548290180303, 43.781850034046066, 52.62871594575819, 0.09999999999999919, 175.0, 877, 697701, 933, 27.714914499998486
934, 4.5778668068384345, 43.734417190909944, 52.53296701852145, 0.09999999999999833, 200.0, 1065, 698766, 934, 33.3393503999996
935, 3.031913166758658, 43.721088026758274, 52.490577709712205, 0.09999999999999878, 410.0, 957, 699723, 935, 30.143438699999024
936, 5.659835155828287, 44.431829615727366, 53.424416321236016, 0.09999999999999791, 530.0, 1192, 700915, 936, 37.66440600000169
937, 4.140782912530602, 44.54373081214379, 53.50386625961219, 0.0999999999999983, 280.0, 1074, 701989, 937, 33.84641339999871
938, 4.123384333075807, 44.470443286834815, 53.40224421443269, 0.10000000000000099, 195.0, 626, 702615, 938, 19.713510900000983
939, 3.896879462683291, 44.526347177678886, 53.52144049442175, 0.1000000000000008, 150.0, 660, 703275, 939, 21.021166699998503
940, 6.153976257688315, 44.44428545560024, 53.43589302920556, 0.09999999999999847, 295.0, 1032, 704307, 940, 32.83847210000022
941, 2.7470202636312355, 44.39411825122255, 53.265174836823434, 0.1000000000000008, 140.0, 660, 704967, 941, 20.977782600000864
942, 4.420224059683581, 44.51221200942993, 53.48938016255697, 0.10000000000000098, 110.0, 600, 705567, 942, 19.12150660000043
943, 4.342176660664918, 44.661763509114586, 53.653912606517885, 0.099999999999998, 285.0, 1164, 706731, 943, 37.0066855999994
944, 3.1926570522608144, 44.567551376796004, 53.505706484955134, 0.10000000000000088, 60.0, 505, 707236, 944, 16.22014979999949
945, 4.127510048078196, 44.48618353474014, 53.44273931696045, 0.10000000000000077, 105.0, 663, 707899, 945, 20.99388910000016
946, 9.450037209308551, 44.62597517438376, 53.64408180103949, 0.09999999999999824, 475.0, 1091, 708990, 946, 34.66649589999906
947, 4.972186842867181, 44.50740221693583, 53.459365877410626, 0.09999999999999955, 145.0, 817, 709807, 947, 26.469260199999553
948, 6.767956204809404, 45.44267612695694, 54.60615230600039, 0.10000000000000071, 75.0, 384, 710191, 948, 12.347206899999946
949, 3.216730438663195, 46.056009345246984, 55.26780515213175, 0.10000000000000085, 75.0, 471, 710662, 949, 15.033409100000426
950, 6.426217642032274, 46.035215364743586, 55.33423997931285, 0.09999999999999798, 610.0, 1168, 711830, 950, 37.35520390000056
951, 3.1782356943500223, 46.116964708124925, 55.36875599895032, 0.10000000000000074, 50.0, 394, 712224, 951, 12.73565729999973
952, 5.382214724036132, 46.120519083234534, 55.448123048348954, 0.099999999999999, 380.0, 911, 713135, 952, 29.33065700000043
953, 7.265226161027972, 46.22215270996094, 55.601004288659844, 0.10000000000000099, 150.0, 633, 713768, 953, 20.532136199999513
954, 4.6221732764488035, 46.09649283949507, 55.353533045341514, 0.099999999999998, 495.0, 1163, 714931, 954, 37.690084099998785
955, 3.227025472368577, 45.97425124434995, 55.22394073658097, 0.09999999999999833, 530.0, 1066, 715997, 955, 34.520171899999696
956, 8.084786010503436, 46.06147864539919, 55.46454571946063, 0.10000000000000028, 160.0, 717, 716714, 956, 23.379785099999935
957, 5.207392188166589, 46.01869140064265, 55.314934838853596, 0.09999999999999908, 185.0, 898, 717612, 957, 29.210204900000463
958, 3.2252869062526703, 46.02580296351619, 55.22875362752855, 0.10000000000000038, 170.0, 706, 718318, 958, 22.917457300000024
959, 5.55061838796903, 46.08465469268061, 55.37736304729216, 0.09999999999999863, 400.0, 992, 719310, 959, 31.99951560000045
960, 6.0679875286801375, 46.051480157738816, 55.343372423827496, 0.09999999999999984, 175.0, 774, 720084, 960, 25.281866699999227
961, 6.6760164764223004, 46.04007147154689, 55.35276566822147, 0.09999999999999827, 300.0, 1081, 721165, 961, 35.297094300000026
962, 4.576707981729435, 46.091731045541444, 55.33299276691909, 0.10000000000000078, 85.0, 662, 721827, 962, 21.604694199999358
963, 4.962881571912195, 45.97996947794785, 55.22477369543947, 0.10000000000000092, 105.0, 648, 722475, 963, 21.362761200000023
964, 4.373104398085434, 45.97094753532652, 55.2237846666081, 0.09999999999999705, 455.0, 1570, 724045, 964, 50.96639859999959
965, 4.548032151335329, 46.00895356218477, 55.27321286402443, 0.09999999999999841, 305.0, 1044, 725089, 965, 34.42541110000093
966, 3.6928907805384155, 46.086370231490875, 55.33839351374929, 0.09999999999999885, 265.0, 943, 726032, 966, 30.80940290000035
967, 5.398652480234682, 46.02829896532668, 55.31750654726287, 0.09999999999999878, 170.0, 958, 726990, 967, 31.384206200000335
968, 4.995577356256709, 46.022894421215426, 55.289274184707345, 0.10000000000000063, 80.0, 677, 727667, 968, 22.361932399999205
969, 5.360324150326501, 46.18580043779245, 55.51989394278914, 0.10000000000000095, 110.0, 566, 728233, 969, 18.837165700000696
970, 8.000420075748604, 45.9526296485781, 55.30225658916054, 0.10000000000000071, 65.0, 382, 728615, 970, 12.648618299999725
971, 7.115290844882549, 46.141018839792594, 55.48069915534055, 0.09999999999999876, 145.0, 964, 729579, 971, 32.04888109999956
972, 6.007762977491872, 45.802507273980964, 55.01371081240542, 0.09999999999999781, 455.0, 1221, 730800, 972, 40.44940730000053
973, 6.716165593404684, 45.8192051610639, 55.084339907092435, 0.09999999999999863, 330.0, 992, 731792, 973, 32.73720780000076
974, 6.2269620044132505, 45.64813134805604, 54.88614870762721, 0.09999999999999805, 445.0, 1145, 732937, 974, 37.84538479999901
975, 5.399479032724219, 45.68124874619877, 54.91465121437521, 0.09999999999999747, 680.0, 1360, 734297, 975, 45.06558479999876
976, 7.443381617321937, 45.678633890491476, 54.97462343012245, 0.10000000000000099, 185.0, 618, 734915, 976, 20.59919169999921
977, 6.154184123776317, 45.86186162412556, 55.08096161387325, 0.09999999999999991, 90.0, 765, 735680, 977, 25.55084800000077
978, 7.390641263990187, 45.74077971221485, 54.97092458893386, 0.10000000000000087, 100.0, 487, 736167, 978, 16.31267680000019
979, 4.549681518862017, 45.731563758119314, 54.96327831736013, 0.09999999999999841, 365.0, 1044, 737211, 979, 34.885966499999995
980, 3.5127903000819822, 45.758356593375986, 54.973274031350776, 0.10000000000000063, 50.0, 344, 737555, 980, 11.714486099999704
981, 5.0290565280264685, 45.82611007261812, 55.08399791074603, 0.09999999999999912, 95.0, 890, 738445, 981, 29.858553199999733
982, 5.1601527823152615, 45.76176705595339, 54.917959860891855, 0.1, 180.0, 751, 739196, 982, 25.20326700000078
983, 3.6212664897931686, 45.783262781577534, 54.983554122471574, 0.10000000000000075, 60.0, 404, 739600, 983, 13.641760100001193
984, 5.970717557717901, 45.95172858981911, 55.23853769214875, 0.09999999999999824, 390.0, 1090, 740690, 984, 36.57261049999943
985, 6.0327848526313135, 45.91705636093297, 55.230405221526155, 0.10000000000000087, 60.0, 485, 741175, 985, 16.279926899998827
986, 4.285866488565455, 45.88805077102158, 55.13244326245654, 0.09999999999999902, 465.0, 910, 742085, 986, 30.908391900000424
987, 4.300078948936352, 45.781774183052086, 55.02014538038487, 0.09999999999999767, 340.0, 1276, 743361, 987, 43.00895049999963
988, 4.326620182235142, 45.830754626581, 55.0722798872159, 0.10000000000000095, 75.0, 578, 743939, 988, 19.67871489999925
989, 5.158588607364955, 45.78820737109051, 54.98692136395453, 0.10000000000000063, 190.0, 677, 744616, 989, 22.78765419999945
990, 5.098847059763337, 45.903663104093525, 55.142392493733645, 0.09999999999999848, 315.0, 1027, 745643, 990, 34.56278470000143
991, 6.565361441194219, 45.95843220743154, 55.21381979960635, 0.10000000000000063, 210.0, 677, 746320, 991, 22.997353500000827
992, 4.799024600650306, 45.92492945863158, 55.15492486073033, 0.09999999999999808, 175.0, 1137, 747457, 992, 38.68873100000019
993, 4.275971524596932, 45.913389435733656, 55.15396759308965, 0.10000000000000088, 35.0, 498, 747955, 993, 17.140219400000205
994, 3.887582560820926, 45.814715376647385, 55.02297923971431, 0.09999999999999924, 270.0, 868, 748823, 994, 29.49369370000022
995, 5.991019771215856, 45.91956628265033, 55.17448929284863, 0.10000000000000081, 40.0, 439, 749262, 995, 14.888521900000342
996, 4.795518138977083, 45.810010687475504, 55.08110819310112, 0.09999999999999898, 365.0, 917, 750179, 996, 31.216266800000085
997, 3.9507710244021896, 45.410918317319734, 54.48042097410748, 0.10000000000000092, 125.0, 538, 750717, 997, 18.525123400000666
998, 7.279480409986476, 45.47598125373334, 54.69751744490994, 0.09999999999999862, 330.0, 994, 751711, 998, 34.00466789999882
999, 7.431297369152308, 45.529314224243166, 54.68998200988769, 0.10000000000000088, 20.0, 500, 752211, 999, 17.21053750000101
1000, 6.406032767406205, 45.46668916273069, 54.65372679139723, 0.09999999999999863, 365.0, 991, 753202, 1000, 33.794953099999475
1001, 5.018315250234814, 45.54049116878186, 54.6997677313712, 0.09999999999999762, 435.0, 1298, 754500, 1001, 44.87201079999977
1002, 5.038692153705369, 45.496780280580666, 54.633398301355534, 0.09999999999999927, 235.0, 863, 755363, 1002, 29.662419000000227
1003, 5.268334611522801, 45.55053127064424, 54.751672556260054, 0.09999999999999935, 130.0, 850, 756213, 1003, 29.11972980000064
1004, 5.69705597979741, 45.55076925489637, 54.804862043592664, 0.10000000000000026, 170.0, 720, 756933, 1004, 24.884533700000247
1005, 6.209888314124954, 45.48565465945591, 54.69327901309951, 0.10000000000000023, 125.0, 723, 757656, 1005, 25.020325800000137
1006, 5.301394068879391, 45.54372439786116, 54.756546794981986, 0.10000000000000084, 60.0, 463, 758119, 1006, 16.0575917999995
1007, 6.110806438719502, 45.6280152948053, 54.77111273413306, 0.09999999999999913, 330.0, 888, 759007, 1007, 30.529967300000862
1008, 6.973196812664245, 45.641480384699804, 54.67485480863521, 0.0999999999999994, 110.0, 842, 759849, 1008, 29.123847099999693
1009, 5.524157478882992, 45.44924385440171, 54.524875284236344, 0.10000000000000098, 115.0, 599, 760448, 1009, 20.770459300001676
1010, 5.319474199733126, 45.2218321184072, 54.335912720166114, 0.10000000000000087, 60.0, 486, 760934, 1010, 16.97576659999868
1011, 3.10533817099746, 45.18739785931327, 54.256659691984005, 0.10000000000000066, 65.0, 352, 761286, 1011, 12.363009099999545
1012, 6.279493196199169, 45.21588266232593, 54.373764375733344, 0.10000000000000091, 110.0, 531, 761817, 1012, 18.519866300001013
1013, 5.609362418126644, 45.38199648205141, 54.53876243008366, 0.09999999999999719, 610.0, 1492, 763309, 1013, 51.763168499999665
1014, 4.971220774768892, 45.37684738826854, 54.50610695984473, 0.09999999999999888, 205.0, 937, 764246, 1014, 32.581991399998515
1015, 6.4407001581272425, 45.28723365284014, 54.42768473545943, 0.09999999999999849, 195.0, 1023, 765269, 1015, 35.784584500001074
1016, 5.918238472415463, 45.47442291772249, 54.62797547626599, 0.09999999999999895, 160.0, 923, 766192, 1016, 32.08449859999928
1017, 6.552926709328608, 45.39767265604079, 54.579094842720316, 0.10000000000000069, 110.0, 671, 766863, 1017, 23.378782599998885
1018, 5.843165910749191, 45.20184134547114, 54.32791185156554, 0.10000000000000096, 130.0, 643, 767506, 1018, 22.61873530000048
1019, 5.485766290649166, 45.256707757469115, 54.280501543990965, 0.10000000000000069, 75.0, 369, 767875, 1019, 13.20758080000087
1020, 3.747801478914842, 45.2101918757559, 54.27882494572886, 0.10000000000000088, 100.0, 499, 768374, 1020, 17.72090709999975
1021, 6.377339087632742, 45.304378241681036, 54.463785690956925, 0.09999999999999887, 340.0, 940, 769314, 1021, 32.76411259999986
1022, 6.414761818454478, 45.34622869195864, 54.51145873328512, 0.09999999999999847, 280.0, 1032, 770346, 1022, 35.99581020000005
1023, 4.9995720489373525, 45.19504361728539, 54.31372350056966, 0.09999999999999845, 300.0, 1035, 771381, 1023, 36.36405129999912
1024, 6.747752623253662, 45.328892448718314, 54.49262359098215, 0.1000000000000004, 330.0, 703, 772084, 1024, 24.72069190000002
1025, 6.283599385335733, 45.44292749523443, 54.623624302348624, 0.09999999999999834, 240.0, 1062, 773146, 1025, 37.366413399999146
1026, 3.6972146188964716, 45.226449124523214, 54.278354101609295, 0.099999999999999, 305.0, 913, 774059, 1026, 32.28696520000085
1027, 6.612347537737627, 45.23449182950533, 54.37653169485239, 0.1000000000000009, 100.0, 650, 774709, 1027, 23.07452050000029
1028, 6.393269098271848, 45.50288416227066, 54.680428819948645, 0.09999999999999917, 190.0, 881, 775590, 1028, 31.192247799999677
1029, 3.1102991896708314, 45.24295570624709, 54.30748536851671, 0.10000000000000087, 55.0, 486, 776076, 1029, 17.662731899999926
1030, 7.174310380478478, 45.408080777642446, 54.548538080140865, 0.10000000000000028, 115.0, 716, 776792, 1030, 25.736027300001297
1031, 5.003952777385711, 45.419180419635325, 54.51819774287407, 0.09999999999999833, 390.0, 1065, 777857, 1031, 37.82092759999978
1032, 4.80799646191371, 45.20693422240031, 54.31761283062874, 0.1000000000000009, 40.0, 517, 778374, 1032, 18.352707400001236
1033, 4.395138582406456, 45.360012976562274, 54.47164275716333, 0.09999999999999824, 160.0, 1088, 779462, 1033, 38.69342440000037
1034, 6.594088171317419, 45.361401028524206, 54.523712953720924, 0.09999999999999856, 205.0, 1007, 780469, 1034, 35.791070399998716
1035, 4.294174262184554, 45.32155420497114, 54.45104954788413, 0.09999999999999955, 160.0, 817, 781286, 1035, 29.21959980000065
1036, 5.959673277424756, 45.16711276041872, 54.25403663873913, 0.09999999999999863, 455.0, 991, 782277, 1036, 35.35946039999908
1037, 4.594354460136736, 45.13376341356794, 54.23771128558472, 0.0999999999999991, 295.0, 894, 783171, 1037, 32.23706139999922
1038, 5.391014293814078, 45.15778868794441, 54.28344959616661, 0.100000000000001, 195.0, 640, 783811, 1038, 22.938264100001106
1039, 4.640010457912474, 45.250046628122114, 54.351841052979914, 0.10000000000000091, 110.0, 524, 784335, 1039, 18.893567099999927
1040, 5.361989286803093, 45.17204071123575, 54.274008823670066, 0.09999999999999873, 185.0, 970, 785305, 1040, 35.01835240000037
1041, 3.508920369425993, 45.33140925462333, 54.44711431533254, 0.10000000000000071, 50.0, 382, 785687, 1041, 13.553663299999243
1042, 4.747251367221725, 45.29396374301134, 54.41206752121179, 0.09999999999999916, 280.0, 884, 786571, 1042, 31.737898499999574
1043, 4.3903172079855475, 45.16562065892843, 54.27345265769284, 0.09999999999999809, 375.0, 1132, 787703, 1043, 40.84749940000074
1044, 6.00452678198804, 45.1732675480078, 54.26795340557488, 0.10000000000000055, 135.0, 686, 788389, 1044, 25.003374399999302
1045, 5.602386158672335, 45.244843961105275, 54.36675265909646, 0.09999999999999819, 305.0, 1103, 789492, 1045, 39.75064409999868
1046, 6.953165460246759, 44.86273935479178, 53.919420285963675, 0.09999999999999808, 255.0, 1136, 790628, 1046, 41.14970689999973
1047, 4.428021487566721, 44.67991073447538, 53.68828004814056, 0.10000000000000075, 100.0, 664, 791292, 1047, 23.891713600000003
1048, 6.100642678061318, 44.55018959944497, 53.49493976768554, 0.09999999999999912, 275.0, 891, 792183, 1048, 32.4169722000006
1049, 5.814524705709634, 44.60119767585104, 53.641286745040546, 0.09999999999999892, 180.0, 927, 793110, 1049, 33.71851319999951
1050, 5.490522214361151, 44.531251589766725, 53.48896109442632, 0.09999999999999848, 280.0, 1027, 794137, 1050, 37.49353960000008
1051, 5.514110898889907, 44.522871702011315, 53.458432717519266, 0.10000000000000017, 185.0, 730, 794867, 1051, 26.726663800000097
1052, 5.645652395708364, 44.56292669769758, 53.53167377915991, 0.09999999999999733, 650.0, 1426, 796293, 1052, 51.88699439999982
1053, 9.461416338132807, 44.59539628890624, 53.6225866984172, 0.10000000000000075, 145.0, 664, 796957, 1053, 24.472337799999877
1054, 4.709226698714091, 44.49619073509274, 53.42873087144436, 0.10000000000000074, 195.0, 665, 797622, 1054, 24.15613510000003
1055, 6.557613267225422, 44.50753329304114, 53.55090649722126, 0.10000000000000099, 115.0, 634, 798256, 1055, 24.10290469999927
1056, 4.60016242698427, 44.62680507495703, 53.59725334470635, 0.09999999999999785, 510.0, 1208, 799464, 1056, 44.98679280000033
1057, 5.513725462477131, 44.46141028371076, 53.39379959212557, 0.10000000000000027, 155.0, 719, 800183, 1057, 26.583600800000568
1058, 5.84851317680799, 44.58429081147892, 53.60735778591232, 0.10000000000000066, 10.0, 351, 800534, 1058, 13.050056900001437
1059, 5.635463312518506, 44.47261671109964, 53.45396202029163, 0.10000000000000085, 185.0, 655, 801189, 1059, 24.234376800000973
1060, 4.4680348621854264, 44.453149841777815, 53.371232558960465, 0.09999999999999686, 530.0, 1691, 802880, 1060, 62.182551500000045
1061, 6.463821259297013, 44.5574558618146, 53.52397971589305, 0.10000000000000063, 85.0, 678, 803558, 1061, 25.0881945000001
1062, 5.618425242567626, 44.62609030655989, 53.62838885089544, 0.10000000000000099, 115.0, 635, 804193, 1062, 22.999063600000227
1063, 5.9849519532543045, 44.427274446229674, 53.3735804033709, 0.10000000000000094, 120.0, 555, 804748, 1063, 17.519372999999177
1064, 5.045196192918205, 44.445836857387, 53.35601262324998, 0.10000000000000096, 65.0, 595, 805343, 1064, 18.505858499998794
1065, 4.308061197620525, 44.44887716530343, 53.40422377727441, 0.09999999999999938, 335.0, 845, 806188, 1065, 26.17690279999988
1066, 5.794469560757418, 44.45801418212438, 53.3813240178662, 0.10000000000000092, 60.0, 539, 806727, 1066, 16.935908299999937
1067, 7.09654094773799, 44.43272869809689, 53.39643485323368, 0.09999999999999802, 305.0, 1156, 807883, 1067, 35.95656969999982
1068, 6.7553883020505205, 44.45017714752073, 53.41701897813438, 0.1000000000000001, 110.0, 739, 808622, 1068, 23.182903999999326
1069, 4.1259431548685415, 44.523632914131156, 53.43067789915863, 0.09999999999999827, 360.0, 1081, 809703, 1069, 33.61528879999969
1070, 6.263946903513296, 43.85705543016865, 52.70742457870149, 0.09999999999999745, 450.0, 1370, 811073, 1070, 42.74557069999901
1071, 5.629586710256204, 43.62671597594233, 52.38169977979261, 0.10000000000000099, 140.0, 622, 811695, 1071, 19.46413169999869
1072, 6.042962255109197, 43.64536846356514, 52.46260984860934, 0.0999999999999998, 205.0, 780, 812475, 1072, 24.606021699999474
1073, 5.428716190412742, 43.61232754973327, 52.429837051703004, 0.09999999999999916, 180.0, 882, 813357, 1073, 27.497980899999675
1074, 5.150925281919673, 43.663232827860774, 52.448850278682755, 0.09999999999999981, 180.0, 778, 814135, 1074, 24.287900500001342
1075, 6.0922067477348865, 43.69023448576597, 52.47892911851487, 0.10000000000000012, 240.0, 737, 814872, 1075, 23.213111900000513
1076, 5.182830660549025, 43.71177784429704, 52.50242602351771, 0.09999999999999946, 205.0, 831, 815703, 1076, 26.080555900000036
1077, 5.316214758139219, 43.61452645248508, 52.36698453322701, 0.10000000000000096, 215.0, 644, 816347, 1077, 20.481213499999285
1078, 4.587984722240416, 43.5567593764459, 52.32861248152311, 0.0999999999999988, 230.0, 954, 817301, 1078, 30.104534800000692
1079, 4.279050774987222, 43.69773622037206, 52.496887795416434, 0.09999999999999981, 200.0, 778, 818079, 1079, 24.5678355
1080, 4.602880029825795, 43.622033330531586, 52.42218818941201, 0.09999999999999776, 395.0, 1241, 819320, 1080, 39.22708169999896
1081, 5.193524031805294, 43.569247020911845, 52.357272885137085, 0.099999999999998, 340.0, 1162, 820482, 1081, 36.499795200001245
1082, 5.435512937469916, 43.70728523947976, 52.50599513858944, 0.10000000000000071, 40.0, 385, 820867, 1082, 12.2271137000007
1083, 5.274630261416858, 43.693605964044, 52.51626500463713, 0.10000000000000099, 155.0, 631, 821498, 1083, 19.998716900001455
1084, 8.400253028299343, 43.795166106586485, 52.714952039647564, 0.10000000000000069, 130.0, 671, 822169, 1084, 21.367169600000125
1085, 4.406083328922589, 43.62434361775716, 52.377008508752894, 0.10000000000000066, 115.0, 675, 822844, 1085, 21.73123519999899
1086, 7.704102729104631, 43.639116361223415, 52.48707898183801, 0.0999999999999974, 555.0, 1392, 824236, 1086, 43.99482139999964
1087, 7.307468306476949, 43.71142186969519, 52.53117050975561, 0.1000000000000009, 130.0, 512, 824748, 1087, 16.342318799999703
1088, 4.90331836242935, 43.653072278347516, 52.38874657520387, 0.09999999999999816, 310.0, 1113, 825861, 1088, 35.3847009000001
1089, 6.783400234638476, 43.67463838041218, 52.54907274557874, 0.10000000000000098, 130.0, 612, 826473, 1089, 19.66385789999913
1090, 6.948561513908892, 43.73593608225424, 52.558106930550004, 0.10000000000000071, 125.0, 381, 826854, 1090, 12.21214610000061
1091, 4.279673046836283, 43.71051899170102, 52.48710595189998, 0.10000000000000063, 150.0, 678, 827532, 1091, 21.799390899999707
1092, 4.210024442256432, 43.70410207568797, 52.49428048155233, 0.09999999999999912, 150.0, 892, 828424, 1092, 28.494476400001076
1093, 5.784940912266423, 43.6648907883723, 52.494105225756655, 0.10000000000000074, 140.0, 665, 829089, 1093, 25.067174000001614
1094, 5.037997779181393, 43.68947981640233, 52.48921694129018, 0.0999999999999986, 420.0, 997, 830086, 1094, 32.38868799999909
1095, 5.4530063431788784, 43.74084738878325, 52.53701169109056, 0.1000000000000006, 5.0, 331, 830417, 1095, 10.742873699999109
1096, 5.369771914624385, 43.884860647179536, 52.732805057447784, 0.0999999999999981, 385.0, 1127, 831544, 1096, 35.969135400000596
1097, 5.895920020630379, 43.77953189004681, 52.59061727695122, 0.09999999999999859, 490.0, 1002, 832546, 1097, 32.318154599999616
1098, 3.3695032319273475, 43.86604216307672, 52.746915269834396, 0.10000000000000078, 115.0, 662, 833208, 1098, 21.32929200000035
1099, 5.164505481668231, 43.825475703345404, 52.64673382971022, 0.10000000000000026, 185.0, 720, 833928, 1099, 23.34589750000123
1100, 8.039636620506645, 43.73724906227805, 52.557833550193095, 0.10000000000000081, 85.0, 440, 834368, 1100, 14.168684000000212
1101, 5.816263099631967, 43.80349953104053, 52.63086342444787, 0.09999999999999938, 170.0, 845, 835213, 1101, 27.449424099999305
1102, 5.037804643422061, 43.72868755496278, 52.56518249900974, 0.09999999999999869, 370.0, 980, 836193, 1102, 31.70689610000045
1103, 4.848279545514397, 43.71531105954111, 52.50222021464906, 0.10000000000000099, 60.0, 627, 836820, 1103, 20.472189300000537
1104, 4.524821903906352, 43.84398507858708, 52.648106178476986, 0.10000000000000069, 105.0, 671, 837491, 1104, 21.782602100000076
1105, 3.3141248968096426, 43.776310758237486, 52.557665921434946, 0.0999999999999996, 240.0, 810, 838301, 1105, 26.24753840000085
1106, 5.362162763242331, 43.97706915429757, 52.8540655933531, 0.10000000000000035, 150.0, 708, 839009, 1106, 23.079584799999793
1107, 5.696501955677207, 43.8918408901892, 52.743335429753095, 0.09999999999999931, 190.0, 856, 839865, 1107, 27.801778700000796
1108, 3.3889861130272902, 43.91437194259078, 52.75313574331778, 0.10000000000000066, 135.0, 675, 840540, 1108, 22.056484400000045
1109, 6.798388537313186, 43.88151703302956, 52.721487340755644, 0.09999999999999729, 445.0, 1446, 841986, 1109, 46.74243799999931
1110, 6.850606368288173, 43.936847357441195, 52.85470179126807, 0.09999999999999712, 520.0, 1529, 843515, 1110, 49.73822829999881
1111, 5.289527054012644, 43.859132635225535, 52.667266194474436, 0.09999999999999713, 350.0, 1523, 845038, 1111, 49.54482519999874
1112, 4.922172020615786, 43.78943840506503, 52.5818458999304, 0.09999999999999852, 380.0, 1018, 846056, 1112, 33.49129119999998
1113, 7.433567197267789, 44.1301193313905, 53.09246807787792, 0.10000000000000088, 50.0, 498, 846554, 1113, 16.3758813000004
1114, 9.211752710181896, 44.00339333294648, 52.95053639278819, 0.10000000000000098, 65.0, 609, 847163, 1114, 19.982903899999656
1115, 5.00142864416028, 43.88631706294985, 52.72939357728973, 0.10000000000000073, 100.0, 667, 847830, 1115, 21.942576099998405
1116, 5.497405480714788, 43.89573602955971, 52.728517830566005, 0.0999999999999978, 150.0, 1228, 849058, 1116, 40.372411099999226
1117, 6.586794559996727, 43.91777716601101, 52.799117816973876, 0.0999999999999967, 545.0, 1797, 850855, 1117, 59.11140609999893
1118, 7.587353402145526, 43.89752574850731, 52.81090164961494, 0.10000000000000087, 75.0, 491, 851346, 1118, 16.27496229999997
1119, 8.643899367659023, 43.894476643315066, 52.78592635462524, 0.09999999999999998, 370.0, 756, 852102, 1119, 24.895864099999017
1120, 6.541821430792513, 43.87509093224524, 52.73037774347085, 0.09999999999999921, 305.0, 873, 852975, 1120, 28.77287499999875
1121, 4.795293286749178, 43.80114910244851, 52.59431958979354, 0.09999999999999759, 265.0, 1313, 854288, 1121, 43.55476859999908
1122, 7.196545018298285, 43.79427635192871, 52.676313242231096, 0.10000000000000042, 165.0, 700, 854988, 1122, 23.081417699999292
1123, 6.988817603135785, 43.96080843337039, 52.846171667220744, 0.10000000000000038, 105.0, 705, 855693, 1123, 23.52796490000037
1124, 5.2280414012269025, 43.87057595106779, 52.69018377724788, 0.09999999999999855, 295.0, 1011, 856704, 1124, 33.64370710000003
1125, 6.669720368979146, 43.97704595260904, 52.83038855485314, 0.10000000000000092, 30.0, 538, 857242, 1125, 17.874146699999983
1126, 6.515587271526162, 43.881465670619555, 52.71912085491678, 0.1000000000000009, 100.0, 506, 857748, 1126, 16.851601200000005
1127, 4.670166659383229, 43.80993313309443, 52.63762554103589, 0.09999999999999684, 555.0, 1699, 859447, 1127, 56.31802489999973
1128, 4.910407214940925, 43.83209571655858, 52.64455269018048, 0.09999999999999773, 390.0, 1254, 860701, 1128, 42.13916869999957
1129, 5.272027194263443, 43.86259010722283, 52.699632388688784, 0.10000000000000049, 135.0, 693, 861394, 1129, 23.072556399998575
1130, 5.768791620270349, 43.84229906400045, 52.61952825387319, 0.10000000000000071, 75.0, 384, 861778, 1130, 12.8886242999979
1131, 7.538582993790632, 43.83806160100655, 52.795819625216936, 0.10000000000000027, 165.0, 718, 862496, 1131, 24.007210699997813
1132, 6.261972046332683, 43.93332289126581, 52.79128437461016, 0.10000000000000088, 110.0, 501, 862997, 1132, 16.71542050000062
1133, 4.769721107412055, 43.81350454617758, 52.61715965824854, 0.0999999999999982, 140.0, 1102, 864099, 1133, 37.09101279999959
1134, 4.962383432141073, 43.75321557468042, 52.60927050693292, 0.09999999999999967, 275.0, 798, 864897, 1134, 26.93147189999945
1135, 3.935912068461571, 43.64958302303186, 52.368332027464874, 0.10000000000000073, 30.0, 387, 865284, 1135, 12.92654290000064
1136, 5.652239510341901, 43.87633577612944, 52.69970801819203, 0.09999999999999847, 410.0, 1032, 866316, 1136, 34.85413889999836
1137, 5.644192481666435, 43.79546178181966, 52.64292929849507, 0.0999999999999996, 145.0, 810, 867126, 1137, 27.18676339999729
1138, 4.990124141440244, 43.83267965180749, 52.693551642392215, 0.0999999999999977, 355.0, 1262, 868388, 1138, 42.94513030000235
1139, 6.881657593638905, 43.860282000848805, 52.784551927598855, 0.09999999999999885, 245.0, 944, 869332, 1139, 31.83171339999899
1140, 5.095444796473042, 43.84451619658197, 52.69843020421724, 0.09999999999999952, 350.0, 821, 870153, 1140, 27.687655699999596
1141, 4.258015248932505, 43.61560262044271, 52.369438774355, 0.09999999999999891, 305.0, 930, 871083, 1141, 31.622739400001592
1142, 6.0697087701108, 43.6672183749912, 52.508326948011245, 0.10000000000000094, 120.0, 555, 871638, 1142, 18.86532620000071
1143, 7.046511809058497, 43.65031151856812, 52.467670104854534, 0.1000000000000002, 175.0, 727, 872365, 1143, 24.675421200001438
1144, 5.086834970439329, 43.58860133969507, 52.36819903795109, 0.10000000000000053, 125.0, 688, 873053, 1144, 23.345664000000397
1145, 4.112949942908779, 43.45232699354551, 52.17301051017867, 0.10000000000000091, 65.0, 649, 873702, 1145, 22.149067499998637
1146, 3.504709915093639, 43.64718156702378, 52.39188234665814, 0.10000000000000063, 50.0, 340, 874042, 1146, 11.681758299997455
1147, 4.466460361206316, 43.65918310958586, 52.440865406572236, 0.10000000000000027, 20.0, 719, 874761, 1147, 24.567846300000383
1148, 8.844341233122801, 43.67628148374364, 52.54615499525079, 0.09999999999999809, 350.0, 1133, 875894, 1148, 38.44647160000022
1149, 5.490880666305853, 43.55706588390262, 52.343763700973156, 0.0999999999999983, 225.0, 1075, 876969, 1149, 36.745312600000034
1150, 4.341829541214288, 43.65747600007919, 52.42575008254346, 0.09999999999999931, 185.0, 857, 877826, 1150, 29.46598919999815
1151, 3.633949761649523, 43.584009896512676, 52.332732355718385, 0.10000000000000095, 35.0, 578, 878404, 1151, 19.945265299997118
1152, 6.195808138659615, 43.57800083200054, 52.42239922347039, 0.09999999999999876, 115.0, 962, 879366, 1152, 32.948041899999225
1153, 5.710563789705831, 43.16835945098998, 51.87023651913343, 0.09999999999999773, 190.0, 1255, 880621, 1153, 44.13317129999996
1154, 5.249106426733536, 42.95517911806211, 51.59161492232438, 0.09999999999999902, 275.0, 910, 881531, 1154, 31.384806599999138
1155, 8.009551832897474, 42.98597534989889, 51.67064689366163, 0.0999999999999981, 240.0, 1130, 882661, 1155, 39.050748400000884
1156, 4.524396440093917, 43.029177508051, 51.69304885423252, 0.09999999999999926, 255.0, 865, 883526, 1156, 29.761775099999795
1157, 5.5160145128718785, 42.95828919650913, 51.56351791905181, 0.0999999999999989, 315.0, 933, 884459, 1157, 31.952355099998385
1158, 5.828434461653233, 42.926073417663574, 51.488994188308716, 0.10000000000000074, 45.0, 400, 884859, 1158, 13.877280199998495
1159, 4.9896398044919055, 42.97924850130342, 51.64356847877711, 0.09999999999999899, 275.0, 915, 885774, 1159, 31.966597899998305
1160, 7.212628753637356, 42.98599059554828, 51.65906247587229, 0.09999999999999803, 240.0, 1151, 886925, 1160, 39.62066489999779
1161, 5.077745924938283, 42.94451039129024, 51.59334816349496, 0.09999999999999816, 295.0, 1112, 888037, 1161, 38.52531789999921
1162, 5.598320344131743, 42.969434170556774, 51.645770494803664, 0.09999999999999813, 270.0, 1119, 889156, 1162, 39.010792699999
1163, 7.321589535304879, 43.04940454730429, 51.76212477584264, 0.09999999999999878, 185.0, 956, 890112, 1163, 33.32812829999966
1164, 7.089071197549055, 44.13651019277297, 53.08455903890432, 0.10000000000000099, 120.0, 622, 890734, 1164, 21.72993249999854
1165, 5.020023299483126, 44.1999614286835, 53.07165249761312, 0.10000000000000048, 140.0, 694, 891428, 1165, 24.002116699997714
1166, 6.122340478226411, 44.05277649813859, 52.94751119865942, 0.10000000000000095, 80.0, 567, 891995, 1166, 19.80436980000013
1167, 6.365111322720246, 44.064902618013576, 52.99893751637689, 0.09999999999999892, 410.0, 928, 892923, 1167, 32.42673869999999
1168, 5.2014970969635685, 44.100445537841296, 52.97579206692528, 0.09999999999999726, 485.0, 1461, 894384, 1168, 50.797739399997226
1169, 6.681390368825068, 44.180572333543196, 53.12146979138471, 0.09999999999999819, 400.0, 1104, 895488, 1169, 38.63095049999902
1170, 5.0477750085116, 44.18902883940336, 53.06728954771489, 0.09999999999999841, 305.0, 1045, 896533, 1170, 36.78071060000002
1171, 5.323070656397785, 44.067953797100856, 52.99739384167652, 0.10000000000000099, 45.0, 641, 897174, 1171, 22.563103799999226
1172, 7.221580515746796, 44.1467778082423, 53.07729657852802, 0.09999999999999737, 660.0, 1406, 898580, 1172, 49.08474700000079
1173, 6.354450777229966, 44.29353778431088, 53.225679407297854, 0.09999999999999795, 585.0, 1178, 899758, 1173, 41.96123329999682
1174, 4.685542399531521, 44.22870303302406, 53.14566349211753, 0.10000000000000091, 135.0, 649, 900407, 1174, 23.075654999996914
1175, 4.92150823667358, 44.33816482127704, 53.256873211381595, 0.09999999999999717, 405.0, 1503, 901910, 1175, 52.91921639999782
1176, 5.745457667602252, 44.32664560665123, 53.30885534790397, 0.0999999999999985, 200.0, 1022, 902932, 1176, 36.195609099999274
1177, 3.8267072718159993, 44.431373096577744, 53.38421320511123, 0.10000000000000091, 130.0, 649, 903581, 1177, 22.891243300000497
1178, 4.916744528607339, 44.400923799390696, 53.34260204950267, 0.09999999999999903, 220.0, 907, 904488, 1178, 32.17445990000124
1179, 3.9989250770624407, 44.32926159748989, 53.251415511499815, 0.09999999999999684, 575.0, 1695, 906183, 1179, 61.74892259999979
1180, 7.13475723609963, 44.35007903542045, 53.2991017656926, 0.09999999999999866, 315.0, 986, 907169, 1180, 35.16701780000221
1181, 4.443030350069752, 44.41768509751066, 53.369606613019194, 0.10000000000000085, 130.0, 654, 907823, 1181, 23.45823129999917
1182, 4.809652141383234, 44.218071611101095, 53.12442177003927, 0.1000000000000007, 80.0, 371, 908194, 1182, 13.326829400000861
1183, 5.016633095913231, 44.249602594803186, 53.157167535079154, 0.1000000000000009, 50.0, 513, 908707, 1183, 18.41201329999967
1184, 3.9543801550863167, 44.35658679024539, 53.26884970681033, 0.09999999999999791, 435.0, 1188, 909895, 1184, 42.246757799999614
1185, 5.153380727732995, 43.364184650022594, 52.109035646483335, 0.09999999999999888, 235.0, 938, 910833, 1185, 33.39096309999877
1186, 4.464571263049055, 43.26364369130839, 51.97590630500461, 0.09999999999999733, 325.0, 1422, 912255, 1186, 50.5003429999997
1187, 7.707975042469186, 43.35569745681333, 52.08465806485714, 0.09999999999999877, 280.0, 959, 913214, 1187, 34.22518229999696
1188, 5.207157407618141, 43.1672508422785, 51.868438238146, 0.09999999999999898, 135.0, 917, 914131, 1188, 32.83578100000159
1189, 6.79097996932245, 43.329170448835505, 52.05325730641683, 0.1000000000000009, 70.0, 516, 914647, 1189, 18.857559000000037
1190, 8.683187863345902, 43.26399346063857, 52.02091012512359, 0.09999999999999964, 235.0, 802, 915449, 1190, 29.06433310000284
1191, 4.361583859884293, 43.216561682870456, 51.90139276379737, 0.10000000000000092, 35.0, 535, 915984, 1191, 19.573476099998516
1192, 7.315747411963954, 43.46396134116433, 52.15284692157399, 0.10000000000000066, 45.0, 352, 916336, 1192, 12.940283799998724
1193, 4.71897199022628, 43.09567659964293, 51.81235331993599, 0.09999999999999895, 195.0, 924, 917260, 1193, 33.321135900001536
1194, 7.353527745626673, 43.26273625313571, 51.96662922685474, 0.10000000000000092, 70.0, 538, 917798, 1194, 19.525343500001327
1195, 6.493179221599062, 43.38690859686901, 52.16676859159443, 0.10000000000000021, 135.0, 726, 918524, 1195, 26.247136499998305
1196, 7.157159952650822, 43.263216681707476, 52.0162200655256, 0.09999999999999941, 215.0, 840, 919364, 1196, 30.352080200002092
1197, 5.617038933876762, 43.190899956495244, 51.877019644142095, 0.10000000000000074, 140.0, 665, 920029, 1197, 24.232402800000273
1198, 5.640962859228081, 43.258656545870565, 51.97491623762715, 0.10000000000000049, 170.0, 692, 920721, 1198, 25.18688060000204
1199, 5.609661210775375, 43.2024868661386, 51.880863172743055, 0.10000000000000066, 310.0, 675, 921396, 1199, 24.71484049999708
1200, 5.414320918644548, 43.12224623014689, 51.80691311827043, 0.10000000000000099, 155.0, 622, 922018, 1200, 22.569336600001407
1201, 4.10748473845363, 43.267366029855744, 51.97524543107873, 0.0999999999999981, 325.0, 1131, 923149, 1201, 41.113399499998195
1202, 4.144796167766802, 43.31384383120017, 51.99439132037767, 0.10000000000000063, 85.0, 678, 923827, 1202, 24.66132419999849
1203, 4.301936545976669, 43.27084405270615, 52.00398268506706, 0.09999999999999926, 150.0, 865, 924692, 1203, 31.756993599999987
1204, 8.365596616401692, 43.21244033533784, 51.982291079830006, 0.09999999999999867, 285.0, 982, 925674, 1204, 35.76409179999973
1205, 7.084031302500535, 43.31304508930928, 52.052577506553185, 0.0999999999999986, 305.0, 999, 926673, 1205, 36.539880500000436
1206, 3.1710117038939614, 43.27746144950847, 51.9530664039085, 0.10000000000000073, 65.0, 391, 927064, 1206, 14.38946660000147
1207, 6.403217541614051, 43.25419868058855, 51.96647850167197, 0.09999999999999955, 230.0, 818, 927882, 1207, 29.804464599998028
1208, 7.233096178236471, 43.27665885607891, 52.0690304266837, 0.10000000000000091, 185.0, 649, 928531, 1208, 23.72979209999903
1209, 3.9999165779378996, 43.23603998095557, 51.936266468740115, 0.10000000000000073, 140.0, 667, 929198, 1209, 24.37446699999782
1210, 9.11146974132862, 43.29913765192032, 52.12368125716845, 0.10000000000000071, 35.0, 384, 929582, 1210, 14.317520099997637
1211, 6.609692234119386, 42.94407576849052, 51.62192845318543, 0.09999999999999898, 335.0, 917, 930499, 1211, 33.685736200000974
1212, 5.70827371314428, 42.7209319157596, 51.36697267544609, 0.09999999999999824, 575.0, 1089, 931588, 1212, 39.977695700003096
1213, 6.248805403351067, 42.67622107159876, 51.294254127150786, 0.10000000000000088, 65.0, 499, 932087, 1213, 18.412685899998905
1214, 8.360463627815115, 42.62983332226455, 51.37075758610528, 0.10000000000000082, 35.0, 454, 932541, 1214, 16.64852830000018
1215, 3.964988271642467, 42.76708325691127, 51.37196561491459, 0.0999999999999997, 245.0, 794, 933335, 1215, 29.354180800000904
1216, 5.1340976745351075, 42.75512444112719, 51.34168469537165, 0.09999999999999983, 250.0, 776, 934111, 1216, 28.40260750000016
1217, 6.085130274359623, 42.79574118538638, 51.45035469659646, 0.10000000000000084, 135.0, 467, 934578, 1217, 17.2075737999985
1218, 6.345170190796217, 42.72521771989033, 51.37569513346175, 0.09999999999999809, 365.0, 1133, 935711, 1218, 41.89212099999713
1219, 5.152169790860899, 42.65468348902785, 51.28920797292622, 0.09999999999999876, 220.0, 964, 936675, 1219, 35.434609400002955
1220, 6.501106245788986, 42.87047187820404, 51.54897556571427, 0.10000000000000088, 155.0, 501, 937176, 1220, 18.597446600000694
1221, 6.643191790614048, 42.60285187833136, 51.19806250779988, 0.10000000000000028, 210.0, 716, 937892, 1221, 26.61667000000307
1222, 6.19978756495128, 42.73876668441394, 51.36938170440926, 0.09999999999999785, 395.0, 1210, 939102, 1222, 44.91135529999883
1223, 4.815736573084938, 42.66524342565223, 51.25374927230138, 0.09999999999999774, 290.0, 1247, 940349, 1223, 45.94048699999985
1224, 5.150767317323973, 42.47073180025274, 51.05399308060155, 0.10000000000000091, 85.0, 528, 940877, 1224, 19.9161903000022
1225, 5.98213523961015, 42.36066952139206, 50.92572907561912, 0.09999999999999915, 280.0, 886, 941763, 1225, 32.88712680000026
1226, 6.513985850415185, 42.36505720811906, 50.905484663754194, 0.10000000000000096, 215.0, 643, 942406, 1226, 23.755820800000947
1227, 7.787505229805956, 42.44546992235845, 51.07679080018903, 0.10000000000000088, 155.0, 505, 942911, 1227, 18.80940399999963
1228, 4.738897450676226, 42.45375953329858, 51.00872837546694, 0.09999999999999842, 220.0, 1041, 943952, 1228, 38.68213520000063
1229, 7.225912224611079, 42.47559133473493, 51.05829085522211, 0.0999999999999998, 175.0, 781, 944733, 1229, 29.287320399998862
1230, 7.630911721467749, 42.359633313582634, 50.92748150486178, 0.10000000000000092, 140.0, 534, 945267, 1230, 20.066505799997685
1231, 5.643896492100894, 42.49005929313771, 51.077413594797406, 0.09999999999999878, 185.0, 958, 946225, 1231, 36.00312330000088
1232, 5.2143494803242705, 42.5994893740503, 51.206553043085634, 0.1000000000000009, 105.0, 518, 946743, 1232, 19.41282140000112
1233, 8.32884421851486, 42.416124945337124, 51.08905520222404, 0.1000000000000004, 110.0, 704, 947447, 1233, 26.494385499998316
1234, 4.7412232776668, 42.29669828790068, 50.80868942150171, 0.09999999999999874, 145.0, 966, 948413, 1234, 36.0828354999976
1235, 6.080023537958618, 42.472144493170546, 51.08900577241341, 0.0999999999999981, 240.0, 1130, 949543, 1235, 42.492371500000445
1236, 5.632930046021177, 42.19191683967756, 50.70421914092121, 0.09999999999999978, 250.0, 783, 950326, 1236, 29.437838300000294
1237, 7.141002946288419, 42.03272910434433, 50.50276049583491, 0.09999999999999958, 185.0, 814, 951140, 1237, 30.44588929999736
1238, 7.671430010865465, 42.07556718160091, 50.59697857237699, 0.10000000000000099, 85.0, 627, 951767, 1238, 23.886688599999616
1239, 6.0177407873149535, 42.0434758132846, 50.54641665342467, 0.09999999999999845, 230.0, 1034, 952801, 1239, 38.86091699999815
1240, 4.673944982615384, 42.02761434356665, 50.49223414178172, 0.09999999999999781, 265.0, 1221, 954022, 1240, 46.18544330000077
1241, 7.029078218979899, 42.0786746729031, 50.595915115761805, 0.09999999999999837, 375.0, 1054, 955076, 1241, 39.68076220000148
1242, 5.948604638878147, 41.99966763987125, 50.48819464155771, 0.09999999999999777, 295.0, 1236, 956312, 1242, 46.730365999999776
1243, 4.448963672616943, 42.13965925303373, 50.62607965035872, 0.09999999999999917, 265.0, 880, 957192, 1243, 33.3028833999997
1244, 6.353238547932232, 41.955871654576995, 50.38523051024617, 0.10000000000000099, 35.0, 631, 957823, 1244, 24.01930490000086
1245, 5.234721164877822, 42.03527829294738, 50.50766715018274, 0.0999999999999974, 510.0, 1394, 959217, 1245, 52.75294329999815
1246, 5.753621304103698, 42.01674722254961, 50.52480135512078, 0.09999999999999923, 290.0, 870, 960087, 1246, 33.279824799999915
1247, 5.744083485784166, 41.14399374848086, 49.442475348403775, 0.10000000000000062, 335.0, 679, 960766, 1247, 25.64779610000187
1248, 3.412305245904119, 41.145035449166016, 49.434955160252215, 0.10000000000000084, 60.0, 463, 961229, 1248, 17.608699599997635
1249, 7.003169421961372, 41.11058204118596, 49.407733692494475, 0.10000000000000095, 70.0, 645, 961874, 1249, 24.638847700000042
1250, 5.198031122427331, 41.11351021383045, 49.39271145979726, 0.09999999999999869, 295.0, 977, 962851, 1250, 37.44946110000092
1251, 4.771576286482811, 40.93942858886719, 49.21466795654297, 0.10000000000000099, 80.0, 625, 963476, 1251, 23.936366300000373
1252, 7.098652677704872, 41.20820229049024, 49.5536601869966, 0.10000000000000091, 80.0, 533, 964009, 1252, 20.348550000002433
1253, 4.69932869088799, 41.14734132230194, 49.435090970922815, 0.10000000000000062, 125.0, 679, 964688, 1253, 26.27837509999881
1254, 3.971940087484462, 41.12169046129499, 49.36588372366769, 0.10000000000000042, 130.0, 700, 965388, 1254, 26.890791800000443
1255, 5.112659109253126, 41.12707859483785, 49.40395515432126, 0.0999999999999998, 260.0, 781, 966169, 1255, 30.06639350000114
1256, 6.715508929768186, 41.12163993203716, 49.451845776503255, 0.10000000000000099, 80.0, 628, 966797, 1256, 24.868468399999983
1257, 5.9145772679385065, 41.07270908612768, 49.4070178543461, 0.0999999999999972, 385.0, 1484, 968281, 1257, 57.92353830000138
1258, 3.4959175971647105, 41.06689702263174, 49.34626545277677, 0.1000000000000009, 90.0, 516, 968797, 1258, 19.881880699998874
1259, 6.645498000935272, 41.17562841909903, 49.517081095377605, 0.10000000000000066, 130.0, 675, 969472, 1259, 26.248404900001333
1260, 6.1430984270202895, 41.14166455557086, 49.44996010789436, 0.09999999999999885, 155.0, 943, 970415, 1260, 36.266416800001025
1261, 5.949569810037124, 41.3696942651594, 49.70348264397801, 0.09999999999999792, 225.0, 1184, 971599, 1261, 45.704346700000315
1262, 4.474464650401288, 41.44362359089384, 49.73779884361018, 0.10000000000000066, 185.0, 674, 972273, 1262, 25.83792390000235
1263, 6.895653925089914, 41.3815674147442, 49.78012697365252, 0.10000000000000071, 115.0, 669, 972942, 1263, 26.160400500000833
1264, 4.922600596935443, 41.38073466701579, 49.717005134072004, 0.09999999999999828, 440.0, 1076, 974018, 1264, 41.56010899999819
1265, 3.6480724865159844, 41.401757658931885, 49.72274392268898, 0.10000000000000084, 65.0, 467, 974485, 1265, 18.11387669999749
1266, 5.674412562406794, 41.483378127266256, 49.84527965599971, 0.099999999999999, 290.0, 913, 975398, 1266, 35.25778039999932
1267, 4.356246208114114, 41.32692528719926, 49.65770271010265, 0.09999999999999787, 270.0, 1206, 976604, 1267, 46.87837910000235
1268, 3.9777346785004073, 41.34990185918035, 49.64751162657867, 0.1000000000000001, 300.0, 740, 977344, 1268, 29.138361500001338
1269, 5.619925255613617, 41.3367839137831, 49.67578319319396, 0.09999999999999855, 205.0, 1011, 978355, 1269, 39.97944660000212
1270, 5.646824063907556, 41.462772857966684, 49.801773155851315, 0.10000000000000075, 85.0, 406, 978761, 1270, 16.105915100000857
1271, 4.741130525781633, 41.4780993490162, 49.82543911048752, 0.10000000000000071, 125.0, 668, 979429, 1271, 26.49762969999938
1272, 6.635211828828181, 42.38538869653337, 50.97058275758492, 0.09999999999999723, 290.0, 1474, 980903, 1272, 58.15153860000282
1273, 3.7635253276107195, 43.02047642132708, 51.66390127808083, 0.10000000000000091, 135.0, 524, 981427, 1273, 20.604132899999968
1274, 6.86354045694073, 43.075185576729154, 51.78470805624257, 0.10000000000000052, 310.0, 690, 982117, 1274, 27.179515199997695
1275, 8.636425241578458, 43.05809633831645, 51.80892380115598, 0.0999999999999983, 210.0, 1075, 983192, 1275, 42.4756770999993
1276, 5.383451027498276, 43.05431242550121, 51.728947641068146, 0.09999999999999791, 200.0, 1190, 984382, 1276, 49.1163338999977
1277, 5.044179444212247, 42.872279374739705, 51.465069529589485, 0.1000000000000006, 205.0, 680, 985062, 1277, 26.971900399999868
1278, 5.105562931267912, 42.95352048662468, 51.643002050482124, 0.09999999999999931, 280.0, 857, 985919, 1278, 34.1618791999972
1279, 7.178166038270962, 43.03844931668727, 51.698199917696215, 0.09999999999999777, 575.0, 1238, 987157, 1279, 49.46614799999952
1280, 6.546850311697254, 42.92750546997441, 51.57383843975589, 0.10000000000000081, 185.0, 658, 987815, 1280, 26.375419599997258
1281, 6.087759114139428, 42.92896967530905, 51.58682544092708, 0.099999999999999, 250.0, 911, 988726, 1281, 35.91220239999893
1282, 7.294725352340361, 43.028147823876914, 51.753746741337004, 0.09999999999999781, 490.0, 1222, 989948, 1282, 48.2305434000009
1283, 5.6344185582077015, 42.133371719048945, 50.6721468633535, 0.10000000000000087, 120.0, 490, 990438, 1283, 19.286775299999135
1284, 7.408601616111743, 41.97819528928617, 50.432370499866764, 0.10000000000000084, 95.0, 656, 991094, 1284, 26.133935900001234
1285, 5.286474967027843, 41.94255888954887, 50.36375643767458, 0.09999999999999909, 135.0, 895, 991989, 1285, 35.45183259999976
1286, 7.333623218762103, 41.930850346185245, 50.41866413455632, 0.099999999999999, 160.0, 911, 992900, 1286, 36.134148500001174
1287, 5.484118693273584, 42.10129642381658, 50.607721452534655, 0.09999999999999902, 445.0, 909, 993809, 1287, 39.201078199999756
1288, 6.54922638106255, 41.973914211094666, 50.475410202740484, 0.0999999999999984, 300.0, 1047, 994856, 1288, 40.94729670000015
1289, 8.242420268507258, 42.15783842018893, 50.75155436568276, 0.10000000000000099, 170.0, 618, 995474, 1289, 24.158763700001145
1290, 7.064552009845053, 42.16270370337799, 50.634698168922014, 0.10000000000000091, 90.0, 524, 995998, 1290, 20.353942500001722
1291, 4.095478992182548, 42.10904947467747, 50.55468467853812, 0.09999999999999809, 310.0, 1133, 997131, 1291, 45.97333740000249
1292, 4.929443907370781, 42.05778968671396, 50.52420982068866, 0.10000000000000098, 95.0, 601, 997732, 1292, 24.307446899998467
1293, 6.868259953933024, 41.954678666701014, 50.471892146889225, 0.1000000000000008, 40.0, 436, 998168, 1293, 17.804923199997575
1294, 4.765252261935409, 42.09036966934128, 50.57705399217672, 0.0999999999999986, 470.0, 997, 999165, 1294, 40.66309589999946
1295, 5.545219680412829, 41.964862602983594, 50.402271298314794, 0.10000000000000049, 215.0, 692, 999857, 1295, 28.318014100001164
