,loss,mae,mean_q,mean_eps,episode_reward,nb_episode_steps,nb_steps,episode,duration
0,0,0,0,0,150.0,646,646,0,1.3296864
1, 0, 0, 0, 0, 500.0, 1475, 2121, 1, 2.8990621999999995
2, 0, 0, 0, 0, 55.0, 366, 2487, 2, 0.7959063000000004
3, 0, 0, 0, 0, 195.0, 1032, 3519, 3, 2.0758328000000006
4, 0, 0, 0, 0, 130.0, 602, 4121, 4, 1.2408152000000001
5, 0, 0, 0, 0, 110.0, 544, 4665, 5, 1.193445999999998
6, 0, 0, 0, 0, 210.0, 963, 5628, 6, 2.018979699999999
7, 0, 0, 0, 0, 120.0, 642, 6270, 7, 1.3073863999999986
8, 0, 0, 0, 0, 135.0, 704, 6974, 8, 1.5490023000000015
9, 0, 0, 0, 0, 30.0, 487, 7461, 9, 1.0603686000000003
10, 0, 0, 0, 0, 105.0, 580, 8041, 10, 1.1972770999999973
11, 0, 0, 0, 0, 160.0, 760, 8801, 11, 1.6869236999999977
12, 0, 0, 0, 0, 85.0, 637, 9438, 12, 1.357285300000001
13, 0, 0, 0, 0, 230.0, 952, 10390, 13, 1.9414113999999998
14, 0, 0, 0, 0, 105.0, 633, 11023, 14, 1.3519574000000034
15, 0, 0, 0, 0, 155.0, 799, 11822, 15, 1.6407558000000009
16, 0, 0, 0, 0, 155.0, 643, 12465, 16, 1.2753937999999962
17, 0, 0, 0, 0, 75.0, 502, 12967, 17, 1.0278582000000043
18, 0, 0, 0, 0, 155.0, 798, 13765, 18, 1.6358511000000036
19, 0, 0, 0, 0, 30.0, 423, 14188, 19, 0.8723024000000024
20, 0, 0, 0, 0, 30.0, 526, 14714, 20, 1.0554927999999961
21, 0, 0, 0, 0, 35.0, 532, 15246, 21, 1.112836999999999
22, 0, 0, 0, 0, 230.0, 922, 16168, 22, 1.8742362999999997
23, 0, 0, 0, 0, 320.0, 769, 16937, 23, 1.555806099999998
24, 0, 0, 0, 0, 200.0, 955, 17892, 24, 1.9462803999999991
25, 0, 0, 0, 0, 260.0, 927, 18819, 25, 1.867226500000001
26, 0, 0, 0, 0, 20.0, 448, 19267, 26, 0.9301817999999997
27, 0, 0, 0, 0, 280.0, 960, 20227, 27, 1.938581400000004
28, 0, 0, 0, 0, 105.0, 828, 21055, 28, 1.6572968000000046
29, 0, 0, 0, 0, 110.0, 503, 21558, 29, 1.0363120000000023
30, 0, 0, 0, 0, 135.0, 721, 22279, 30, 1.459700600000005
31, 0, 0, 0, 0, 45.0, 406, 22685, 31, 0.8384697999999986
32, 0, 0, 0, 0, 290.0, 1227, 23912, 32, 2.3697447999999994
33, 0, 0, 0, 0, 110.0, 759, 24671, 33, 1.5045319000000035
34, 0, 0, 0, 0, 210.0, 825, 25496, 34, 1.6129587
35, 0, 0, 0, 0, 135.0, 649, 26145, 35, 1.3228712999999956
36, 0, 0, 0, 0, 265.0, 916, 27061, 36, 1.8579323000000016
37, 0, 0, 0, 0, 335.0, 756, 27817, 37, 1.5143984000000046
38, 0, 0, 0, 0, 55.0, 575, 28392, 38, 1.1870353000000051
39, 0, 0, 0, 0, 165.0, 703, 29095, 39, 1.4491196999999971
40, 0, 0, 0, 0, 440.0, 953, 30048, 40, 1.9257664000000005
41, 0, 0, 0, 0, 140.0, 821, 30869, 41, 1.647843199999997
42, 0, 0, 0, 0, 100.0, 387, 31256, 42, 0.791945300000009
43, 0, 0, 0, 0, 105.0, 719, 31975, 43, 1.4501702000000023
44, 0, 0, 0, 0, 205.0, 886, 32861, 44, 1.7887580999999955
45, 0, 0, 0, 0, 105.0, 610, 33471, 45, 1.2689017000000007
46, 0, 0, 0, 0, 210.0, 642, 34113, 46, 1.3073591999999934
47, 0, 0, 0, 0, 80.0, 507, 34620, 47, 1.0462288000000086
48, 0, 0, 0, 0, 50.0, 391, 35011, 48, 0.8185253999999986
49, 0, 0, 0, 0, 210.0, 908, 35919, 49, 1.8376537999999982
50, 0, 0, 0, 0, 135.0, 654, 36573, 50, 1.3257036999999912
51, 0, 0, 0, 0, 105.0, 733, 37306, 51, 1.4858562000000006
52, 0, 0, 0, 0, 210.0, 808, 38114, 52, 1.6357069999999965
53, 0, 0, 0, 0, 105.0, 722, 38836, 53, 1.4953055999999947
54, 0, 0, 0, 0, 135.0, 790, 39626, 54, 1.5930689000000058
55, 0, 0, 0, 0, 120.0, 503, 40129, 55, 1.043197400000011
56, 0, 0, 0, 0, 155.0, 783, 40912, 56, 1.5801905000000005
57, 0, 0, 0, 0, 135.0, 692, 41604, 57, 1.4433425
58, 0, 0, 0, 0, 155.0, 785, 42389, 58, 1.5796830000000028
59, 0, 0, 0, 0, 355.0, 790, 43179, 59, 1.6331643999999983
60, 0, 0, 0, 0, 80.0, 383, 43562, 60, 0.8004096000000089
61, 0, 0, 0, 0, 410.0, 1452, 45014, 61, 2.9072519999999997
62, 0, 0, 0, 0, 165.0, 770, 45784, 62, 1.5798789000000113
63, 0, 0, 0, 0, 215.0, 904, 46688, 63, 1.8490635999999938
64, 0, 0, 0, 0, 55.0, 391, 47079, 64, 0.8221008999999952
65, 0, 0, 0, 0, 310.0, 652, 47731, 65, 1.3321016000000014
66, 0, 0, 0, 0, 45.0, 474, 48205, 66, 0.9759391999999991
67, 0, 0, 0, 0, 110.0, 737, 48942, 67, 1.5062654000000038
68, 0, 0, 0, 0, 95.0, 607, 49549, 68, 1.2530972999999932
69, 0, 0, 0, 0, 180.0, 873, 50422, 69, 1.7829394999999977
70, 0, 0, 0, 0, 210.0, 811, 51233, 70, 1.6947731000000061
71, 0, 0, 0, 0, 380.0, 837, 52070, 71, 1.711193200000011
72, 0, 0, 0, 0, 195.0, 999, 53069, 72, 2.0426430999999923
73, 0, 0, 0, 0, 155.0, 823, 53892, 73, 1.663291799999996
74, 0, 0, 0, 0, 180.0, 803, 54695, 74, 1.6086230999999884
75, 0, 0, 0, 0, 210.0, 838, 55533, 75, 1.7236263999999863
76, 0, 0, 0, 0, 320.0, 1404, 56937, 76, 2.755211099999997
77, 0, 0, 0, 0, 100.0, 570, 57507, 77, 1.1485224999999986
78, 0, 0, 0, 0, 110.0, 618, 58125, 78, 1.2812719000000072
79, 0, 0, 0, 0, 75.0, 633, 58758, 79, 1.2878987999999936
80, 0, 0, 0, 0, 210.0, 750, 59508, 80, 1.540970299999998
81, 0, 0, 0, 0, 180.0, 509, 60017, 81, 1.0474863999999968
82, 0, 0, 0, 0, 180.0, 851, 60868, 82, 1.7284434999999974
83, 0, 0, 0, 0, 50.0, 403, 61271, 83, 0.8226980000000026
84, 0, 0, 0, 0, 135.0, 584, 61855, 84, 1.2134042000000136
85, 0, 0, 0, 0, 50.0, 616, 62471, 85, 1.2629527999999937
86, 0, 0, 0, 0, 215.0, 809, 63280, 86, 1.6724968000000047
87, 0, 0, 0, 0, 105.0, 688, 63968, 87, 1.4300096999999994
88, 0, 0, 0, 0, 80.0, 419, 64387, 88, 0.8640488000000062
89, 0, 0, 0, 0, 445.0, 923, 65310, 89, 1.8756389999999783
90, 0, 0, 0, 0, 105.0, 506, 65816, 90, 1.0662073999999961
91, 0, 0, 0, 0, 285.0, 915, 66731, 91, 1.8753580999999997
92, 0, 0, 0, 0, 135.0, 496, 67227, 92, 1.0378030999999908
93, 0, 0, 0, 0, 355.0, 804, 68031, 93, 1.6370712000000083
94, 0, 0, 0, 0, 105.0, 397, 68428, 94, 0.8389880999999946
95, 0, 0, 0, 0, 145.0, 775, 69203, 95, 1.5793362000000002
96, 0, 0, 0, 0, 110.0, 618, 69821, 96, 1.2932708000000162
97, 0, 0, 0, 0, 110.0, 627, 70448, 97, 1.3083047000000079
98, 0, 0, 0, 0, 180.0, 787, 71235, 98, 1.6413451999999893
99, 0, 0, 0, 0, 235.0, 915, 72150, 99, 1.8476782999999841
100, 0, 0, 0, 0, 415.0, 914, 73064, 100, 1.8250969000000055
101, 0, 0, 0, 0, 105.0, 617, 73681, 101, 1.2682929000000058
102, 0, 0, 0, 0, 120.0, 639, 74320, 102, 1.318524300000007
103, 0, 0, 0, 0, 135.0, 771, 75091, 103, 1.5478501000000051
104, 0, 0, 0, 0, 110.0, 661, 75752, 104, 1.3440549000000033
105, 0, 0, 0, 0, 110.0, 770, 76522, 105, 1.5684737999999925
106, 0, 0, 0, 0, 155.0, 793, 77315, 106, 1.600158599999986
107, 0, 0, 0, 0, 105.0, 641, 77956, 107, 1.3278507999999931
108, 0, 0, 0, 0, 80.0, 396, 78352, 108, 0.8418819999999982
109, 0, 0, 0, 0, 155.0, 780, 79132, 109, 1.5791083000000015
110, 0, 0, 0, 0, 105.0, 669, 79801, 110, 1.3636060999999984
111, 0, 0, 0, 0, 75.0, 474, 80275, 111, 0.980099899999999
112, 0, 0, 0, 0, 105.0, 505, 80780, 112, 1.0442792999999995
113, 0, 0, 0, 0, 110.0, 731, 81511, 113, 1.4991813999999977
114, 0, 0, 0, 0, 105.0, 492, 82003, 114, 1.0226499000000047
115, 0, 0, 0, 0, 260.0, 975, 82978, 115, 1.9540883999999892
116, 0, 0, 0, 0, 110.0, 680, 83658, 116, 1.3919890999999893
117, 0, 0, 0, 0, 105.0, 619, 84277, 117, 1.2393713000000162
118, 0, 0, 0, 0, 110.0, 653, 84930, 118, 1.3381163999999899
119, 0, 0, 0, 0, 180.0, 804, 85734, 119, 1.6309321999999895
120, 0, 0, 0, 0, 210.0, 875, 86609, 120, 1.787946799999986
121, 0, 0, 0, 0, 745.0, 1658, 88267, 121, 3.251289600000007
122, 0, 0, 0, 0, 210.0, 799, 89066, 122, 1.6020244000000048
123, 0, 0, 0, 0, 180.0, 858, 89924, 123, 1.735849399999978
124, 0, 0, 0, 0, 110.0, 760, 90684, 124, 1.5870257999999922
125, 0, 0, 0, 0, 345.0, 756, 91440, 125, 1.650235699999996
126, 0, 0, 0, 0, 105.0, 635, 92075, 126, 1.314711399999993
127, 0, 0, 0, 0, 135.0, 789, 92864, 127, 1.650135000000006
128, 0, 0, 0, 0, 485.0, 1002, 93866, 128, 2.1587853999999993
129, 0, 0, 0, 0, 75.0, 416, 94282, 129, 0.8853804999999966
130, 0, 0, 0, 0, 380.0, 786, 95068, 130, 1.6752400000000023
131, 0, 0, 0, 0, 180.0, 837, 95905, 131, 1.7935397999999907
132, 0, 0, 0, 0, 155.0, 798, 96703, 132, 1.7145193000000063
133, 0, 0, 0, 0, 110.0, 687, 97390, 133, 1.4701397000000043
134, 0, 0, 0, 0, 155.0, 799, 98189, 134, 1.7182213000000104
135, 0, 0, 0, 0, 210.0, 845, 99034, 135, 1.8031416999999976
136, 0, 0, 0, 0, 105.0, 625, 99659, 136, 1.3507599000000141
137, 7.471996936373985, 6.05639429562367, 7.6222177147865295, 0.8196246999999998, 95.0, 758, 100417, 137, 24.54035669999999
138, 5.51382409854867, 6.019347935161371, 7.515030311716014, 0.8188588000000001, 80.0, 435, 100852, 138, 24.4252525
139, 4.8181927834710185, 5.991329536029614, 7.381962423060343, 0.8177527000000003, 135.0, 794, 101646, 139, 44.65323420000004
140, 5.959515643975552, 5.996672987819075, 7.40057181408731, 0.8161354000000007, 170.0, 1003, 102649, 140, 56.62197320000001
141, 5.877597607222814, 5.967050334385463, 7.336905640647525, 0.8146656999999997, 70.0, 630, 103279, 141, 35.79505690000002
142, 5.233300678566475, 5.958672122404463, 7.319296189593924, 0.8136001000000002, 125.0, 554, 103833, 142, 31.51473589999995
143, 4.920225976921749, 5.9403018939405, 7.279065814366569, 0.8127441999999997, 30.0, 397, 104230, 143, 22.684673299999986
144, 6.321953832396406, 5.9605777423843564, 7.34605392165806, 0.8119314999999999, 105.0, 506, 104736, 144, 28.939785700000016
145, 4.696951866027259, 5.92393191066789, 7.223503991900158, 0.8110387000000003, 10.0, 486, 105222, 145, 27.83950679999998
146, 4.759756769221198, 5.917681004711773, 7.243187053433023, 0.8101710999999997, 85.0, 478, 105700, 146, 27.505768999999987
147, 5.781600080931477, 5.925590314578601, 7.2450480740810494, 0.8091117999999999, 120.0, 699, 106399, 147, 40.29834649999998
148, 5.157767458937988, 5.9126644521719625, 7.2146551309358555, 0.8076736000000007, 200.0, 899, 107298, 148, 51.9840289
149, 7.682217555129041, 6.076819494524449, 7.178021389128761, 0.8062695999999999, 165.0, 661, 107959, 149, 38.43046449999997
150, 7.338610650468689, 6.104089866572913, 7.2450400341599615, 0.8052013000000002, 90.0, 526, 108485, 150, 30.7190217000001
151, 5.747190232016325, 5.957794777384654, 7.134435222110035, 0.8037892, 405.0, 1043, 109528, 151, 61.07293160000006
152, 5.588097517279312, 5.896966745196214, 7.109984185853954, 0.8024032000000002, 40.0, 497, 110025, 152, 29.144026900000085
153, 5.487815496835623, 6.017089046443905, 7.280095281686869, 0.8014563999999995, 90.0, 555, 110580, 153, 32.698321199999896
154, 5.295756001665135, 6.003620211524193, 7.253043757544623, 0.8006005000000002, 30.0, 396, 110976, 154, 23.429372100000023
155, 5.513792127179487, 6.010247512192826, 7.267799636908174, 0.7996834000000003, 85.0, 623, 111599, 155, 36.854799699999944
156, 4.932237938046455, 5.993022761108182, 7.259987130401828, 0.7984882, 105.0, 705, 112304, 156, 41.937807099999986
157, 5.2307328145410015, 5.998504003152807, 7.243628349145913, 0.7967691999999995, 490.0, 1205, 113509, 157, 72.10120840000002
158, 5.313914787422245, 6.016848776177562, 7.282975590607658, 0.7947495999999998, 255.0, 1039, 114548, 158, 62.39690140000005
159, 4.084614541036327, 6.015552461438062, 7.256268290775578, 0.7934454999999999, 35.0, 410, 114958, 159, 24.795550599999842
160, 4.60777701591753, 6.0137877705121285, 7.297443093675556, 0.7927201000000003, 50.0, 396, 115354, 160, 24.015222799999947
161, 4.999951952459231, 6.0068194690408685, 7.250847848016058, 0.7918875999999998, 110.0, 529, 115883, 161, 32.17205820000004
162, 4.374924841023491, 6.005159740105361, 7.257998402532703, 0.7906600000000003, 125.0, 835, 116718, 162, 50.8494541
163, 4.788259987987525, 6.0163224227039525, 7.281951108215549, 0.7892739999999998, 155.0, 705, 117423, 163, 43.1658523000001
164, 4.891288854038879, 6.013004749768401, 7.255241026943677, 0.7879825000000001, 210.0, 730, 118153, 164, 44.79151700000011
165, 5.406228571527266, 6.020193911012197, 7.2819639065362125, 0.7867027000000002, 115.0, 692, 118845, 165, 42.57738840000002
166, 4.778914920272834, 6.006270126796063, 7.261419441964891, 0.7854967000000004, 110.0, 648, 119493, 166, 40.00634769999988
167, 4.357601335321769, 6.012481157317361, 7.268067357204713, 0.7844401, 95.0, 526, 120019, 167, 32.56695130000003
168, 4.811695221976104, 6.057944637704566, 7.270308644896051, 0.7835185, 60.0, 498, 120517, 168, 31.008022700000083
169, 5.075464934182144, 6.045781888339433, 7.261107409984274, 0.7821325000000006, 185.0, 1042, 121559, 169, 64.9830735999999
170, 5.032291945775946, 6.032073512086278, 7.247810665259442, 0.780715, 180.0, 533, 122092, 170, 33.413540999999896
171, 4.1407788727044315, 6.018289381386147, 7.241335569236364, 0.7796566, 155.0, 643, 122735, 171, 40.489494199999854
172, 5.458587503462652, 6.042036570345902, 7.277638939102883, 0.7784398000000002, 105.0, 709, 123444, 172, 44.782985300000064
173, 4.530543605426345, 6.031246196862423, 7.25221994862412, 0.7773562000000002, 90.0, 495, 123939, 173, 31.506011800000124
174, 4.619553748333987, 6.018483008924238, 7.235728471500595, 0.7761646, 225.0, 829, 124768, 174, 52.73668339999995
175, 4.465394484199723, 6.009571992542188, 7.224031060611721, 0.7745031999999991, 130.0, 1017, 125785, 175, 64.93369589999998
176, 4.084405420484947, 6.005111656104005, 7.214741753576062, 0.7731837999999999, 20.0, 449, 126234, 176, 28.8060981000001
177, 4.659195909190876, 6.016180739741944, 7.251896909091263, 0.7723495, 50.0, 478, 126712, 177, 30.779083899999932
178, 4.873451198623019, 6.0274832395288165, 7.2348428304912975, 0.7713631000000002, 90.0, 618, 127330, 178, 39.799211900000046
179, 4.058418397265646, 6.007236431678965, 7.212446822494757, 0.7702030000000001, 135.0, 671, 128001, 179, 43.53331019999996
180, 3.8594312462955713, 6.008303644536417, 7.200548876689959, 0.7690302999999997, 120.0, 632, 128633, 180, 40.99120509999989
181, 5.391761488857723, 6.041949037521604, 7.262937821498533, 0.7680646, 30.0, 441, 129074, 181, 28.876202599999942
182, 4.752091776670479, 6.028324280881716, 7.245224062989398, 0.7671511000000002, 65.0, 574, 129648, 182, 37.571246799999926
183, 4.677150159158179, 6.048211214972324, 7.251938312431502, 0.7659756999999998, 185.0, 732, 130380, 183, 48.02064660000019
184, 4.493897950587441, 6.062323452381605, 7.281921024042259, 0.7642755999999998, 185.0, 1157, 131537, 184, 76.41605340000024
185, 4.6854054383802834, 6.056881017015692, 7.283278158254791, 0.7627213, 120.0, 570, 132107, 185, 37.790082900000016
186, 4.64695660819021, 6.069076986652118, 7.2843182843978544, 0.7615252000000003, 110.0, 759, 132866, 186, 50.514375499999915
187, 4.595636953676054, 6.066211576279834, 7.283859648420888, 0.7600402000000005, 225.0, 891, 133757, 187, 59.6052980999998
188, 4.647178918829855, 6.071472320264021, 7.30734413804037, 0.7585930000000001, 335.0, 717, 134474, 188, 48.09071069999982
189, 5.236027973548819, 6.088161112119754, 7.31267633040746, 0.7576021000000002, 65.0, 384, 134858, 189, 25.882569800000056
190, 4.318047340628535, 6.057621533867227, 7.284239590601803, 0.7566381999999999, 105.0, 687, 135545, 190, 46.437755599999946
191, 4.675002928954182, 6.050443448153409, 7.270462894439698, 0.7552773999999997, 180.0, 825, 136370, 191, 55.90196449999985
192, 3.8339345768668145, 6.0507855463267575, 7.2602429358004725, 0.7539975999999999, 30.0, 597, 136967, 192, 40.641063399999894
193, 4.490615609347036, 6.057211776313029, 7.2770944065169285, 0.7529131, 120.0, 608, 137575, 193, 41.46619490000012
194, 4.739822918498838, 6.053497330409066, 7.283692231049409, 0.7516666000000002, 100.0, 777, 138352, 194, 53.14705360000016
195, 4.935526875022165, 6.0572123506914295, 7.278849625793589, 0.7503427000000005, 110.0, 694, 139046, 195, 47.65911439999991
196, 4.50403518657422, 6.053297257389773, 7.253208442870921, 0.7490800000000001, 160.0, 709, 139755, 196, 48.81115529999988
197, 5.105188154175802, 6.136731762571383, 7.378467542871001, 0.7480872999999997, 105.0, 394, 140149, 197, 27.251545799999803
198, 4.5786649081833755, 6.2606800038327455, 7.528239369819668, 0.7469793999999998, 140.0, 837, 140986, 198, 57.995803799999976
199, 4.080094375116313, 6.247321070440663, 7.506322253470453, 0.7456896999999999, 45.0, 596, 141582, 199, 41.47448710000026
200, 4.179428761571736, 6.251928907146627, 7.5125540484114355, 0.7445575000000001, 80.0, 662, 142244, 200, 46.22396630000003
201, 4.221602990697086, 6.254266252304984, 7.5154582860301415, 0.7434775000000002, 160.0, 538, 142782, 201, 37.63518500000009
202, 3.856859472066721, 6.240180741960757, 7.508998117714285, 0.7426080999999997, 65.0, 428, 143210, 202, 30.05041710000023
203, 4.744091414856866, 6.269695873597297, 7.547738451496819, 0.7412544999999996, 230.0, 1076, 144286, 203, 75.91763149999997
204, 4.340491584721153, 6.260350386301677, 7.508873852032408, 0.7399377999999999, 105.0, 387, 144673, 204, 27.441408299999694
205, 4.5641098872570565, 6.252578802584567, 7.520242875155037, 0.7391746, 105.0, 461, 145134, 205, 32.83345969999982
206, 3.944244612458033, 6.251988983012169, 7.527413781815598, 0.7381557999999997, 110.0, 671, 145805, 206, 47.83474389999992
207, 4.45061773665122, 6.265513406350062, 7.550443205568525, 0.7367094999999999, 215.0, 936, 146741, 207, 67.10744599999998
208, 4.739091757093157, 6.26853555897304, 7.55575993347168, 0.7350795999999995, 340.0, 875, 147616, 208, 62.9858678999999
209, 3.967041888921819, 6.252682154229347, 7.533210624938316, 0.7332346, 170.0, 1175, 148791, 209, 84.74610970000003
210, 4.7617982138991355, 6.26946076965332, 7.543028918584188, 0.7315021, 210.0, 750, 149541, 210, 54.687103899999784
211, 4.133585956321586, 6.380568943605338, 7.70603563279633, 0.7301187999999998, 210.0, 787, 150328, 211, 57.86149269999987
212, 3.835154560394585, 6.55340909704249, 7.899500560253225, 0.7287336999999999, 110.0, 752, 151080, 212, 55.24460339999996
213, 4.235026975228068, 6.561736918898189, 7.891684026577893, 0.7268328999999996, 390.0, 1360, 152440, 213, 100.41894719999982
214, 4.127552211839212, 6.554193218163302, 7.894069822860767, 0.7250527000000002, 105.0, 618, 153058, 214, 45.9071399999998
215, 4.334862715523144, 6.545968813501346, 7.882419232350246, 0.7239312999999998, 145.0, 628, 153686, 215, 46.85580549999986
216, 3.9498529605122474, 6.54912860762288, 7.886634534570013, 0.7227783999999997, 210.0, 653, 154339, 216, 48.91764779999994
217, 4.35245965886644, 6.5640964963775135, 7.893377379659729, 0.7218046000000001, 10.0, 429, 154768, 217, 32.367401900000004
218, 3.6906936843117815, 6.534074056409865, 7.855189261508833, 0.7208848000000002, 50.0, 593, 155361, 218, 44.74164259999998
219, 4.792514705303318, 6.556976452252063, 7.901568114633102, 0.7194889, 440.0, 958, 156319, 219, 72.32546460000003
220, 4.0005097586969685, 6.547020749041908, 7.89519807270595, 0.7181479000000003, 75.0, 532, 156851, 220, 40.459627100000034
221, 4.2102875255786625, 6.5489552240113955, 7.891790312689704, 0.7166701000000001, 285.0, 1110, 157961, 221, 84.41732480000019
222, 3.8997833430261934, 6.550494681374501, 7.8832105499202925, 0.7151401000000002, 90.0, 590, 158551, 222, 45.19387920000008
223, 4.106595281478241, 6.537811468082978, 7.873555799096937, 0.7139044000000003, 145.0, 783, 159334, 223, 57.8808127999996
224, 3.948530187944482, 6.545377340730174, 7.878517681173145, 0.7125975999999999, 105.0, 669, 160003, 224, 45.65563110000039
225, 4.2802607518179485, 6.717971836519317, 8.104841229277065, 0.7114275999999997, 120.0, 631, 160634, 225, 43.181918600000245
226, 4.530094450042278, 6.719057416214662, 8.097698954974904, 0.7100028999999994, 220.0, 952, 161586, 226, 65.4760469999992
227, 3.487694584968267, 6.709576550871134, 8.073770518414676, 0.7086852999999996, 65.0, 512, 162098, 227, 35.34698290000051
228, 4.105963692804308, 6.708163360754649, 8.096527819570742, 0.7074036999999996, 245.0, 912, 163010, 228, 63.147022500000276
229, 3.5487815837855368, 6.714764867577828, 8.066474339123038, 0.7056775, 255.0, 1006, 164016, 229, 69.89285480000035
230, 4.333441334277039, 6.730139658939213, 8.10003372214974, 0.7042401999999998, 100.0, 591, 164607, 230, 41.277945400000135
231, 3.954969409084509, 6.7330631082020105, 8.091129265134297, 0.7031412999999996, 90.0, 630, 165237, 231, 44.21416210000007
232, 4.25747744462277, 6.729399210477928, 8.099732535909936, 0.7016778999999995, 225.0, 996, 166233, 232, 70.09272789999977
233, 3.7768687245009813, 6.726238579568216, 8.081594635369415, 0.6999319, 215.0, 944, 167177, 233, 66.57299340000009
234, 4.278681388443468, 6.728294523103844, 8.095942024395429, 0.6984352000000001, 155.0, 719, 167896, 234, 50.97827829999915
235, 4.0886392228043915, 6.734104921420415, 8.09999517024609, 0.6969673000000002, 210.0, 912, 168808, 235, 64.78496760000053
236, 4.489132700668227, 6.74818635401004, 8.13761839854806, 0.6954211000000003, 205.0, 806, 169614, 236, 57.58923210000012
237, 3.371013660694478, 6.710846257347592, 8.076664380255462, 0.6943843000000001, 15.0, 346, 169960, 237, 24.88596409999991
238, 4.616393746695662, 7.149292322346562, 8.614357285318226, 0.6932682999999995, 260.0, 894, 170854, 238, 64.14720639999996
239, 4.260309998248075, 7.165769997830957, 8.630777508055422, 0.6916978000000001, 155.0, 851, 171705, 239, 61.359085299999606
240, 3.7428925535384496, 7.1523185193173, 8.611303153944894, 0.6903450999999997, 100.0, 652, 172357, 240, 47.223937199999455
241, 3.6108096738808726, 7.15261327342753, 8.608178622883521, 0.6891714999999997, 110.0, 652, 173009, 241, 47.334277799999654
242, 3.3652076963204656, 7.150480091822598, 8.59659216882136, 0.6879429999999999, 135.0, 713, 173722, 242, 51.941431600000215
243, 4.088271302829426, 7.1482953226700685, 8.602078602893725, 0.6867424, 80.0, 621, 174343, 243, 45.35978189999969
244, 3.4055717063130753, 7.139827421361749, 8.587258445277358, 0.6854409999999999, 150.0, 825, 175168, 244, 60.5929086999995
245, 4.0537848358237465, 7.150868965858637, 8.602011888526206, 0.6839245000000004, 220.0, 860, 176028, 245, 63.34817380000004
246, 4.206546664237976, 7.1668167053974985, 8.616304374072705, 0.6824385999999999, 200.0, 791, 176819, 246, 58.4379871000001
247, 4.102050470216061, 7.151564720495423, 8.599750911655711, 0.6811237, 110.0, 670, 177489, 247, 49.69160770000053
248, 4.496053509709268, 7.159019785352273, 8.613324821585476, 0.6801571, 95.0, 404, 177893, 248, 30.073087900000246
249, 4.263250581881938, 7.168319336980836, 8.632528516981337, 0.6792669999999998, 105.0, 585, 178478, 249, 43.62447590000011
250, 3.770677398478464, 7.148297643293758, 8.584582311635153, 0.6783904000000001, 15.0, 389, 178867, 250, 29.083905499999673
251, 4.200001662808773, 7.162534339830331, 8.62541652738569, 0.6772564000000002, 290.0, 871, 179738, 251, 65.27610480000021
252, 3.715926849582532, 7.199113292379065, 8.662810119422707, 0.6758731000000003, 135.0, 666, 180404, 252, 49.91066359999968
253, 3.704677153738017, 7.236037570207857, 8.689599380880443, 0.6745645, 190.0, 788, 181192, 253, 59.42320749999999
254, 3.8979667363957913, 7.2358004154717595, 8.710274634802667, 0.673165, 165.0, 767, 181959, 254, 58.060312700000395
255, 4.043950975635947, 7.230338563452234, 8.695294653619086, 0.6720885999999999, 80.0, 429, 182388, 255, 32.68201649999992
256, 4.484672739960645, 7.23716123631126, 8.697066259886089, 0.6708474999999995, 215.0, 950, 183338, 256, 72.31567949999953
257, 3.471668631357786, 7.229357977326099, 8.698972332362946, 0.6684948999999997, 510.0, 1664, 185002, 257, 127.45046009999987
258, 3.4304324680457134, 7.223178397966904, 8.69917655774391, 0.6663123999999999, 105.0, 761, 185763, 258, 58.60157849999996
259, 3.8500943932777796, 7.224446994481069, 8.699658075968424, 0.6651360999999997, 60.0, 546, 186309, 259, 42.203899199999796
260, 3.4238865479432055, 7.222636938427615, 8.689059520865085, 0.6639993999999998, 110.0, 717, 187026, 260, 55.550321100000474
261, 3.302021302593251, 7.2280192419334695, 8.686410740569785, 0.6629652999999999, 45.0, 432, 187458, 261, 33.63490430000002
262, 4.238857208183531, 7.237931601797637, 8.70849500786724, 0.6615118000000004, 170.0, 1183, 188641, 262, 92.38789219999944
263, 3.7824071980776743, 7.225635733441255, 8.689939235401999, 0.6597369999999998, 410.0, 789, 189430, 263, 61.867967600000156
264, 3.4279830905211837, 7.2259944233114535, 8.71911331923334, 0.6586912000000001, 65.0, 373, 189803, 264, 29.2972649000003
265, 4.038741911941422, 7.311954337551833, 8.802001450058436, 0.6577174000000002, 125.0, 709, 190512, 265, 55.69922039999983
266, 4.0654872059117535, 7.342796342592713, 8.82426660506156, 0.6566985999999997, 145.0, 423, 190935, 266, 33.43831090000003
267, 3.8131184860007967, 7.323031483297273, 8.817481778362605, 0.6557463999999998, 125.0, 635, 191570, 267, 50.12643310000021
268, 3.6063014143359116, 7.312613392766581, 8.801102608565968, 0.6543072999999998, 490.0, 964, 192534, 268, 76.39252699999997
269, 3.8534977686810428, 7.332967450193237, 8.82263921678235, 0.6531220000000001, 75.0, 353, 192887, 269, 28.090895700000146
270, 3.667360215964284, 7.313510045651217, 8.807547840330827, 0.6520285, 210.0, 862, 193749, 270, 68.60642280000047
271, 4.1081370111501725, 7.3363179510633465, 8.816913781566589, 0.6506848000000002, 80.0, 631, 194380, 271, 50.302396099999896
272, 3.9821116432390715, 7.3278300536306284, 8.816783555683337, 0.6492619000000002, 225.0, 950, 195330, 272, 76.2490859999998
273, 3.9839314950706455, 7.323832955646214, 8.804282106435638, 0.6478363000000003, 70.0, 634, 195964, 273, 50.89555389999987
274, 3.4128404017617773, 7.307669049168861, 8.780487683709598, 0.6464268999999999, 155.0, 932, 196896, 274, 75.10892010000043
275, 4.197501420178072, 7.305250961030239, 8.789911600393339, 0.6448474000000003, 280.0, 823, 197719, 275, 66.63633550000031
276, 3.3548804629594087, 7.299423625469208, 8.760218775272369, 0.6437467000000001, 30.0, 400, 198119, 276, 32.59202689999984
277, 4.166164633899163, 7.305091107197297, 8.779449083866217, 0.6430357000000001, 80.0, 390, 198509, 277, 31.87772589999986
278, 3.806845663763573, 7.289929425731822, 8.77446927197692, 0.6419890000000003, 125.0, 773, 199282, 278, 63.09467010000026
279, 3.7090998567560667, 7.293181393736152, 8.7813813506916, 0.6407911000000002, 105.0, 558, 199840, 279, 45.681323099999645
280, 4.4274946484688575, 7.271260426809413, 8.760034675062121, 0.6399045999999998, 45.0, 427, 200267, 280, 35.06609329999992
281, 4.015848622701289, 7.2536942064762115, 8.733955203362232, 0.6387570999999999, 230.0, 848, 201115, 281, 69.4522208999997
282, 3.690310262789063, 7.250491826164531, 8.729147232790044, 0.6371523999999996, 265.0, 935, 202050, 282, 76.5623114
283, 3.7214176415108713, 7.235177641164456, 8.700279870537768, 0.6355198, 225.0, 879, 202929, 283, 72.25846519999959
284, 4.271557729808908, 7.2264644936511395, 8.7026240097849, 0.6343866999999999, 80.0, 380, 203309, 284, 31.24769329999981
285, 3.1679638004040016, 7.215918484271741, 8.679456731852364, 0.6333103, 210.0, 816, 204125, 285, 67.1044993000005
286, 3.315237259974062, 7.22895008580505, 8.690967087833071, 0.632134, 25.0, 491, 204616, 286, 40.3450627000002
287, 3.8844067379832268, 7.233264288902283, 8.704102052847544, 0.6306121000000006, 515.0, 1200, 205816, 287, 98.5231576999995
288, 3.6048904983586523, 7.2291614287403, 8.692815526073197, 0.6290802999999999, 50.0, 502, 206318, 288, 41.39422900000045
289, 4.067148207470774, 7.2403322715759275, 8.723729558467864, 0.6277285000000004, 315.0, 1000, 207318, 289, 82.11533500000041
290, 3.4958657032867957, 7.236330957741573, 8.703831368808089, 0.626176, 105.0, 725, 208043, 290, 59.46774929999992
291, 3.7199465645086476, 7.232070205502394, 8.711780373643084, 0.6246010000000003, 435.0, 1025, 209068, 291, 83.93686119999984
292, 3.787285544685312, 7.238706388673582, 8.716741768630234, 0.6227775999999995, 140.0, 1001, 210069, 292, 82.19120930000008
293, 4.104549601598343, 7.308152667146171, 8.80238111803765, 0.6211684000000002, 135.0, 787, 210856, 293, 64.45578280000063
294, 3.9291193664294295, 7.311961120245858, 8.797408387753528, 0.6199731999999998, 75.0, 541, 211397, 294, 44.39276079999945
295, 4.111893649276362, 7.308844511139755, 8.795982874250619, 0.6188643999999996, 220.0, 691, 212088, 295, 57.01452939999945
296, 4.3254622181256615, 7.311180481766209, 8.793629499878547, 0.617797, 110.0, 495, 212583, 296, 40.6573214
297, 4.024879449230283, 7.3193678134629705, 8.8361229391659, 0.6168160000000003, 80.0, 595, 213178, 297, 48.73146100000122
298, 3.8012671555475435, 7.307173175386863, 8.795686270930979, 0.6159168999999999, 15.0, 404, 213582, 298, 33.149486700000125
299, 4.319196507115932, 7.306954814014777, 8.788926942896882, 0.6150015999999999, 10.0, 613, 214195, 299, 50.21434309999859
300, 4.2582757348156255, 7.3009624495267165, 8.768366152558004, 0.6141447999999999, 15.0, 339, 214534, 300, 27.65245330000107
301, 5.271661682690426, 7.329918061814657, 8.830441162353608, 0.6132492999999998, 160.0, 656, 215190, 301, 53.67517709999993
302, 4.304137604292833, 7.308523555611664, 8.80231167415403, 0.6114663999999995, 645.0, 1325, 216515, 302, 108.26186789999883
303, 3.7413171897240733, 7.3026481873398525, 8.79589944279522, 0.6097834, 70.0, 545, 217060, 303, 44.65751509999973
304, 4.610232186614509, 7.310428374833233, 8.804746883858439, 0.6087331, 80.0, 622, 217682, 304, 50.8495522000012
305, 4.130854046797936, 7.291224687369828, 8.774529943761138, 0.6074748999999999, 255.0, 776, 218458, 305, 63.330200800000966
306, 2.9865469925371104, 7.257614983452691, 8.74454245177455, 0.6063471999999998, 20.0, 477, 218935, 306, 39.05976869999904
307, 3.4630638337089814, 7.2570229348335555, 8.740430978964303, 0.6053284000000001, 125.0, 655, 219590, 307, 53.62282199999936
308, 3.778131528617291, 7.351957529046563, 8.847312547919456, 0.6039379, 210.0, 890, 220480, 308, 72.71882160000132
309, 4.766250502250788, 7.433329079512594, 8.958783204764417, 0.6024898, 165.0, 719, 221199, 309, 58.835926499999914
310, 4.359817402671554, 7.425867873513532, 8.937036883569288, 0.6009409, 655.0, 1002, 222201, 310, 81.82894159999887
311, 3.9017634204607496, 7.425492312170084, 8.924484276293645, 0.5996350000000001, 90.0, 449, 222650, 311, 36.70990090000123
312, 3.652206730648103, 7.400695322113623, 8.915356606759861, 0.5987620000000001, 55.0, 521, 223171, 312, 42.74780769999961
313, 4.173769855216229, 7.404322913683105, 8.910906630077397, 0.5978097999999997, 90.0, 537, 223708, 313, 44.018886299998485
314, 4.688777104705946, 7.40662641754709, 8.923233096070868, 0.5964660999999999, 290.0, 956, 224664, 314, 78.08074440000019
315, 4.790241892334329, 7.4090944002809485, 8.916809695603373, 0.5949873999999997, 180.0, 687, 225351, 315, 56.171160699999746
316, 4.421376363101342, 7.399892851249459, 8.904193757384444, 0.5937579999999999, 180.0, 679, 226030, 316, 55.52898090000053
317, 3.821714034650178, 7.375118297813213, 8.875425395009088, 0.5928417999999998, 60.0, 339, 226369, 317, 27.761221300001125
318, 3.4353471405460647, 7.3788740471929355, 8.87536486457376, 0.5919705999999997, 110.0, 629, 226998, 318, 51.39349679999941
319, 4.329515145833676, 7.377176060519376, 8.892009148230919, 0.590995, 110.0, 455, 227453, 319, 37.22816349999994
320, 4.789208647221714, 7.383694714385194, 8.891909606735428, 0.590239, 35.0, 385, 227838, 320, 31.478539399999136
321, 4.354384463630062, 7.367945639446715, 8.871500624807908, 0.5893362999999998, 135.0, 618, 228456, 321, 50.39983960000063
322, 4.354990053039331, 7.383652084057148, 8.882121166816125, 0.5881950999999999, 50.0, 650, 229106, 322, 53.03339099999903
323, 4.510167270466901, 7.380840004354283, 8.89574564228887, 0.5872995999999999, 10.0, 345, 229451, 323, 32.56713850000051
324, 3.942865227580342, 7.434123966308281, 8.935606518747594, 0.5861988999999997, 210.0, 878, 230329, 324, 81.07267909999973
325, 3.9385914739741144, 7.536999033634053, 9.078031381895375, 0.5847895, 155.0, 688, 231017, 325, 61.12672920000114
326, 4.2971423662564145, 7.545761214599837, 9.0781821377787, 0.5835681999999998, 180.0, 669, 231686, 326, 58.845461499999146
327, 4.177045318801872, 7.544849675698359, 9.081482078208298, 0.5820876999999999, 315.0, 976, 232662, 327, 93.99421540000003
328, 3.786077682021334, 7.52855140061451, 9.049989723223892, 0.5800852000000004, 560.0, 1249, 233911, 328, 121.34590829999979
329, 3.669954057786749, 7.532511814888277, 9.063122760199512, 0.5780925999999996, 265.0, 965, 234876, 329, 95.35317460000078
330, 3.9329705390246104, 7.538698233431401, 9.071096726912486, 0.5761576, 500.0, 1185, 236061, 330, 119.70298550000007
331, 4.067318013901986, 7.525460669742757, 9.058601740017608, 0.5743746999999999, 245.0, 796, 236857, 331, 82.90352800000073
332, 3.7652226716390773, 7.5115548394426535, 9.036959268789753, 0.5731741, 120.0, 538, 237395, 332, 56.17795190000106
333, 5.036444743453052, 7.524665365893019, 9.067093977836265, 0.5722695999999998, 30.0, 467, 237862, 333, 45.88497970000026
334, 4.430817522770106, 7.532668024171388, 9.06235144474968, 0.5712309999999999, 180.0, 687, 238549, 334, 66.7762543000008
335, 4.4725794096949825, 7.525326905398345, 9.054201266116069, 0.5700609999999998, 135.0, 613, 239162, 335, 59.98490069999934
336, 3.6440582408286906, 7.509455105816876, 9.035557568868, 0.5689018000000001, 105.0, 675, 239837, 336, 64.71619570000075
337, 4.437846177255017, 7.735597594623091, 9.299502488979012, 0.5679694000000001, 75.0, 361, 240198, 337, 34.60813849999977
338, 4.316044012079715, 7.906714687197227, 9.514506069693978, 0.5669586999999997, 240.0, 762, 240960, 338, 71.95040230000086
339, 4.478407205178199, 7.894149094711913, 9.498136025674398, 0.5655285999999998, 115.0, 827, 241787, 339, 82.89689889999863
340, 3.746142388433445, 7.879219658298579, 9.482168543102897, 0.5641929999999997, 60.0, 657, 242444, 340, 63.94284039999911
341, 3.9967586958101764, 7.872603899051129, 9.484807450183402, 0.5630068, 185.0, 661, 243105, 341, 64.04325860000063
342, 4.540496747091979, 7.88413405418396, 9.477143826363962, 0.5618430999999999, 155.0, 632, 243737, 342, 61.63166300000012
343, 4.090435005264518, 7.8587182730804255, 9.453099344983514, 0.5606911000000002, 145.0, 648, 244385, 343, 64.25006460000077
344, 4.133726430311799, 7.8523890867829325, 9.447636282444, 0.5595319, 180.0, 640, 245025, 344, 62.210581999999704
345, 4.005812250522677, 7.829209940254764, 9.417351485207544, 0.5582475999999998, 210.0, 787, 245812, 345, 75.3538494000004
346, 3.849884868774782, 7.8339830745668975, 9.422053311151616, 0.5563152999999998, 700.0, 1360, 247172, 346, 130.13396009999997
347, 4.661419909574051, 7.852718085423779, 9.467132592243884, 0.5545882, 205.0, 559, 247731, 347, 53.5502462000004
348, 4.006951213674208, 7.841810456419413, 9.437669385499307, 0.5534749, 155.0, 678, 248409, 348, 64.76014030000078
349, 4.114464800048303, 7.83356279701684, 9.39913555037393, 0.5525146, 80.0, 389, 248798, 349, 37.08796660000007
350, 3.1415914473515616, 7.84944101545012, 9.429468801099647, 0.5518072000000002, 120.0, 397, 249195, 350, 37.675613900000826
351, 4.363882541254665, 7.856173578540931, 9.426803567436304, 0.5510494, 85.0, 445, 249640, 351, 43.281155200000285
352, 3.7970404964779676, 7.8882562011598125, 9.475859719302814, 0.5501935, 45.0, 506, 250146, 352, 48.931705999999394
353, 4.0260981995873, 7.993711527482963, 9.624007042543388, 0.5493006999999998, 110.0, 486, 250632, 353, 47.341679200000726
354, 4.178646135276982, 7.978317620262267, 9.601052189630176, 0.5484097, 45.0, 504, 251136, 354, 49.245724899999914
355, 4.411537704521959, 7.981665337302468, 9.597120897119696, 0.5474611, 55.0, 550, 251686, 355, 53.77415790000123
356, 4.267477730880868, 7.960649850919126, 9.580045918087887, 0.5461984, 195.0, 853, 252539, 356, 83.95686399999977
357, 3.6354765126143476, 7.933011193096809, 9.53362277467931, 0.5448061, 155.0, 694, 253233, 357, 67.91774860000078
358, 3.5774234271779353, 7.9314296853785615, 9.538684326288651, 0.5432994999999999, 385.0, 980, 254213, 358, 94.52563759999975
359, 3.842348640815979, 7.9364615128899265, 9.543159772785156, 0.5416155999999998, 290.0, 891, 255104, 359, 86.30020039999908
360, 4.410620689143737, 7.939242828389009, 9.542452258865039, 0.5399496999999999, 210.0, 960, 256064, 360, 93.13871499999914
361, 3.8530704191592937, 7.91207184702018, 9.510413933248028, 0.5387022999999999, 80.0, 426, 256490, 361, 41.241215699999884
362, 3.783176706603677, 7.898803689826327, 9.493061978043675, 0.5373838, 295.0, 1039, 257529, 362, 100.4871480999991
363, 3.5447027593450673, 7.882713494511346, 9.467205668136392, 0.5359797999999999, 80.0, 521, 258050, 363, 50.09009440000045
364, 4.396382774336524, 7.897287822538806, 9.499193922165901, 0.5348412999999999, 285.0, 744, 258794, 364, 72.9760927999996
365, 4.156594525520078, 7.906055330352908, 9.504500505286753, 0.5330709999999995, 290.0, 1223, 260017, 365, 119.8226254000001
366, 3.8545204779664837, 8.04710837849846, 9.676160740901313, 0.5310937000000002, 320.0, 974, 260991, 366, 94.60329699999966
367, 4.372627966968171, 8.04722865752721, 9.673865672035104, 0.5296105000000001, 120.0, 674, 261665, 367, 65.1913558999986
368, 4.68096390643876, 8.045559530020698, 9.676297031567575, 0.5283172000000003, 140.0, 763, 262428, 368, 73.65346379999937
369, 3.799126211840373, 8.025279630234827, 9.639902030155335, 0.5266477000000003, 260.0, 1092, 263520, 369, 106.52300640000067
370, 3.690570633591521, 8.014764633505516, 9.617070814530797, 0.5250871, 90.0, 642, 264162, 370, 63.02087980000033
371, 4.16282298443494, 8.025478043436577, 9.63672726698389, 0.523756, 135.0, 837, 264999, 371, 83.95176259999971
372, 4.18365952262172, 8.032378658541926, 9.64960271164223, 0.5225167000000001, 30.0, 540, 265539, 372, 53.80187920000026
373, 4.397123931384668, 8.038342244741393, 9.664472349290925, 0.5211451000000002, 270.0, 984, 266523, 373, 100.40453640000123
374, 4.689516925983292, 8.030239206080815, 9.654525345177959, 0.519634, 50.0, 695, 267218, 374, 67.33125180000025
375, 3.8905550289886843, 8.009757424552406, 9.632312301484998, 0.5181886, 140.0, 911, 268129, 375, 89.98350369999935
376, 3.796110665813709, 8.012029887487492, 9.619739644229412, 0.5170230999999998, 35.0, 384, 268513, 376, 37.91875440000149
377, 3.873921307352754, 8.01600701801784, 9.631519767311547, 0.5157765999999999, 315.0, 1001, 269514, 377, 96.32932959999926
378, 4.395987462633707, 8.03122720286602, 9.669511147371427, 0.5144185000000001, 75.0, 508, 270022, 378, 48.2576149000015
379, 3.6218188041017885, 8.043404242375514, 9.65931412667939, 0.5135751999999999, 90.0, 429, 270451, 379, 40.98941790000026
380, 4.071950227764375, 8.035012340180263, 9.668580055236816, 0.5127193, 80.0, 522, 270973, 380, 49.38440619999892
381, 3.9511534071543353, 8.035898413294767, 9.6584977599362, 0.5116708000000001, 120.0, 643, 271616, 381, 60.68254999999954
382, 3.919004246935077, 8.0161393474345, 9.628259322652415, 0.5106222999999998, 45.0, 522, 272138, 382, 49.58186879999994
383, 3.6933181333052447, 8.015262600263892, 9.629308423688334, 0.5095386999999998, 205.0, 682, 272820, 383, 65.02297680000083
384, 3.603624513656172, 7.99883355957944, 9.60969089686638, 0.5082327999999998, 240.0, 769, 273589, 384, 72.8071615000008
385, 2.8124474598029954, 7.982062375367577, 9.578345891848132, 0.5071789, 50.0, 402, 273991, 385, 38.189369499999884
386, 3.7916763161690974, 8.002548902726573, 9.614936610205854, 0.5060665000000001, 415.0, 834, 274825, 386, 78.98593839999921
387, 4.241571500778578, 8.00631717593666, 9.628520392154773, 0.5047515999999999, 180.0, 627, 275452, 387, 56.93725069999891
388, 3.068126770431059, 7.9867341961666565, 9.598340253756517, 0.5033692, 160.0, 909, 276361, 388, 90.90914599999996
389, 4.066336478762053, 7.999002265341488, 9.613281623816784, 0.5016763000000001, 240.0, 972, 277333, 389, 91.9274007999993
390, 3.742115896500197, 7.974402539042019, 9.580938197142325, 0.5001310000000002, 160.0, 745, 278078, 390, 70.72793579999961
391, 3.960094372375939, 7.990417064013206, 9.600701323212636, 0.4989772000000002, 100.0, 537, 278615, 391, 50.09128039999996
392, 3.8832556231413036, 7.982391937822103, 9.584493538737297, 0.49791789999999975, 125.0, 640, 279255, 392, 59.312981499999296
393, 3.6519581203538816, 7.959541701576085, 9.56558274296881, 0.4966002999999998, 410.0, 824, 280079, 393, 77.63487650000025
394, 3.77018278465976, 7.845250489964335, 9.437559578554733, 0.49508559999999985, 210.0, 859, 280938, 394, 82.07731729999978
395, 3.4287242486838894, 7.864872230909258, 9.444879424509578, 0.4939686999999999, 105.0, 382, 281320, 395, 36.50436710000031
396, 4.475552781688092, 7.8865861336987715, 9.472167545691468, 0.49314609999999987, 140.0, 532, 281852, 396, 49.8345330000011
397, 3.9118284430318666, 7.864698593361863, 9.455222705729957, 0.4922038, 105.0, 515, 282367, 397, 48.810462800000096
398, 3.9566178384964816, 7.868022803877508, 9.456432520080703, 0.49093299999999973, 195.0, 897, 283264, 398, 84.22770490000039
399, 4.382726607296059, 7.870249668144849, 9.447654161320996, 0.48954159999999974, 110.0, 649, 283913, 399, 61.21184750000066
400, 3.842266799551662, 7.860036352299786, 9.439786822752964, 0.4882572999999999, 135.0, 778, 284691, 400, 73.1342222000003
401, 4.3014349062613375, 7.869442610216391, 9.440620655372713, 0.48704140000000007, 105.0, 573, 285264, 401, 54.19438000000082
402, 4.146721844434488, 7.860422035433212, 9.43282257136059, 0.4856670999999999, 470.0, 954, 286218, 402, 91.6540514999997
403, 3.7932783854400327, 7.847043420026402, 9.42541820617493, 0.48405699999999985, 210.0, 835, 287053, 403, 79.1585425000012
404, 4.088794400222561, 7.840302232139469, 9.40606785512341, 0.4824369999999999, 270.0, 965, 288018, 404, 92.28419810000014
405, 3.5844585196057843, 7.820352806059342, 9.388849915072905, 0.48092409999999974, 140.0, 716, 288734, 405, 64.73575639999945
406, 3.843521696010065, 7.808561115659357, 9.386651657503597, 0.47953989999999985, 210.0, 822, 289556, 406, 73.72650090000025
407, 4.2284404612380095, 7.963164515864089, 9.574259877043145, 0.4781367999999998, 275.0, 737, 290293, 407, 65.80293230000098
408, 3.9232951380750714, 8.200115910698386, 9.867430141392877, 0.4768614999999997, 185.0, 680, 290973, 408, 60.68014399999993
409, 3.479772358437669, 8.17573777301666, 9.803283542655299, 0.47563209999999995, 135.0, 686, 291659, 409, 61.17548270000043
410, 4.152855117224595, 8.168786248740028, 9.7999469462563, 0.47440269999999995, 140.0, 680, 292339, 410, 60.58210229999895
411, 3.815117317502913, 8.193219596061153, 9.815934620041778, 0.4725487, 365.0, 1380, 293719, 411, 122.3770158999996
412, 3.718387185363099, 8.211422943510115, 9.860774785280228, 0.47084590000000004, 110.0, 512, 294231, 412, 45.84968889999982
413, 2.9767242800490816, 8.185811744961061, 9.802000007724525, 0.46966329999999995, 380.0, 802, 295033, 413, 74.23851300000024
414, 3.505126060732515, 8.169739589030609, 9.7939216151382, 0.4685256999999998, 110.0, 462, 295495, 414, 41.24929220000013
415, 4.252148314320211, 8.18581072740917, 9.809190338170982, 0.4675410999999999, 105.0, 632, 296127, 415, 57.69012300000031
416, 3.7540422832350138, 8.187873294397953, 9.815046080557824, 0.466345, 105.0, 697, 296824, 416, 63.03550240000004
417, 3.743662585033176, 8.193670940883269, 9.815695539948903, 0.46465390000000006, 270.0, 1182, 298006, 417, 109.39778339999975
418, 3.4845729529686604, 8.19421282936545, 9.824197521510733, 0.46296279999999995, 110.0, 697, 298703, 418, 62.406901899999866
419, 3.2731557059755074, 8.173368869729304, 9.792378871595089, 0.4616118999999998, 210.0, 804, 299507, 419, 73.08228910000071
420, 3.866593958476236, 8.274582230478845, 9.913503725714925, 0.4603005999999998, 105.0, 653, 300160, 420, 55.31160960000125
421, 3.767091322301605, 8.589767109650085, 10.31006576572059, 0.4590055, 210.0, 786, 300946, 421, 65.02021530000093
422, 4.04258422762961, 8.574750713399938, 10.289303323384878, 0.4579650999999998, 75.0, 370, 301316, 422, 30.730088299998897
423, 3.460421158199922, 8.571672298562781, 10.285715897122925, 0.4568743, 205.0, 842, 302158, 423, 72.24570020000101
424, 3.538363439956708, 8.59229000575507, 10.301171275750914, 0.4555135, 125.0, 670, 302828, 424, 60.14906379999957
425, 3.960670082428204, 8.595166896478817, 10.320058950600913, 0.45434709999999995, 105.0, 626, 303454, 425, 56.29218039999978
426, 3.8407112704507544, 8.587542661523397, 10.306136948872457, 0.4529700999999998, 200.0, 904, 304358, 426, 81.25328230000014
427, 3.763965946240503, 8.587518801454637, 10.299402492293895, 0.4514976999999998, 155.0, 732, 305090, 427, 65.49278299999787
428, 3.8889450151402283, 8.61585391431176, 10.335200317024125, 0.4501305999999998, 155.0, 787, 305877, 428, 70.71666710000136
429, 3.3879973111730632, 8.592043009173036, 10.304483870104686, 0.4485609999999998, 460.0, 957, 306834, 429, 85.61711949999881
430, 3.3402043187131514, 8.597663962738562, 10.325579818135346, 0.44707150000000007, 110.0, 698, 307532, 430, 62.5808586000021
431, 3.7083921520507825, 8.611632163761652, 10.323601403431585, 0.4458276999999998, 165.0, 684, 308216, 431, 61.423866900000576
432, 3.9734804370289756, 8.60663906006586, 10.324225687299457, 0.4447395999999999, 120.0, 525, 308741, 432, 46.99183730000004
433, 3.652759981819206, 8.599419026253118, 10.30716438249203, 0.44387919999999986, 110.0, 431, 309172, 433, 38.693684900001244
434, 3.706317300756013, 8.59244461980848, 10.306359935971075, 0.4426435, 215.0, 942, 310114, 434, 84.4226267999984
435, 4.285541744008951, 8.4626168888474, 10.143948232554026, 0.4411036000000001, 195.0, 769, 310883, 435, 68.84708710000268
436, 2.90940306574534, 8.44720834636232, 10.119326755760959, 0.4400353000000001, 70.0, 418, 311301, 436, 37.289204799999425
437, 3.3007631534182824, 8.435247043007914, 10.108148198032817, 0.4390713999999998, 110.0, 653, 311954, 437, 58.47753450000164
438, 3.6222980882227422, 8.43850641131401, 10.118309386968612, 0.4377636999999999, 180.0, 800, 312754, 438, 71.84108769999875
439, 3.6220376251078954, 8.416390190471652, 10.102995174357817, 0.4361535999999999, 215.0, 989, 313743, 439, 91.91088469999886
440, 3.4659623277437, 8.40329055137035, 10.075272130716533, 0.4349196999999999, 30.0, 382, 314125, 440, 41.88292889999866
441, 3.6302002339546844, 8.403159171118773, 10.077708855607456, 0.4340970999999999, 25.0, 532, 314657, 441, 61.893872000000556
442, 4.391752508852693, 8.392700464642859, 10.074532156272173, 0.4329172, 180.0, 779, 315436, 442, 73.70761800000037
443, 3.696574819115137, 8.41792847789773, 10.095755421762314, 0.43142590000000025, 215.0, 878, 316314, 443, 81.51921910000237
444, 3.3538108629246173, 8.407473547336382, 10.078302034964928, 0.43007410000000007, 105.0, 624, 316938, 444, 56.73887560000003
445, 3.7791895100514497, 8.404706437178332, 10.078245821223918, 0.42844330000000014, 500.0, 1188, 318126, 445, 111.09169380000094
446, 3.8159550858046813, 8.426787005464728, 10.095180009789857, 0.4266486999999999, 160.0, 806, 318932, 446, 75.79992700000003
447, 4.4151648496451115, 8.551571656812657, 10.266771600642457, 0.42458499999999993, 360.0, 1487, 320419, 447, 138.6150162999984
448, 3.454563948580676, 8.863923512456362, 10.63418661541951, 0.4225428999999999, 155.0, 782, 321201, 448, 77.06363350000174
449, 3.6783131500288713, 8.865279278285067, 10.625547710667805, 0.4211362, 180.0, 781, 321982, 449, 72.82532029999857
450, 3.734411649508019, 8.872034109164954, 10.63744671558862, 0.41984200000000005, 200.0, 657, 322639, 450, 63.04093110000031
451, 3.665739804348618, 8.882636983558614, 10.651121422096535, 0.4189105, 80.0, 378, 323017, 451, 38.6971764000009
452, 3.6147935508800533, 8.879239899052234, 10.649870455579748, 0.4177179999999999, 260.0, 947, 323964, 452, 90.53020900000047
453, 3.715727367245954, 8.900687580266275, 10.672833987503997, 0.4159945, 425.0, 968, 324932, 453, 91.70316310000271
454, 4.12745172829385, 8.886108168826741, 10.658008107713833, 0.41441680000000014, 110.0, 785, 325717, 454, 75.84354370000074
455, 3.916669963173164, 8.913425519484882, 10.68155820240346, 0.413362, 105.0, 387, 326104, 455, 37.483786599997984
456, 3.9983701184510427, 8.8976185928278, 10.658748613821494, 0.4118814999999999, 315.0, 1258, 327362, 456, 118.88517779999893
457, 3.6924333569599175, 8.915775030258803, 10.698848278201812, 0.40997979999999995, 185.0, 855, 328217, 457, 80.88000319999992
458, 3.8856839898355218, 8.90869325284332, 10.669622378920035, 0.4087440999999999, 35.0, 518, 328735, 458, 48.4033210000016
459, 3.5005617561887523, 8.903964800912826, 10.669009917420768, 0.4079484999999999, 80.0, 366, 329101, 459, 34.31401530000221
460, 3.747772093520177, 8.911367929711634, 10.683420034087433, 0.4069135, 175.0, 784, 329885, 460, 74.25078220000069
461, 3.4461972358168205, 9.117609430599764, 10.933984782654425, 0.40558510000000003, 320.0, 692, 330577, 461, 64.5091199999988
462, 5.118096699626129, 9.186811214901622, 11.0080156062757, 0.40444119999999995, 110.0, 579, 331156, 462, 53.64526919999844
463, 4.364234432210373, 9.160331281175624, 10.984177761996815, 0.4031542000000001, 335.0, 851, 332007, 463, 80.82505669999955
464, 4.291162245711962, 9.184157891328944, 11.005357605080272, 0.4017690999999999, 155.0, 688, 332695, 464, 66.53895829999965
465, 5.651511915775288, 9.187940709570418, 11.011137866700619, 0.4008357999999999, 95.0, 349, 333044, 465, 32.88826110000082
466, 3.482383781529124, 9.13006554691458, 10.947195457788322, 0.39973059999999977, 290.0, 879, 333923, 466, 88.99028389999876
467, 4.073331818237924, 9.145401863263231, 10.948331022188874, 0.39835719999999986, 180.0, 647, 334570, 467, 66.53864639999665
468, 3.9513931789206236, 9.149481870227197, 10.962753240929104, 0.39679119999999984, 490.0, 1093, 335663, 468, 114.31417409999995
469, 4.015411984493771, 9.150376308872849, 10.974377023155089, 0.39502810000000016, 240.0, 866, 336529, 469, 91.2655803000016
470, 4.0544917720028115, 9.138912584811827, 10.950331055363522, 0.3938931999999999, 95.0, 395, 336924, 470, 41.71536940000078
471, 3.8900862913519365, 9.160769307524694, 10.99015559805567, 0.39269079999999984, 215.0, 941, 337865, 471, 97.80688290000035
472, 4.456160583648926, 9.166182284232898, 10.987367849105445, 0.39096640000000005, 450.0, 975, 338840, 472, 102.8743910000012
473, 4.104102252239592, 9.15887779523626, 10.976257595166349, 0.3889675, 445.0, 1246, 340086, 473, 129.19949500000075
474, 4.875993609354454, 9.261651337294662, 11.094512217689685, 0.38748340000000003, 95.0, 403, 340489, 474, 41.24468489999708
475, 4.1161269478952605, 9.250310159245185, 11.077628480418213, 0.3862468000000001, 285.0, 971, 341460, 475, 104.71188780000011
476, 4.589723945240383, 9.266932611172516, 11.113809553022678, 0.38458180000000003, 320.0, 879, 342339, 476, 95.05283910000071
477, 3.588012120150544, 9.269962933972058, 11.10998511009509, 0.38308689999999995, 155.0, 782, 343121, 477, 83.5172066999985
478, 4.163080061512503, 9.279995200645864, 11.112293933754536, 0.3816594999999999, 215.0, 804, 343925, 478, 81.23056740000175
479, 4.073833031805954, 9.248187546555476, 11.08613892373322, 0.3800016999999999, 495.0, 1038, 344963, 479, 105.57818730000145
480, 4.976649669888175, 9.293454628651057, 11.138374044161822, 0.37839159999999983, 250.0, 751, 345714, 480, 76.5953640000007
481, 4.82222865178994, 9.283163473695891, 11.129390582878719, 0.37685529999999995, 265.0, 956, 346670, 481, 110.16283490000205
482, 4.4630724217808035, 9.265586937798394, 11.11847032134296, 0.37522540000000004, 230.0, 855, 347525, 482, 91.10584190000009
483, 4.917273828169841, 9.26733124977329, 11.120687921700528, 0.3734443, 345.0, 1124, 348649, 483, 118.04433970000173
484, 3.760436637895276, 9.2681088996656, 11.114601711311726, 0.3719871999999999, 20.0, 495, 349144, 484, 50.153168100001494
485, 4.6211841526920105, 9.267093255396889, 11.112520321038321, 0.37100079999999996, 60.0, 601, 349745, 485, 61.64313200000106
486, 4.1736033896409905, 9.233008124611594, 11.076576837450633, 0.3700935999999999, 65.0, 407, 350152, 486, 43.204740299999685
487, 4.268564012400601, 9.210984910737483, 11.051345036007943, 0.36923680000000003, 85.0, 545, 350697, 487, 55.81518169999981
488, 3.477300537009555, 9.198554527328675, 11.025076326117459, 0.36814869999999994, 355.0, 664, 351361, 488, 68.76737659999708
489, 4.911497568434223, 9.21374282262004, 11.04072396552309, 0.3665359, 385.0, 1128, 352489, 489, 121.27811909999946
490, 4.705177946044849, 9.20294485092163, 11.030345584184696, 0.3651696999999999, 70.0, 390, 352879, 490, 40.020271099998354
491, 4.817419478168206, 9.2103393880971, 11.030657127767077, 0.36396640000000013, 335.0, 947, 353826, 491, 99.92885190000015
492, 4.842134103147739, 9.209774696102182, 11.049111308291772, 0.36225549999999995, 230.0, 954, 354780, 492, 101.24859419999848
493, 4.719736780824978, 9.213058036619802, 11.052190944867553, 0.36050319999999986, 440.0, 993, 355773, 493, 102.16526449999947
494, 4.526444613472405, 9.21048888200948, 11.048435356907504, 0.3591442, 60.0, 517, 356290, 494, 54.361068400001386
495, 4.374424493312835, 9.221099081157167, 11.059457694159613, 0.35794989999999993, 310.0, 810, 357100, 495, 84.64331789999778
496, 4.155770252483639, 9.191826443464276, 11.026180119789435, 0.3565809999999999, 225.0, 711, 357811, 496, 72.19926159999886
497, 4.552053320460038, 9.191932536319257, 11.03151470827065, 0.3555297999999999, 45.0, 457, 358268, 497, 49.17159190000166
498, 4.59844596526202, 9.193747818570177, 11.019681101887166, 0.3545829999999998, 185.0, 595, 358863, 498, 61.76708470000085
499, 4.216211121151888, 9.193348125214094, 11.021109087351661, 0.3532302999999998, 210.0, 908, 359771, 499, 91.66824220000126
500, 4.715211923653481, 9.231979585258882, 11.0690422736073, 0.3514636000000001, 415.0, 1055, 360826, 500, 95.8012118000006
501, 4.7978415492370985, 9.221237412853354, 11.058441862975352, 0.34975360000000005, 240.0, 845, 361671, 501, 78.76372730000003
502, 4.799825452959414, 9.230554288546713, 11.064617443506075, 0.3483819999999999, 120.0, 679, 362350, 502, 60.59634179999921
503, 4.567846547002378, 9.233369115063601, 11.057702954772793, 0.34741900000000003, 110.0, 391, 362741, 503, 34.37704170000143
504, 5.08735750251768, 9.23382641757876, 11.063366621669438, 0.34621929999999973, 305.0, 942, 363683, 504, 79.64137329999721
505, 5.242311534259015, 9.206949167506277, 11.038924354473986, 0.3447649, 165.0, 674, 364357, 505, 57.199968900000385
506, 4.596769881899693, 9.179504539246624, 11.018404975103861, 0.34356519999999996, 105.0, 659, 365016, 506, 57.677481499998976
507, 4.346700950153172, 9.194556619226933, 11.01643003821373, 0.3423961, 110.0, 640, 365656, 507, 58.439511100001255
508, 4.127536475234869, 9.170302415694993, 10.993577496333948, 0.3414718, 75.0, 387, 366043, 508, 35.52968019999753
509, 5.213395532670912, 9.180081660930927, 11.015224209460584, 0.3407139999999999, 110.0, 455, 366498, 509, 41.814323099999456
510, 4.580602175883345, 9.177940888700501, 10.996322144385552, 0.3391722999999998, 375.0, 1258, 367756, 510, 114.46854019999955
511, 4.514446903915369, 9.191565835198691, 11.026140824768895, 0.3375756999999999, 180.0, 516, 368272, 511, 47.27608700000201
512, 4.563667650547187, 9.167404209467593, 10.99104880931104, 0.33614560000000004, 290.0, 1073, 369345, 512, 97.60916010000074
513, 4.217957206110266, 9.167324848991028, 10.993052291360131, 0.3348432999999999, 30.0, 374, 369719, 513, 33.95728340000278
514, 4.920137029349595, 9.25806866659151, 11.093654864317887, 0.3334770999999999, 250.0, 1144, 370863, 514, 104.19921760000216
515, 4.192362912869779, 9.292588822939328, 11.146879921191017, 0.3318544, 155.0, 659, 371522, 515, 60.01127469999847
516, 5.621580593469666, 9.291669030244604, 11.1494987717948, 0.3305602, 160.0, 779, 372301, 516, 70.99106100000063
517, 5.608914588237069, 9.291359265645346, 11.162093826981842, 0.3295296999999999, 105.0, 366, 372667, 517, 33.524710500001675
518, 4.746396166529378, 9.271842766424705, 11.130393132053573, 0.3283650999999999, 150.0, 928, 373595, 518, 84.61329839999962
519, 4.647307321194589, 9.270338938930841, 11.124981305730625, 0.32661549999999984, 225.0, 1016, 374611, 519, 92.44086679999964
520, 4.8787235314220325, 9.287662946260893, 11.123214581433464, 0.32530329999999996, 85.0, 442, 375053, 520, 40.42715130000215
521, 5.2172663574336005, 9.277721755231013, 11.130042784331275, 0.3243564999999999, 130.0, 610, 375663, 521, 55.768051099999866
522, 4.629584996725258, 9.25677571531202, 11.103393468700471, 0.3228192999999999, 305.0, 1098, 376761, 522, 100.10047660000055
523, 4.788300311708165, 9.264062136804272, 11.101683829073421, 0.3210795999999999, 240.0, 835, 377596, 523, 76.1336865000012
524, 5.546582713123583, 9.264151928499452, 11.094394028630946, 0.3197241999999999, 125.0, 671, 378267, 524, 61.71311620000051
525, 4.742623673564242, 9.261481957842213, 11.10044705128485, 0.3181914999999998, 240.0, 1032, 379299, 525, 94.08723219999956
526, 4.854625985119492, 9.301793591181438, 11.156203013658523, 0.31639870000000003, 240.0, 960, 380259, 526, 87.6754628000017
527, 5.188553868143249, 9.42893857348819, 11.30347332461127, 0.31485609999999997, 150.0, 754, 381013, 527, 69.05626370000027
528, 4.607897286852839, 9.399771066485455, 11.281167224129254, 0.3136725999999999, 120.0, 561, 381574, 528, 51.1806779000035
529, 5.382554600666177, 9.42185850710067, 11.303818205212059, 0.312274, 500.0, 993, 382567, 529, 90.66007220000029
530, 5.313549915318177, 9.426751026260519, 11.293404167389202, 0.3108987999999999, 85.0, 535, 383102, 530, 48.77314380000098
531, 4.797532356760882, 9.419462583444497, 11.292710669405826, 0.3098178999999999, 125.0, 666, 383768, 531, 60.89620840000134
532, 4.9982240286443425, 9.390902166995291, 11.265098508906043, 0.30808539999999995, 200.0, 1259, 385027, 532, 115.05568100000164
533, 5.143741112027783, 9.370467078872025, 11.23952439520508, 0.3060307, 335.0, 1024, 386051, 533, 93.28010369999902
534, 5.671267025419691, 9.399500700650295, 11.264876642279862, 0.30445749999999994, 155.0, 724, 386775, 534, 66.31432889999996
535, 4.55765175664356, 9.383469251768668, 11.246783922632765, 0.3028716999999998, 265.0, 1038, 387813, 535, 94.89242659999945
536, 5.071131969415225, 9.373529553413391, 11.230221044100247, 0.30146949999999995, 80.0, 520, 388333, 536, 47.65199520000169
537, 3.6702163830725816, 9.34757456118173, 11.196310342663397, 0.3006315999999999, 110.0, 411, 388744, 537, 37.42763170000035
538, 4.934759710771569, 9.35914629831843, 11.224286611291065, 0.2996613999999999, 140.0, 667, 389411, 538, 60.413669199999276
539, 4.509289661757854, 9.294260881750624, 11.143824988307216, 0.29824660000000003, 475.0, 905, 390316, 539, 82.07592440000008
540, 4.706549534741487, 9.21492591346662, 11.037275829792724, 0.29682099999999995, 105.0, 679, 390995, 540, 61.70409640000071
541, 4.582293214532884, 9.210592373557713, 11.020620219949363, 0.29521630000000015, 375.0, 1104, 392099, 541, 100.18747509999957
542, 4.856718255562344, 9.173760214619254, 10.990024184084486, 0.2934396999999999, 535.0, 870, 392969, 542, 78.81555560000197
543, 4.629245138861412, 9.169155976938647, 10.979962498642678, 0.2918827, 280.0, 860, 393829, 543, 77.9952431999991
544, 4.824706043150806, 9.17047042413738, 10.986590971110898, 0.290395, 140.0, 793, 394622, 544, 72.09662789999857
545, 4.213492815678987, 9.189310852641022, 11.001729462413186, 0.28936719999999994, 80.0, 349, 394971, 545, 31.792455200000404
546, 4.4687078497010075, 9.179176061024922, 10.993401574231907, 0.28830159999999994, 170.0, 835, 395806, 546, 75.96128780000072
547, 4.9416858225769635, 9.197710403790303, 11.027404418597392, 0.28727379999999986, 15.0, 307, 396113, 547, 28.0489376000005
548, 3.800462810845857, 9.170548779241155, 10.991496453124485, 0.28635669999999996, 180.0, 712, 396825, 548, 64.62229099999968
549, 4.482746440331673, 9.176017957387561, 10.997011245293761, 0.2851776999999999, 135.0, 598, 397423, 549, 54.29723099999683
550, 4.509062772399278, 9.185105212448818, 11.003835886263, 0.2842848999999998, 50.0, 394, 397817, 550, 35.886533099997905
551, 5.093321091519904, 9.188804113210528, 11.008848512371856, 0.2831761, 215.0, 838, 398655, 551, 75.94214529999954
552, 4.786052161806565, 9.1934217055098, 11.01809024162033, 0.28202499999999986, 80.0, 441, 399096, 552, 40.13068509999721
553, 5.032670249794163, 9.19201816542674, 11.010686739689886, 0.28099089999999993, 180.0, 708, 399804, 553, 64.3406584000004
554, 5.239562621681478, 9.439790931671702, 11.313771715963075, 0.2796661, 135.0, 764, 400568, 554, 69.44994029999725
555, 4.734151794171248, 9.504443304228241, 11.386646968062205, 0.27822519999999995, 200.0, 837, 401405, 555, 76.01645859999917
556, 4.5344117274785125, 9.50482029163062, 11.380584117464615, 0.2766555999999999, 535.0, 907, 402312, 556, 82.67670400000134
557, 5.019199834821316, 9.515206716610836, 11.408437085151672, 0.27537129999999993, 95.0, 520, 402832, 557, 47.28387400000065
558, 4.8372988513470325, 9.509552425248462, 11.40056731426889, 0.27422199999999997, 135.0, 757, 403589, 558, 69.3387561999989
559, 4.811578805435379, 9.492415485741958, 11.37620663193037, 0.2725866999999999, 255.0, 1060, 404649, 559, 96.57116900000256
560, 5.081703486131039, 9.494641427621952, 11.370334949835083, 0.2707785999999999, 390.0, 949, 405598, 560, 86.3029873000014
561, 4.688321737686495, 9.476062443670113, 11.358179060260902, 0.2692035999999999, 170.0, 801, 406399, 561, 73.0332684999994
562, 4.8805631520315105, 9.475669181082543, 11.357844421201422, 0.26763039999999994, 260.0, 947, 407346, 562, 86.07009339999786
563, 4.58644872995759, 9.468112148785039, 11.34866614942379, 0.266428, 75.0, 389, 407735, 563, 35.66055140000026
564, 5.292974577484459, 9.47018544953445, 11.342823753356933, 0.2654254, 140.0, 725, 408460, 564, 64.80992920000062
565, 4.319455676614899, 9.459515312817336, 11.339523556110302, 0.26429860000000005, 105.0, 527, 408987, 565, 43.442781800000375
566, 4.20917130394922, 9.458707200802438, 11.345460599030906, 0.26338149999999994, 130.0, 492, 409479, 566, 40.748679600001196
567, 5.091215183169155, 9.823363167642425, 11.780743138264802, 0.2619828999999999, 175.0, 1062, 410541, 567, 87.54148019999775
568, 4.164471001029015, 10.172778261184693, 12.188166522979737, 0.2605770999999999, 100.0, 500, 411041, 568, 41.192798299998685
569, 5.124688813303198, 10.196145818347023, 12.202976576487224, 0.2597490999999999, 75.0, 420, 411461, 569, 34.65933710000172
570, 4.919162527278617, 10.159626307310882, 12.175096146854354, 0.2589337, 105.0, 486, 411947, 570, 40.24387479999859
571, 4.960047628513106, 10.177528129013595, 12.18470820007621, 0.25803369999999987, 100.0, 514, 412461, 571, 42.46808879999662
572, 5.560275339782858, 10.183583140621066, 12.200804862064036, 0.25670529999999997, 250.0, 962, 413423, 572, 78.93932219999988
573, 5.037936425507069, 10.194649309158326, 12.217944871902466, 0.2549395, 130.0, 1000, 414423, 573, 82.08497020000141
574, 4.649288993036708, 10.221377359425087, 12.236074569530057, 0.25320159999999997, 260.0, 931, 415354, 574, 76.34093099999882
575, 4.464809920453856, 10.215452735305679, 12.241353286073563, 0.2513485, 310.0, 1128, 416482, 575, 92.4154125999994
576, 5.293052481466955, 10.247282234002137, 12.280474174432538, 0.24910300000000005, 350.0, 1367, 417849, 576, 111.9296992999989
577, 5.152488893959152, 10.273100735181831, 12.306614839064965, 0.2471949999999999, 150.0, 753, 418602, 577, 61.7312282999992
578, 5.427036133269601, 10.289303327718311, 12.32474360933313, 0.24557139999999988, 405.0, 1051, 419653, 578, 86.14759059999778
579, 5.544946780402539, 10.32205032533215, 12.378264484317622, 0.24423489999999992, 115.0, 434, 420087, 579, 35.636125099998026
580, 5.245685036140576, 10.375801889519943, 12.416180649138333, 0.24333129999999992, 90.0, 570, 420657, 580, 46.6167518000002
581, 5.774628393221319, 10.381977988962541, 12.448387182246872, 0.24220269999999997, 125.0, 684, 421341, 581, 56.20370379999804
582, 4.7288152866394855, 10.339707712973318, 12.378441515504388, 0.24083379999999996, 195.0, 837, 422178, 582, 68.5443254999991
583, 4.597700384301199, 10.334842385158954, 12.381421361476297, 0.2393775999999999, 180.0, 781, 422959, 583, 63.96724899999754
584, 5.506265769587769, 10.332896224221031, 12.38939718938136, 0.23785569999999995, 175.0, 910, 423869, 584, 74.74382970000079
585, 5.103685831803203, 10.326871770556057, 12.389023256228407, 0.2364525999999999, 170.0, 649, 424518, 585, 53.07702110000173
586, 4.972944301867044, 10.326804843430498, 12.36525278376312, 0.23523579999999988, 145.0, 703, 425221, 586, 57.54112349999923
587, 5.3462548272176225, 10.328939599123869, 12.387292646928268, 0.2341081, 85.0, 550, 425771, 587, 45.01987910000025
588, 4.556152681130149, 10.296389090434442, 12.33902879922131, 0.23241159999999997, 430.0, 1335, 427106, 588, 109.0606594000019
589, 5.283274112963209, 10.32256599233932, 12.366605590371524, 0.2308887999999999, 55.0, 357, 427463, 589, 29.26707119999992
590, 5.065461792498357, 10.323760226697951, 12.381077215874608, 0.22999689999999995, 160.0, 634, 428097, 590, 51.9553382999984
591, 5.103278858321054, 10.304992423135161, 12.341451408634565, 0.22843089999999994, 435.0, 1106, 429203, 591, 90.39415279999957
592, 5.936438897712944, 10.320835217741347, 12.374715124700487, 0.226999, 60.0, 485, 429688, 592, 39.790414499999315
593, 4.6068567295633525, 10.580077977076064, 12.678025683347325, 0.2255761, 325.0, 1096, 430784, 593, 89.9798669999982
594, 5.5302790491114395, 10.694768415961274, 12.825191898448677, 0.22358709999999993, 315.0, 1114, 431898, 594, 91.14867279999817
595, 5.3984171219819945, 10.655304868129397, 12.766446602997384, 0.22214079999999994, 60.0, 493, 432391, 595, 40.52099520000047
596, 5.065154472107732, 10.667639844888782, 12.782601581562233, 0.22108689999999986, 90.0, 678, 433069, 596, 55.619495999999344
597, 4.615638571140034, 10.658995804443858, 12.76445064669341, 0.21992589999999992, 185.0, 612, 433681, 597, 50.149379399998
598, 5.107569623730447, 10.634440300004343, 12.74012160559797, 0.21854529999999994, 290.0, 922, 434603, 598, 75.71572410000226
599, 4.95687383075571, 10.61704089826141, 12.720889042019369, 0.2165878, 475.0, 1253, 435856, 599, 102.6315797999996
600, 5.197060659658109, 10.605730173539142, 12.695352042729237, 0.2148426999999999, 95.0, 686, 436542, 600, 56.33006999999998
601, 4.385852072852673, 10.601884505772354, 12.701552119113432, 0.21377079999999998, 25.0, 505, 437047, 601, 41.809955299999274
602, 4.953632100210439, 10.60283854237174, 12.705653355332831, 0.21190419999999985, 800.0, 1569, 438616, 602, 128.59051270000055
603, 5.103941505547338, 10.62705301118377, 12.754668550683348, 0.20982159999999989, 240.0, 745, 439361, 603, 61.11375880000196
604, 4.866453110551702, 10.818206774543624, 12.96106454502693, 0.2078533, 850.0, 1442, 440803, 604, 117.9751591000022
605, 5.058899590062217, 10.981802501561452, 13.173327690545767, 0.20582199999999987, 270.0, 815, 441618, 605, 66.80374330000268
606, 4.85913762458637, 10.972245162489724, 13.155161313417942, 0.2044512999999999, 110.0, 708, 442326, 606, 58.04597819999981
607, 5.727726282746789, 10.986375473335208, 13.178653472192593, 0.20297979999999993, 120.0, 927, 443253, 607, 75.94869219999964
608, 6.322227270135255, 11.035319916555814, 13.213209004268467, 0.20166399999999993, 50.0, 535, 443788, 608, 43.8589350000002
609, 4.957525375674133, 11.010973334454864, 13.193254640595175, 0.20042919999999995, 120.0, 837, 444625, 609, 68.67937800000072
610, 5.047960787007572, 11.003071916864274, 13.17075293706664, 0.19866069999999997, 485.0, 1128, 445753, 610, 92.12330759999895
611, 5.519661077164039, 10.991165906658527, 13.161653537723035, 0.19701459999999993, 90.0, 701, 446454, 611, 57.23425710000083
612, 4.975719634967035, 10.987814493431822, 13.160295591334947, 0.19594179999999994, 95.0, 491, 446945, 612, 40.87466850000055
613, 4.270493055017371, 10.952349500727832, 13.114712597552995, 0.19490139999999995, 180.0, 665, 447610, 613, 54.47876679999899
614, 5.417802598951309, 10.966237148812146, 13.140500205125266, 0.19319589999999992, 410.0, 1230, 448840, 614, 100.4303676999989
615, 4.916649409702846, 10.998452549410942, 13.176710447153651, 0.19089189999999992, 285.0, 1330, 450170, 615, 108.77079800000138
616, 4.710535085320871, 11.06078595540994, 13.240547794163426, 0.18915669999999996, 110.0, 598, 450768, 616, 48.95029879999856
617, 4.683309122492066, 11.070209552974054, 13.255797061222962, 0.1879291, 200.0, 766, 451534, 617, 62.84296879999965
618, 5.567192413604136, 11.06589196146149, 13.280520220392757, 0.18689049999999993, 110.0, 388, 451922, 618, 31.904741099999228
619, 5.022861542006736, 11.06969044855249, 13.261025960628803, 0.18565209999999996, 225.0, 988, 452910, 619, 80.82117689999723
620, 4.84298156721313, 11.059569201222088, 13.25746466311097, 0.18401679999999987, 65.0, 829, 453739, 620, 67.85527419999926
621, 5.075675859824669, 11.042124227784882, 13.241774460974383, 0.18176500000000004, 555.0, 1673, 455412, 621, 136.57125799999994
622, 4.770828591757991, 11.05811484241131, 13.26208327623105, 0.17904879999999992, 350.0, 1345, 456757, 622, 109.96708650000073
623, 5.191859807353467, 11.064173310995102, 13.26826399564743, 0.17749269999999998, 50.0, 384, 457141, 623, 31.50672990000021
624, 5.193462508618832, 11.0575625650088, 13.25384089231491, 0.17606709999999987, 365.0, 1200, 458341, 624, 98.17883430000074
625, 5.658806020264243, 11.060282996700252, 13.265616025937215, 0.17430219999999996, 255.0, 761, 459102, 625, 62.49360670000169
626, 4.44931703712426, 11.0092189022139, 13.216801852805942, 0.17315829999999993, 70.0, 510, 459612, 626, 42.00497220000034
627, 5.339601935957795, 11.179952502843753, 13.404497016128616, 0.17197569999999995, 130.0, 804, 460416, 627, 65.7312376000009
628, 6.2593777906246135, 11.319733530746223, 13.582953595126849, 0.17055729999999986, 185.0, 772, 461188, 628, 63.41224390000207
629, 5.114164258109521, 11.319913362324165, 13.569439846182856, 0.16912359999999999, 225.0, 821, 462009, 629, 67.39355779999823
630, 5.412561688193326, 11.331649290303053, 13.59043726678622, 0.16753509999999994, 205.0, 944, 462953, 630, 77.6729742000025
631, 5.211999073352782, 11.32137478168924, 13.589522367290794, 0.16560009999999994, 325.0, 1206, 464159, 631, 99.14568309999959
632, 4.999533487837992, 11.306555324130589, 13.569395463260603, 0.1641502, 45.0, 405, 464564, 632, 33.38545809999778
633, 5.215410583272757, 11.309727572496293, 13.572908727509818, 0.16311699999999993, 235.0, 743, 465307, 633, 61.23346820000006
634, 4.881130094903818, 11.316369209053867, 13.580766114742485, 0.16142859999999998, 305.0, 1133, 466440, 634, 93.10169630000019
635, 5.0726040860266535, 11.315058406260556, 13.568607495253389, 0.15976359999999995, 175.0, 717, 467157, 635, 58.84907010000097
636, 4.888286971049625, 11.314231623833736, 13.574870399508077, 0.15849369999999993, 395.0, 694, 467851, 636, 56.84039910000138
637, 5.965042200672078, 11.322022821115151, 13.576550260248544, 0.15743889999999994, 30.0, 478, 468329, 637, 39.2001980999994
638, 5.132031454331314, 11.306287306245022, 13.56335504703258, 0.15622749999999994, 255.0, 868, 469197, 638, 71.50666840000122
639, 5.087027983369433, 11.276460717612498, 13.520901998308537, 0.1547721999999999, 140.0, 749, 469946, 639, 61.45730190000177
640, 5.668664496759825, 11.728924616077279, 14.061012708688084, 0.15338709999999992, 160.0, 790, 470736, 640, 64.85034739999901
641, 4.914219700120469, 11.754024996552417, 14.08509123966258, 0.15200649999999996, 275.0, 744, 471480, 641, 60.814532399999734
642, 4.701436616259197, 11.756724093075052, 14.10184764178773, 0.15045759999999986, 190.0, 977, 472457, 642, 80.16140400000222
643, 4.963992262508931, 11.752885689722536, 14.089413854906304, 0.14857839999999997, 220.0, 1111, 473568, 643, 91.34297510000033
644, 4.918608971241445, 11.754403063647809, 14.093857325040377, 0.1464435999999999, 625.0, 1261, 474829, 644, 103.32822360000137
645, 4.679647038817178, 11.759160519557975, 14.103572082337184, 0.1443672999999999, 545.0, 1046, 475875, 645, 85.88250900000276
646, 4.749569862819555, 11.737947059095951, 14.080695148936488, 0.14291289999999995, 90.0, 570, 476445, 646, 46.762728400000924
647, 5.323260772656771, 11.749130372128455, 14.091444637261185, 0.14184909999999995, 110.0, 612, 477057, 647, 50.0697345999979
648, 4.93735486499131, 11.75557669893655, 14.093913076467036, 0.1408320999999999, 190.0, 518, 477575, 648, 42.39616449999812
649, 5.366828953861728, 11.73711682936942, 14.08317790290182, 0.13943709999999995, 145.0, 1032, 478607, 649, 84.3031009999977
650, 4.985732456553454, 11.751806352771608, 14.099923197158986, 0.13723389999999994, 615.0, 1416, 480023, 650, 115.53849780000019
651, 5.3343488136306405, 12.161235203345617, 14.56620260576407, 0.13561389999999995, 5.0, 384, 480407, 651, 31.59580249999999
652, 5.024164339051629, 12.110034643298517, 14.522542999434645, 0.13465179999999996, 155.0, 685, 481092, 652, 56.17005860000063
653, 5.425115044992591, 12.097506341942292, 14.507810917822763, 0.13297419999999988, 445.0, 1179, 482271, 653, 96.02006020000044
654, 5.6073370292741505, 12.091180170011652, 14.49845154992101, 0.13126329999999994, 260.0, 722, 482993, 654, 59.07723679999981
655, 5.638922014639745, 12.087151116201929, 14.487054046706774, 0.13007079999999993, 90.0, 603, 483596, 655, 49.34031280000272
656, 5.719016692595187, 12.077100714132476, 14.494551588477357, 0.12868389999999993, 175.0, 938, 484534, 656, 76.52270480000152
657, 5.373437245559325, 12.063960771964664, 14.475878937100568, 0.12713859999999988, 175.0, 779, 485313, 657, 63.68196480000188
658, 5.072356015345929, 12.051068072640055, 14.452916550910336, 0.1253412999999999, 635.0, 1218, 486531, 658, 99.83725979999872
659, 5.522965442392515, 12.035749843306546, 14.436906907351576, 0.12321819999999993, 265.0, 1141, 487672, 659, 93.08259369999723
660, 5.398097163660986, 12.017360512595895, 14.406520659571916, 0.1216359999999999, 165.0, 617, 488289, 660, 50.520076300002984
661, 5.7808987690342795, 12.019924399587843, 14.413819234901004, 0.12043269999999996, 195.0, 720, 489009, 661, 58.82134579999547
662, 5.324029701342017, 12.02997865030321, 14.426527403168759, 0.11925369999999993, 50.0, 590, 489599, 662, 48.28803569999582
663, 5.813869894342435, 11.996420956544508, 14.388093754589795, 0.11804499999999991, 245.0, 753, 490352, 663, 61.46137379999709
664, 5.201184149567302, 11.992908849344625, 14.393942886299186, 0.11646639999999991, 420.0, 1001, 491353, 664, 81.54213879999588
665, 5.161003921147036, 11.970957064672028, 14.348944080331938, 0.11457729999999991, 245.0, 1098, 492451, 665, 89.57159520000278
666, 5.1804854878919375, 11.957377457981787, 14.319561111140372, 0.11323449999999989, 65.0, 394, 492845, 666, 32.25962889999937
667, 6.137136288496278, 11.962725329843368, 14.33344406666963, 0.11230029999999994, 210.0, 644, 493489, 667, 52.54471969999577
668, 5.256382213280751, 11.939842342963585, 14.318705533834605, 0.11113569999999995, 110.0, 650, 494139, 668, 53.049361000004865
669, 6.135085539332814, 11.943652816598407, 14.319437123070198, 0.11007729999999992, 100.0, 526, 494665, 669, 42.995451899994805
670, 4.7610722597962045, 11.939528342020713, 14.312241981931999, 0.10832949999999995, 370.0, 1416, 496081, 670, 115.012418600003
671, 4.83918110703815, 11.94211842484319, 14.32582193857541, 0.10641879999999995, 80.0, 707, 496788, 671, 57.50292210000043
672, 5.071551918672208, 11.930127890863245, 14.31844031032632, 0.10543779999999993, 55.0, 383, 497171, 672, 31.155449699996097
673, 5.48918548678277, 11.939594598090062, 14.311662901620396, 0.10421469999999997, 125.0, 976, 498147, 673, 79.4592047000042
674, 5.410535841936636, 11.96071044235853, 14.34098220759365, 0.10234539999999995, 245.0, 1101, 499248, 674, 89.4128542000035
675, 5.038468401642688, 12.033293053807025, 14.435670410677133, 0.10040934168674472, 505.0, 1245, 500493, 675, 101.27877509999962
676, 4.6724851368754, 12.14817930445259, 14.563109110902857, 0.10000000000000092, 170.0, 648, 501141, 676, 52.684349099996325
677, 5.1847610120972, 12.1336081094212, 14.54785182343589, 0.10000000000000026, 410.0, 720, 501861, 677, 58.58650280000438
678, 5.153497760806325, 12.151551796051313, 14.57262036642532, 0.099999999999998, 720.0, 1163, 503024, 678, 94.47209169999405
679, 5.633477840439776, 12.168732894094367, 14.595778863579794, 0.09999999999999795, 385.0, 1178, 504202, 679, 95.5924937000018
680, 6.012404105057577, 12.179957316293345, 14.599025004095845, 0.09999999999999779, 425.0, 1232, 505434, 680, 99.9503532000017
681, 5.544461177403213, 12.202818060574467, 14.633878530588168, 0.1000000000000009, 50.0, 511, 505945, 681, 41.59157250000135
682, 5.124401304866868, 12.180585535511518, 14.609027585708471, 0.09999999999999888, 185.0, 937, 506882, 682, 76.03571409999859
683, 5.338895599263089, 12.171788644931866, 14.604093412303266, 0.09999999999999853, 200.0, 1013, 507895, 683, 82.24178070000198
684, 6.362483869251023, 12.21161966514044, 14.63847950449017, 0.10000000000000041, 110.0, 702, 508597, 684, 56.84564220000175
685, 5.506220590410057, 12.182478681224987, 14.598344392132905, 0.09999999999999956, 185.0, 815, 509412, 685, 66.26658890000544
686, 5.232020398179195, 12.199308079079797, 14.62112769937872, 0.10000000000000074, 75.0, 401, 509813, 686, 32.67463519999728
687, 5.175847215539827, 12.592381352702464, 15.096476946853278, 0.10000000000000099, 155.0, 635, 510448, 687, 51.64675249999709
688, 5.517273666616529, 12.761749941110612, 15.296521408855915, 0.100000000000001, 145.0, 640, 511088, 688, 52.01768149999407
689, 5.885910237686975, 12.765916853684645, 15.299089007325225, 0.09999999999999902, 205.0, 910, 511998, 689, 74.028690500003
690, 5.72172437573085, 12.752798487183835, 15.289909220866845, 0.10000000000000094, 95.0, 551, 512549, 690, 44.89903440000489
691, 5.623122493001341, 12.748430776232071, 15.285146120668367, 0.10000000000000085, 175.0, 655, 513204, 691, 53.360823099996196
692, 5.07098662943551, 12.703586067472186, 15.23373750897197, 0.09999999999999895, 115.0, 924, 514128, 692, 75.15637620000052
693, 4.992566590762045, 12.717999488349975, 15.251693442111879, 0.1000000000000009, 130.0, 508, 514636, 693, 41.30942900000082
694, 5.949998492900474, 12.716521364372106, 15.241477117740951, 0.09999999999999865, 140.0, 989, 515625, 694, 80.32356710000022
695, 5.071636303078454, 12.709040634587126, 15.227058378255592, 0.10000000000000091, 150.0, 530, 516155, 695, 43.173515399997996
696, 6.292374329770014, 12.727141213662124, 15.257291463328178, 0.1000000000000006, 150.0, 681, 516836, 696, 55.31659659999423
697, 5.516693119998099, 12.665849127964666, 15.213586158455, 0.1000000000000009, 65.0, 513, 517349, 697, 41.758467100000416
698, 5.566184141253697, 12.648424377878204, 15.173308849334717, 0.09999999999999976, 200.0, 786, 518135, 698, 63.999803300001076
699, 4.756858321860324, 12.638974863173187, 15.158291161122229, 0.09999999999999876, 240.0, 963, 519098, 699, 78.19103590000304
700, 5.921772076623072, 12.629368229425332, 15.13830371474287, 0.10000000000000075, 75.0, 409, 519507, 700, 33.37576580000314
701, 5.090528371233593, 12.593309661894466, 15.104857676178407, 0.09999999999999978, 110.0, 783, 520290, 701, 63.775933600001736
702, 5.383915590672909, 12.592464198612547, 15.104684620184374, 0.09999999999999916, 280.0, 883, 521173, 702, 71.92981240000518
703, 4.77547137947099, 12.584778374284378, 15.092472424478341, 0.09999999999999801, 435.0, 1159, 522332, 703, 94.20964539999841
704, 4.900420045060005, 12.59147439257884, 15.108413774622155, 0.0999999999999999, 150.0, 767, 523099, 704, 62.45700599999691
705, 5.677636442150307, 12.578474685514172, 15.091382844920375, 0.09999999999999942, 245.0, 838, 523937, 705, 68.04067129999748
706, 5.037079452716031, 12.55235233955013, 15.053643854381969, 0.09999999999999847, 550.0, 1030, 524967, 706, 83.99497580000025
707, 5.2930479837705455, 12.545556402252403, 15.049370709587546, 0.09999999999999844, 370.0, 1037, 526004, 707, 84.44842319999589
708, 4.2560224846143555, 12.545019478802823, 15.048617495567251, 0.09999999999999871, 370.0, 971, 526975, 708, 79.02002680000442
709, 5.163943528525946, 12.538538360274059, 15.040662209058894, 0.10000000000000096, 105.0, 593, 527568, 709, 48.41043699999864
710, 5.031330729560029, 12.485859287728509, 14.989514371474012, 0.10000000000000077, 90.0, 417, 527985, 710, 33.96388840000145
711, 5.1835673129047395, 12.488079101908168, 14.980637257153163, 0.09999999999999777, 670.0, 1236, 529221, 711, 100.50160329999926
712, 4.386502242458412, 12.468995145722932, 14.953265246223001, 0.10000000000000098, 95.0, 612, 529833, 712, 49.96610060000239
713, 5.120129211630884, 12.519926552168666, 15.00686457375772, 0.09999999999999898, 260.0, 916, 530749, 713, 74.72012580000592
714, 5.409235192769955, 12.519184427073792, 15.017461938324205, 0.10000000000000078, 135.0, 661, 531410, 714, 54.07222790000378
715, 5.09652842907748, 12.494717064510798, 14.984142022150383, 0.09999999999999955, 445.0, 817, 532227, 715, 66.69711149999785
716, 5.278277326437187, 12.504797144910219, 14.99977657630721, 0.0999999999999994, 270.0, 842, 533069, 716, 68.74274290000176
717, 5.3303837483474075, 12.520276278305673, 15.004828230488435, 0.10000000000000098, 110.0, 617, 533686, 717, 50.43892380000034
718, 5.302717001086246, 12.497651710636777, 15.000311516212982, 0.10000000000000098, 60.0, 603, 534289, 718, 49.21049920000223
719, 5.48599156320736, 12.501354180612871, 14.995061999495311, 0.09999999999999891, 195.0, 930, 535219, 719, 76.35718869999982
720, 5.324134350539892, 12.471219451157088, 14.974988378609988, 0.10000000000000096, 60.0, 582, 535801, 720, 47.70640529999946
721, 5.720344252980524, 12.478003555728543, 14.959580869059408, 0.10000000000000099, 140.0, 620, 536421, 721, 50.718778999995266
722, 4.917508122966672, 12.433619749807093, 14.936069518110179, 0.10000000000000092, 90.0, 548, 536969, 722, 44.84767599999759
723, 4.928624099886024, 12.44639073047009, 14.932600573655014, 0.09999999999999902, 265.0, 910, 537879, 723, 74.35792159999983
724, 5.933259038121201, 12.442551939321119, 14.922268690952034, 0.0999999999999983, 365.0, 1075, 538954, 724, 87.89012480000383
725, 4.491673276141964, 12.478266384515807, 14.970279740866397, 0.09999999999999723, 490.0, 1473, 540427, 725, 120.24338149999676
726, 5.049334584653546, 12.587713500933337, 15.096073382974684, 0.10000000000000066, 50.0, 353, 540780, 726, 28.942659000000276
727, 4.764734371909689, 12.529485130727421, 15.032298720378584, 0.09999999999999899, 175.0, 914, 541694, 727, 74.64873079999961
728, 5.616860517124546, 12.560477151452323, 15.067903332558775, 0.10000000000000078, 140.0, 661, 542355, 728, 54.0772364000004
729, 5.602022601451859, 12.491508945053173, 14.987645026850215, 0.100000000000001, 205.0, 639, 542994, 729, 52.262910999997985
730, 4.538991163920115, 12.466146970296407, 14.954373366362578, 0.0999999999999986, 415.0, 999, 543993, 730, 81.68279710000206
731, 4.272308734850695, 12.452927763628196, 14.94511474638111, 0.10000000000000091, 85.0, 531, 544524, 731, 43.35753889999614
732, 4.5736171703653286, 12.467164036707224, 14.953955023905953, 0.09999999999999866, 255.0, 985, 545509, 732, 80.5582285000055
733, 5.240124158351025, 12.458201998827226, 14.952250787083258, 0.100000000000001, 195.0, 638, 546147, 733, 52.23059149999608
734, 4.985874696211382, 12.44950706944321, 14.954270402156945, 0.0999999999999995, 120.0, 825, 546972, 734, 67.59195690000342
735, 4.415853458744751, 12.411204118203845, 14.881628527813211, 0.09999999999999837, 260.0, 1054, 548026, 735, 86.054335300003
736, 4.412422852979979, 12.39698572097484, 14.871844058634768, 0.10000000000000099, 90.0, 622, 548648, 736, 50.837272799995844
737, 4.578472127466055, 12.392035877291443, 14.863770378416401, 0.09999999999999981, 440.0, 779, 549427, 737, 63.58780180000031
738, 4.981459197195449, 12.396372604370118, 14.869596894896857, 0.10000000000000088, 80.0, 505, 549932, 738, 41.2292443999977
739, 4.959361240588522, 12.350101273120499, 14.81862360126274, 0.09999999999999712, 500.0, 1533, 551465, 739, 124.86217220000253
740, 4.0061522542484225, 12.3522369899447, 14.8169342071291, 0.10000000000000071, 75.0, 378, 551843, 740, 30.938839599999483
741, 5.122545205216649, 12.3379441982398, 14.810819636093328, 0.0999999999999976, 565.0, 1304, 553147, 741, 106.14305120000063
742, 4.933114858599972, 12.326049778496122, 14.799703245209184, 0.10000000000000099, 120.0, 619, 553766, 742, 50.56213510000089
743, 4.793841106398392, 12.308516882186712, 14.76974320042041, 0.09999999999999847, 280.0, 1032, 554798, 743, 84.30360359999759
744, 4.395281551743508, 12.296314632004174, 14.745406969768451, 0.09999999999999908, 215.0, 899, 555697, 744, 73.32095370000025
745, 4.544038559975943, 12.28123369072735, 14.733682519158844, 0.09999999999999894, 185.0, 926, 556623, 745, 75.59086600000592
746, 4.74428054473258, 12.281011179921304, 14.740522687798304, 0.09999999999999837, 150.0, 1057, 557680, 746, 86.51556219999475
747, 4.936319310627329, 12.288129187656287, 14.747903318394352, 0.09999999999999916, 250.0, 883, 558563, 747, 72.48011879999831
748, 4.040337538267945, 12.282051764743429, 14.739174329059225, 0.10000000000000095, 65.0, 568, 559131, 748, 46.55241980000574
749, 5.453766938982028, 12.305698174835378, 14.781237647303561, 0.10000000000000091, 75.0, 529, 559660, 749, 43.34880829999747
750, 4.848005817701974, 12.453826699361786, 14.950225254000745, 0.09999999999999794, 405.0, 1182, 560842, 750, 96.76533290000225
751, 5.0801830120773275, 12.542301884043514, 15.05324799998277, 0.09999999999999916, 355.0, 882, 561724, 751, 72.10663189999468
752, 4.615684641863458, 12.541946859100916, 15.044960669037694, 0.10000000000000085, 55.0, 479, 562203, 752, 39.29029420000006
753, 4.820411531428315, 12.528828289652655, 15.029372267574889, 0.10000000000000092, 120.0, 547, 562750, 753, 44.797504000001936
754, 4.369944970827471, 12.51460023003527, 15.025287227939401, 0.09999999999999964, 385.0, 803, 563553, 754, 65.78256669999973
755, 5.061202175016246, 12.549348095034764, 15.067296188921969, 0.10000000000000098, 140.0, 605, 564158, 755, 49.63642139999865
756, 4.372518580904754, 12.527183622076032, 15.026104417264737, 0.10000000000000088, 50.0, 651, 564809, 756, 53.46885050000128
757, 4.582930076347467, 12.534067925987744, 15.039314854577034, 0.09999999999999762, 545.0, 1297, 566106, 757, 106.25030569999944
758, 4.556849327988512, 12.524592949274018, 15.041778659069632, 0.10000000000000099, 145.0, 635, 566741, 758, 52.2540719000026
759, 4.939148900862289, 12.523006483938842, 15.0194518536593, 0.0999999999999981, 175.0, 1130, 567871, 759, 92.79376899999625
760, 5.236944853559437, 12.510389251196944, 15.004975526924902, 0.10000000000000096, 75.0, 596, 568467, 760, 48.87133780000295
761, 4.8833331735331775, 12.492563153795627, 14.98224581782682, 0.09999999999999874, 440.0, 965, 569432, 761, 79.33855739999854
762, 5.303703077109773, 12.513084900866653, 15.011406450023438, 0.10000000000000092, 115.0, 538, 569970, 762, 44.3192121999964
763, 4.912868279093754, 13.017286344202693, 15.619700716641136, 0.09999999999999752, 505.0, 1336, 571306, 763, 109.91190369999822
764, 5.307616792777751, 13.040088162777272, 15.655968738363145, 0.1, 240.0, 752, 572058, 764, 61.924046400003135
765, 4.6585330063502, 13.072920148213704, 15.691632747650146, 0.10000000000000002, 245.0, 750, 572808, 765, 61.805198500005645
766, 5.167584219513814, 13.033880593837099, 15.64489764960166, 0.09999999999999948, 250.0, 829, 573637, 766, 68.23929970000609
767, 5.056452998920668, 13.04054526923966, 15.652550377442171, 0.100000000000001, 140.0, 638, 574275, 767, 52.57995579999988
768, 4.916668819694557, 13.040254556907797, 15.644747052197424, 0.09999999999999856, 260.0, 1007, 575282, 768, 82.90897669999686
769, 5.08954339045022, 13.023831705741694, 15.645207452069362, 0.09999999999999959, 200.0, 812, 576094, 769, 66.96604890000162
770, 5.1157494386395825, 13.033289027988696, 15.639972411338173, 0.09999999999999946, 265.0, 831, 576925, 770, 68.57596100000228
771, 5.2100656882977825, 13.049351535044925, 15.651018052705577, 0.10000000000000034, 160.0, 710, 577635, 771, 59.01152919999731
772, 5.053892396060565, 13.03396083162031, 15.63510412987862, 0.10000000000000085, 85.0, 655, 578290, 772, 54.01522970000224
773, 5.036108700458523, 13.048069363548642, 15.668472396324955, 0.09999999999999865, 280.0, 987, 579277, 773, 81.20105840000178
774, 5.467590843257791, 13.082220645550171, 15.698928026119434, 0.09999999999999822, 380.0, 1098, 580375, 774, 90.54415210000298
775, 5.475053457381708, 13.21697992964598, 15.857026137030113, 0.09999999999999878, 180.0, 957, 581332, 775, 78.73192199999903
776, 5.4450464630408, 13.238877852913907, 15.890400084624824, 0.1000000000000009, 75.0, 509, 581841, 776, 41.95378670000355
777, 4.89998599365994, 13.214257938472453, 15.859577142065097, 0.10000000000000045, 35.0, 698, 582539, 777, 57.602208000003884
778, 5.493283724267596, 13.228302556258278, 15.866801732483834, 0.09999999999999863, 200.0, 991, 583530, 778, 81.68177590000414
779, 5.723666502269048, 13.256717480634101, 15.903452327496199, 0.10000000000000091, 50.0, 526, 584056, 779, 43.47257489999902
780, 4.947601781199175, 13.21098890200744, 15.863668441772461, 0.10000000000000096, 195.0, 643, 584699, 780, 52.99160799999663
781, 5.054779266321319, 13.18861869625044, 15.83091845787958, 0.09999999999999745, 585.0, 1367, 586066, 781, 112.39673870000115
782, 5.0129590974068, 13.182986359024378, 15.824005209237363, 0.09999999999999801, 500.0, 1159, 587225, 782, 95.44921750000503
783, 5.100764814601002, 13.16493444138789, 15.800164150526799, 0.10000000000000088, 115.0, 502, 587727, 783, 41.3824672999981
784, 5.211697282499939, 13.196408255773646, 15.831708324228535, 0.10000000000000085, 130.0, 655, 588382, 784, 54.01791979999689
785, 4.806087097683241, 13.203469704020234, 15.85217003137699, 0.10000000000000074, 85.0, 397, 588779, 785, 32.828740899996774
786, 5.804962323973602, 13.18130817716887, 15.829424721492696, 0.09999999999999999, 295.0, 754, 589533, 786, 62.04480849999527
787, 4.919141995267608, 13.258358193699863, 15.90599150132819, 0.09999999999999834, 350.0, 1063, 590596, 787, 87.56161079999583
788, 5.175816631232191, 13.30748402081306, 15.981409283545124, 0.0999999999999994, 125.0, 842, 591438, 788, 69.69229820000328
789, 5.520509622538287, 13.320248161231616, 15.984426372837186, 0.09999999999999826, 400.0, 1086, 592524, 789, 89.52805459999945
790, 4.438671175513086, 13.378310022474844, 16.0513273709937, 0.09999999999999973, 135.0, 790, 593314, 790, 65.03858719999698
791, 4.789611809783512, 13.362037938950836, 16.026507595494035, 0.09999999999999876, 170.0, 963, 594277, 791, 79.36471739999979
792, 5.251331638920215, 13.356910478237063, 16.009505005769952, 0.1000000000000009, 80.0, 516, 594793, 792, 42.70439559999795
793, 4.631504069020351, 13.335963070392609, 16.008523213863374, 0.10000000000000085, 50.0, 480, 595273, 793, 39.820633099996485
794, 4.590040947076422, 13.354430011762778, 16.013365471940112, 0.09999999999999937, 150.0, 847, 596120, 794, 69.92406489999848
795, 4.966402613077452, 13.322577901120145, 15.993019814450047, 0.10000000000000048, 195.0, 694, 596814, 795, 57.36815420000494
796, 5.403648571037019, 13.355826819580571, 16.01337398024789, 0.09999999999999863, 175.0, 991, 597805, 796, 82.03634070000408
797, 4.664994824105973, 13.356247439715704, 16.020459259846678, 0.10000000000000099, 145.0, 619, 598424, 797, 51.160865199999535
798, 5.235358187582257, 13.362741315087607, 16.033413607020712, 0.10000000000000053, 105.0, 688, 599112, 798, 56.88526140000613
799, 4.881774685039476, 13.347668909168133, 16.006577488437348, 0.09999999999999928, 220.0, 861, 599973, 799, 71.15158670000528
800, 5.081080361048381, 13.481434262593588, 16.17094429016113, 0.1000000000000007, 65.0, 375, 600348, 800, 31.1077535000004
801, 4.92263434748125, 13.467377891351914, 16.165997851764317, 0.0999999999999996, 225.0, 809, 601157, 801, 66.88641360000474
802, 5.203325655247338, 13.480087984878173, 16.168034333953333, 0.10000000000000096, 135.0, 582, 601739, 802, 48.35512749999907
803, 4.874266190978798, 13.492681977818313, 16.18367607037998, 0.0999999999999995, 285.0, 824, 602563, 803, 68.1885925999959
804, 5.509720732384868, 13.506854949229087, 16.20050677683107, 0.09999999999999964, 350.0, 803, 603366, 804, 66.62924550000025
805, 4.893146273717864, 13.4869428072495, 16.186124936815162, 0.09999999999999801, 505.0, 1157, 604523, 805, 95.86982100000023
806, 4.927288429656376, 13.495005916804075, 16.18789050852259, 0.09999999999999988, 65.0, 768, 605291, 806, 63.792723999999
807, 4.951242679724326, 13.448256698021522, 16.12873220590445, 0.1000000000000009, 155.0, 650, 605941, 807, 55.578699000005145
808, 4.866748850745491, 13.421707937989053, 16.104711580880082, 0.10000000000000099, 160.0, 632, 606573, 808, 54.4527264999997
809, 5.098663131114656, 13.448954707964331, 16.131911930151745, 0.0999999999999981, 160.0, 1130, 607703, 809, 98.93617830000585
810, 4.85631657138877, 13.454286669809884, 16.14262085835868, 0.10000000000000092, 110.0, 545, 608248, 810, 56.42507170000317
811, 4.835475373173423, 13.477334565178758, 16.165869664530295, 0.09999999999999856, 225.0, 1007, 609255, 811, 89.68276049999986
812, 4.976171646943072, 13.504772053489202, 16.216901384828464, 0.10000000000000034, 155.0, 711, 609966, 812, 61.39654259999952
813, 5.52383021974791, 13.746862331141728, 16.49756163823017, 0.10000000000000099, 135.0, 629, 610595, 813, 57.50642109999899
814, 5.36173776424661, 13.825491408523249, 16.588446505799585, 0.09999999999999781, 310.0, 1225, 611820, 814, 108.79925749999529
815, 4.781882129767753, 13.810201267689965, 16.57222104525433, 0.09999999999999909, 195.0, 895, 612715, 815, 78.51803080000536
816, 5.156062461916669, 13.82050713998863, 16.581682361739563, 0.09999999999999773, 615.0, 1255, 613970, 816, 107.87269989999913
817, 5.061654521983572, 13.805177678766938, 16.569495494657133, 0.10000000000000062, 85.0, 679, 614649, 817, 57.94685610000306
818, 5.185146256916925, 13.803232811592721, 16.55109392016397, 0.09999999999999983, 115.0, 777, 615426, 818, 71.37304619999486
819, 5.0802751123905185, 13.785953451239545, 16.53786257453587, 0.10000000000000052, 120.0, 690, 616116, 819, 62.36905359999946
820, 5.218168055490021, 13.755557038401829, 16.49626006193247, 0.0999999999999973, 470.0, 1441, 617557, 820, 126.30319389999931
821, 5.687853006568066, 13.68614699932956, 16.429197494743406, 0.10000000000000095, 110.0, 645, 618202, 821, 55.85891360000096
822, 4.4119898062343745, 13.67239731534815, 16.411605687104455, 0.10000000000000073, 35.0, 387, 618589, 822, 33.15249069999845
823, 5.25401413418911, 13.687001630200765, 16.41704721816933, 0.09999999999999823, 605.0, 1094, 619683, 823, 95.86457009999867
824, 4.935201471479576, 13.837790103162117, 16.599919195105706, 0.09999999999999877, 140.0, 961, 620644, 824, 80.97048069999437
825, 4.988191971426033, 13.94083801808514, 16.704443896731565, 0.09999999999999952, 140.0, 821, 621465, 825, 70.62334330000158
826, 4.669782746348455, 13.948090064539779, 16.731399462424335, 0.0999999999999994, 440.0, 841, 622306, 826, 71.11145269999543
827, 4.935433969544295, 13.954979682667904, 16.745543843511193, 0.09999999999999679, 400.0, 1739, 624045, 827, 147.24261249999836
828, 5.298182276541713, 14.04629383956959, 16.83948837740025, 0.10000000000000098, 115.0, 614, 624659, 828, 52.489427599997725
829, 5.363227907663736, 14.008800329306187, 16.799225964607338, 0.10000000000000099, 315.0, 624, 625283, 829, 52.26209289999679
830, 5.33380586206913, 14.029390311795611, 16.833943228388943, 0.09999999999999928, 440.0, 860, 626143, 830, 72.39404980000108
831, 5.662305493195666, 13.984493078057604, 16.776425971359505, 0.09999999999999933, 280.0, 854, 626997, 831, 72.34509850000177
832, 4.723444847902142, 14.001781070340437, 16.815376170812417, 0.10000000000000078, 150.0, 662, 627659, 832, 57.23617929999455
833, 5.9297905410345475, 14.016912489969759, 16.813477412936262, 0.0999999999999989, 155.0, 933, 628592, 833, 79.4549920999998
834, 5.377868282888085, 13.977488209307193, 16.769845151901244, 0.100000000000001, 195.0, 640, 629232, 834, 53.695033500000136
835, 5.031376878169143, 14.035711019145332, 16.836557770547596, 0.09999999999999865, 205.0, 988, 630220, 835, 83.63049909999972
836, 5.695122404139915, 14.148479832926638, 16.98547503365104, 0.1000000000000005, 155.0, 691, 630911, 836, 58.592660700000124
837, 5.462048304699533, 14.174319893373854, 17.004169269396098, 0.09999999999999673, 605.0, 1773, 632684, 837, 149.37218810000195
838, 5.728712347030861, 14.178783913508763, 17.02430287753418, 0.09999999999999828, 185.0, 1077, 633761, 838, 91.29500769999868
839, 5.361335842891989, 14.226299860529902, 17.067373301476938, 0.09999999999999735, 620.0, 1409, 635170, 839, 119.7254355000041
840, 6.03135164209458, 14.242933400944706, 17.08608934515914, 0.10000000000000092, 95.0, 538, 635708, 840, 45.78782269999647
841, 5.943555666912686, 14.260437619686126, 17.10365771922198, 0.09999999999999917, 345.0, 880, 636588, 841, 74.50307320000138
842, 5.468876052434277, 14.232860018493264, 17.071415243634753, 0.10000000000000099, 120.0, 628, 637216, 842, 53.63188999999693
843, 5.788680375299671, 14.21805984323675, 17.057724325687854, 0.10000000000000098, 155.0, 616, 637832, 843, 52.79705500000273
844, 5.332396098191796, 14.21106349220068, 17.047801492649462, 0.09999999999999724, 490.0, 1468, 639300, 844, 123.7745131000047
845, 5.307738600486637, 14.210456044254798, 17.047802299862294, 0.10000000000000048, 260.0, 694, 639994, 845, 58.2044795000038
846, 5.244251998289963, 14.371942060856732, 17.25100776071685, 0.09999999999999869, 255.0, 978, 640972, 846, 83.32208890000038
847, 6.055973497737538, 14.380711769335198, 17.25594988967433, 0.0999999999999995, 380.0, 825, 641797, 847, 70.0408813000031
848, 6.185455446654842, 14.360967161541893, 17.222411083039784, 0.09999999999999941, 240.0, 840, 642637, 848, 70.86031989999901
849, 5.8264327951926, 14.38324267592437, 17.248218802662638, 0.09999999999999741, 390.0, 1386, 644023, 849, 116.82822369999485
850, 5.443851066550575, 14.359153730080026, 17.24007881356815, 0.09999999999999921, 240.0, 873, 644896, 850, 75.44399390000035
851, 5.116220980114335, 14.355623747309318, 17.230503673631105, 0.10000000000000012, 245.0, 737, 645633, 851, 61.64256349999778
852, 5.019907158973453, 14.371498592607267, 17.253750101550594, 0.10000000000000069, 105.0, 364, 645997, 852, 30.95183719999477
853, 6.029587587855185, 14.382895468109778, 17.251644360105132, 0.10000000000000098, 110.0, 613, 646610, 853, 51.179169800001546
854, 5.4022229016458585, 14.369766534385034, 17.239399536181306, 0.09999999999999885, 300.0, 944, 647554, 854, 79.54166289999557
855, 4.95005879360576, 14.339761576295206, 17.194279446466332, 0.09999999999999984, 215.0, 774, 648328, 855, 65.37242069999775
856, 5.6387198216759415, 14.32891617090641, 17.19687828087533, 0.09999999999999809, 270.0, 1133, 649461, 856, 94.92224410000199
857, 4.91171120823397, 14.496959123123302, 17.394360564918852, 0.09999999999999966, 140.0, 801, 650262, 857, 66.78184399999736
858, 6.2054794395739785, 14.88842908743543, 17.86584542455505, 0.1000000000000009, 80.0, 511, 650773, 858, 43.36581310000474
859, 5.023486530750574, 14.852094753009133, 17.82382519798134, 0.09999999999999974, 125.0, 789, 651562, 859, 66.2061859999958
860, 5.447593038471846, 14.847214749226204, 17.793981249515827, 0.10000000000000077, 105.0, 416, 651978, 860, 35.07438270000421
861, 5.743607441486876, 14.838754423303541, 17.801031997780395, 0.10000000000000098, 120.0, 612, 652590, 861, 51.00400929999887
862, 4.783805594030394, 14.830840075802978, 17.789122180425743, 0.09999999999999955, 220.0, 818, 653408, 862, 68.72078239999973
863, 5.935527798866892, 14.843270838010561, 17.804364568536933, 0.09999999999999731, 300.0, 1430, 654838, 863, 120.01195830000506
864, 5.633540986184908, 14.872214483018087, 17.842916357931482, 0.09999999999999845, 485.0, 1036, 655874, 864, 87.31941060000099
865, 6.104480009526014, 14.874033038432781, 17.834490517011055, 0.09999999999999945, 415.0, 832, 656706, 865, 70.27703749999637
866, 5.066687545355628, 14.875013109515695, 17.841642440534105, 0.09999999999999956, 180.0, 816, 657522, 866, 68.74590660000104
867, 5.873443091362715, 14.850156264305115, 17.809172081947327, 0.09999999999999788, 220.0, 1200, 658722, 867, 106.46946860000025
868, 4.9669828462309065, 14.834833441159777, 17.803404775963646, 0.10000000000000085, 135.0, 654, 659376, 868, 60.2604810000048
869, 4.915500200445384, 14.872964649692948, 17.841476494157817, 0.09999999999999934, 140.0, 852, 660228, 869, 86.73115040000266
870, 5.369782973630847, 15.057738917783775, 18.054992744849585, 0.10000000000000067, 20.0, 359, 660587, 870, 37.55667080000421
871, 5.574044870445137, 15.038722544484793, 18.041178448693636, 0.10000000000000099, 60.0, 633, 661220, 871, 60.60442399999738
872, 5.785535969744718, 15.066236643338572, 18.075468579138615, 0.09999999999999903, 235.0, 906, 662126, 872, 85.29972090000228
873, 5.502428290736637, 15.036518247181196, 18.04572910051254, 0.10000000000000055, 15.0, 311, 662437, 873, 29.38494320000609
874, 5.29297069339068, 15.050620541216514, 18.052286684251285, 0.10000000000000057, 135.0, 683, 663120, 874, 59.335470500001975
875, 5.637272842537309, 14.994552066670128, 17.978936872276698, 0.09999999999999787, 540.0, 1206, 664326, 875, 111.48788770000101
876, 5.475913020134983, 15.017295017080793, 18.010533894522716, 0.10000000000000085, 140.0, 472, 664798, 876, 43.86297289999493
877, 5.844367501264417, 15.008837507158853, 18.00910723650897, 0.09999999999999776, 260.0, 1242, 666040, 877, 112.28359820000333
878, 5.944651807262505, 15.029798749037983, 18.01576130278866, 0.10000000000000075, 110.0, 407, 666447, 878, 36.06193930000154
879, 5.151465513594243, 15.01847318391115, 18.025799861929034, 0.10000000000000023, 105.0, 724, 667171, 879, 64.80428489999758
880, 5.097047030741102, 15.00632837004821, 18.005711443214462, 0.09999999999999962, 135.0, 807, 667978, 880, 71.0792666999987
881, 5.860862529057626, 15.042441189446361, 18.046623094100752, 0.09999999999999996, 140.0, 758, 668736, 881, 70.1741075999962
882, 5.363694649373469, 15.03215823009588, 18.034366958344464, 0.10000000000000071, 115.0, 669, 669405, 882, 60.70874420000473
883, 5.282935127429197, 15.03559332682674, 18.04914434810629, 0.10000000000000074, 110.0, 399, 669804, 883, 38.27454439999565
884, 6.234234471189967, 15.464550743219595, 18.554210141198702, 0.09999999999999759, 425.0, 1309, 671113, 884, 121.52976730000228
885, 5.313977806878197, 15.539755004403837, 18.636604858193163, 0.09999999999999815, 535.0, 1115, 672228, 885, 97.16860949999682
886, 6.005241396116636, 15.56927784333582, 18.673381863269924, 0.09999999999999813, 190.0, 1121, 673349, 886, 102.59017859999585
887, 5.4618260810059605, 15.58530701100351, 18.69482709802509, 0.09999999999999773, 380.0, 1254, 674603, 887, 114.32018450000032
888, 5.75900065314095, 15.580820492678468, 18.694112885673093, 0.0999999999999997, 135.0, 795, 675398, 888, 69.27453509999759
889, 6.098666854923078, 15.580758049374534, 18.69356749893783, 0.10000000000000049, 440.0, 693, 676091, 889, 64.32236510000075
890, 5.723535295920841, 15.609261751688392, 18.720573037798594, 0.0999999999999974, 545.0, 1393, 677484, 890, 127.09197450000647
891, 5.606028020240012, 15.621928814479283, 18.72405921845209, 0.10000000000000078, 55.0, 420, 677904, 891, 37.296291999999085
892, 5.354742496549296, 15.595234889115881, 18.707001634281287, 0.1000000000000006, 125.0, 681, 678585, 892, 66.53570760000002
893, 5.790732841223897, 15.606967350250102, 18.717245616704552, 0.10000000000000099, 195.0, 641, 679226, 893, 57.999023100004706
894, 6.01678648812346, 15.601667408895965, 18.695502215092723, 0.10000000000000075, 15.0, 404, 679630, 894, 36.390454400003364
895, 5.458461246650611, 15.597539003571468, 18.70118064880371, 0.1000000000000007, 170.0, 670, 680300, 895, 60.477612900001986
896, 5.701968905777713, 15.531775991901073, 18.6247299335621, 0.09999999999999898, 195.0, 918, 681218, 896, 78.00182710000081
897, 4.9355382914682036, 15.520142601531687, 18.610542152923287, 0.1000000000000009, 65.0, 515, 681733, 897, 43.47575190000498
898, 5.697834611141762, 15.518264170406628, 18.60485957268955, 0.10000000000000096, 45.0, 588, 682321, 898, 49.62216540000372
899, 5.636661470748009, 15.542129925666972, 18.632890050360498, 0.09999999999999795, 515.0, 1175, 683496, 899, 101.89923239999916
900, 5.946791642029351, 15.573141454724922, 18.681260404405077, 0.09999999999999734, 320.0, 1417, 684913, 900, 127.7437815000012
901, 5.031824468031725, 15.608038469151538, 18.707186701860046, 0.09999999999999871, 475.0, 971, 685884, 901, 87.26881500000309
902, 5.4927158989183384, 15.607741154353798, 18.7178658548212, 0.10000000000000087, 75.0, 653, 686537, 902, 59.153042099998856
903, 5.408339406552233, 15.594679648209208, 18.702621569036516, 0.10000000000000092, 150.0, 647, 687184, 903, 58.91528059999837
904, 5.781908319595663, 15.582639416271352, 18.704219058235697, 0.1000000000000007, 25.0, 374, 687558, 904, 34.93332830000145
905, 5.177204614942589, 15.538285970317075, 18.638876975787742, 0.10000000000000096, 100.0, 643, 688201, 905, 58.148227799996675
906, 5.211428676692533, 15.54822424469233, 18.651232380635676, 0.100000000000001, 90.0, 639, 688840, 906, 56.767963500002224
907, 6.21142920511757, 15.552823414820683, 18.6771167494045, 0.10000000000000091, 120.0, 526, 689366, 907, 47.27838309999788
908, 5.292465377897575, 15.573124974929302, 18.685622491613124, 0.09999999999999959, 245.0, 811, 690177, 908, 72.52354979999654
909, 6.286011265383826, 15.749727569501221, 18.875493308370427, 0.10000000000000073, 80.0, 387, 690564, 909, 37.03687219999847
910, 5.192644399815593, 15.70165161154736, 18.826178901496974, 0.10000000000000091, 130.0, 522, 691086, 910, 52.30110440000135
911, 5.789556943246096, 15.70079907265534, 18.832345565316253, 0.1000000000000009, 85.0, 509, 691595, 911, 50.35073290000582
912, 5.769495723876651, 15.692900387644093, 18.82434619026573, 0.09999999999999916, 110.0, 883, 692478, 912, 81.07444870000472
913, 5.69454501453115, 15.684221053176573, 18.816103744082035, 0.09999999999999908, 205.0, 898, 693376, 913, 81.97616250000283
914, 5.7084984901648035, 15.677295068145302, 18.815868590954487, 0.09999999999999883, 275.0, 948, 694324, 914, 90.11404100000073
915, 5.526093502659332, 15.702378776258332, 18.842865910294794, 0.09999999999999862, 245.0, 993, 695317, 915, 104.33315069999662
916, 6.216182590069541, 15.665802346654685, 18.786094751702734, 0.1000000000000006, 25.0, 332, 695649, 916, 35.71755739999935
917, 5.0705740712275915, 15.682257059184908, 18.81486344309381, 0.09999999999999935, 155.0, 849, 696498, 917, 89.46885330000077
918, 4.991804780003553, 15.692278587889529, 18.831372369549232, 0.10000000000000071, 170.0, 668, 697166, 918, 65.94129659999453
919, 5.967891888008562, 15.650987307230631, 18.79818222873895, 0.10000000000000095, 100.0, 645, 697811, 919, 64.56820579999476
920, 4.873201104120283, 15.657431746610166, 18.77485694693078, 0.0999999999999997, 275.0, 794, 698605, 920, 74.30775409999478
921, 6.27864796028474, 15.634098757136117, 18.768757570612678, 0.10000000000000099, 115.0, 623, 699228, 921, 57.312715000000026
922, 5.66569210718299, 15.61089053567966, 18.72665575156258, 0.10000000000000099, 110.0, 622, 699850, 922, 56.96019019999949
923, 5.596461176408404, 15.648022850199895, 18.771876290614504, 0.1000000000000009, 20.0, 514, 700364, 923, 47.04580079999869
924, 5.990230929981108, 15.655882928682411, 18.786914833732272, 0.10000000000000084, 115.0, 460, 700824, 924, 42.53015929999674
925, 6.10064565982965, 15.672462780457323, 18.805679440803235, 0.09999999999999978, 150.0, 782, 701606, 925, 73.47635949999676
926, 5.551604418337345, 15.669851524353028, 18.795094646453858, 0.09999999999999859, 345.0, 1000, 702606, 926, 92.93574470000021
927, 5.607080961148056, 15.652648255922562, 18.77201681042928, 0.10000000000000035, 120.0, 709, 703315, 927, 64.75769880000007
928, 6.136547864278158, 15.648875283905953, 18.77597452799479, 0.0999999999999995, 195.0, 825, 704140, 928, 75.47262410000258
929, 5.7338615349803685, 15.615084289600377, 18.72345417473195, 0.09999999999999895, 305.0, 923, 705063, 929, 85.07465180000145
930, 5.830729621786338, 15.606507018162654, 18.71827627328726, 0.1000000000000009, 45.0, 650, 705713, 930, 59.63350720000017
931, 5.642737944058142, 15.596413902856279, 18.709545350584673, 0.09999999999999709, 665.0, 1543, 707256, 931, 140.67588830000022
932, 5.249267572583012, 15.527067231498588, 18.62057073473704, 0.10000000000000091, 40.0, 527, 707783, 932, 49.3281891000006
933, 5.793302449799535, 15.538675123913924, 18.639258729549418, 0.09999999999999964, 215.0, 802, 708585, 933, 74.32787720000488
934, 5.201301212177098, 15.53988916272315, 18.645793804275655, 0.10000000000000092, 55.0, 535, 709120, 934, 48.8155431999985
935, 4.673381246858173, 15.53671196937561, 18.63726460562812, 0.09999999999999906, 200.0, 900, 710020, 935, 83.45870509999804
936, 5.751141561287635, 15.629162873088832, 18.74935163786117, 0.09999999999999926, 130.0, 867, 710887, 936, 80.96698979999928
937, 5.9041948761442855, 15.62872159003605, 18.748947352114104, 0.09999999999999705, 630.0, 1573, 712460, 937, 144.08830529999977
938, 5.066550841395344, 15.57779688664845, 18.68479816232409, 0.10000000000000094, 40.0, 560, 713020, 938, 52.15353280000272
939, 5.288573373713203, 15.575422042930448, 18.694934169988375, 0.09999999999999792, 420.0, 1184, 714204, 939, 108.01815300000453
940, 5.020432392207298, 15.591714963069936, 18.698686515428744, 0.10000000000000023, 185.0, 724, 714928, 940, 61.7955804000012
941, 5.9897884868568605, 15.563952648801502, 18.67402477178099, 0.10000000000000077, 105.0, 663, 715591, 941, 58.390052499999
942, 5.567655960107461, 15.575331447063348, 18.688886798956457, 0.0999999999999998, 130.0, 780, 716371, 942, 71.12792479999916
943, 5.238610991162209, 15.561020236687373, 18.67087027103842, 0.10000000000000081, 110.0, 447, 716818, 943, 38.54692200000136
944, 5.161046834503674, 15.575701106914375, 18.69533447085621, 0.0999999999999982, 215.0, 1102, 717920, 944, 96.52645330000087
945, 5.590397522996463, 15.593467373482197, 18.702560592586938, 0.09999999999999734, 600.0, 1421, 719341, 945, 126.13689200000226
946, 5.218753354641998, 15.558931603345725, 18.67950460351952, 0.10000000000000024, 305.0, 721, 720062, 946, 64.94337209999503
947, 5.316259848020579, 15.535282502927279, 18.644385908026443, 0.09999999999999658, 730.0, 1900, 721962, 947, 207.91858800000045
948, 5.0927591168343005, 15.523939384325116, 18.63515151278319, 0.0999999999999975, 470.0, 1353, 723315, 948, 148.50291899999866
949, 5.240828587601729, 15.545733917718646, 18.65344510133239, 0.09999999999999783, 385.0, 1218, 724533, 949, 132.05558870000095
950, 5.204717424365559, 15.553225386355605, 18.666671233517782, 0.09999999999999909, 300.0, 896, 725429, 950, 91.750798699999
951, 5.658687134114344, 15.57476151280287, 18.68378409234489, 0.10000000000000084, 160.0, 656, 726085, 951, 68.58213220000471
952, 5.840507578580899, 15.549928925688702, 18.671232852123136, 0.09999999999999967, 260.0, 798, 726883, 952, 86.1447374000054
953, 5.921529301041918, 15.58492616649323, 18.71355018450941, 0.10000000000000084, 75.0, 463, 727346, 953, 45.858751299994765
954, 6.276414412111508, 15.574556331396845, 18.691360951955446, 0.10000000000000098, 85.0, 642, 727988, 954, 56.357306300000346
955, 5.317995383153209, 15.529444708217511, 18.641236674443153, 0.09999999999999726, 410.0, 1462, 729450, 955, 126.7734558000011
956, 4.70540789700159, 15.525570917809633, 18.63817043274216, 0.10000000000000099, 130.0, 631, 730081, 956, 55.68970540000009
957, 5.434312947671111, 15.629219788392877, 18.757150307528374, 0.09999999999999873, 315.0, 969, 731050, 957, 85.05261389999941
958, 5.480168839154079, 15.657999567975823, 18.7822062206851, 0.09999999999999867, 130.0, 982, 732032, 958, 98.32205380000232
959, 5.344364272264259, 15.674592575804315, 18.80915994198961, 0.09999999999999781, 355.0, 1221, 733253, 959, 256.70514990000083
960, 5.42315920067556, 15.720226475686738, 18.88685921466712, 0.1000000000000008, 160.0, 660, 733913, 960, 129.19063879999885
961, 5.033080605745942, 15.701858100924547, 18.85587748929558, 0.09999999999999806, 425.0, 1141, 735054, 961, 136.89892139999574
962, 5.537288702361247, 15.738837801349101, 18.901948344645074, 0.09999999999999991, 240.0, 764, 735818, 962, 81.34733859999687
963, 5.339219251716578, 15.710825997811776, 18.85168970249317, 0.10000000000000092, 30.0, 540, 736358, 963, 54.1069439999992
964, 5.36252038448139, 15.699475878977594, 18.83788146681458, 0.0999999999999984, 225.0, 1048, 737406, 964, 108.88783459999831
965, 4.86748680204585, 15.697432056371717, 18.81500332597373, 0.10000000000000064, 40.0, 345, 737751, 965, 43.05628070000239
966, 5.5143357467531855, 15.67594723952444, 18.830078335334186, 0.10000000000000074, 105.0, 399, 738150, 966, 48.174736400003894
967, 5.73539325534492, 15.719080724587311, 18.871860810872672, 0.09999999999999722, 315.0, 1480, 739630, 967, 181.74868779999815
968, 5.675382340323022, 15.592414722747485, 18.697977365595836, 0.0999999999999973, 715.0, 1439, 741069, 968, 177.26733299999614
969, 5.344002565879547, 15.550908758285198, 18.658931713080378, 0.09999999999999967, 185.0, 799, 741868, 969, 153.18316590000177
970, 5.515652245277172, 15.564687965156791, 18.684531405255512, 0.09999999999999859, 230.0, 1001, 742869, 970, 183.9960546000002
971, 5.233088622907646, 15.557760776454256, 18.667133191159664, 0.0999999999999984, 120.0, 1048, 743917, 971, 132.14076829999976
972, 5.854570867209085, 15.575493665665352, 18.688658678718134, 0.09999999999999946, 195.0, 831, 744748, 972, 95.01588789999369
973, 5.263059400821448, 15.548512825808983, 18.68027089764291, 0.10000000000000044, 150.0, 699, 745447, 973, 96.6699129999979
974, 4.956509234927999, 15.565908913745403, 18.680682735471123, 0.1000000000000006, 180.0, 681, 746128, 974, 165.70857039999828
975, 5.428547272105207, 15.575672161858728, 18.682618848804726, 0.09999999999999888, 415.0, 938, 747066, 975, 257.5901013000039
976, 5.24866367773169, 15.552679760607681, 18.655785312542335, 0.10000000000000049, 160.0, 692, 747758, 976, 183.7506177000032
977, 5.6100467254873365, 15.548140816390514, 18.659475199878216, 0.09999999999999988, 290.0, 768, 748526, 977, 205.71931409999524
978, 5.800235590960253, 15.553212695198264, 18.667883274261964, 0.0999999999999989, 150.0, 935, 749461, 978, 243.6807422999991
979, 5.448605988104973, 15.600261203794949, 18.723014275067726, 0.09999999999999729, 480.0, 1443, 750904, 979, 363.14382909999404
980, 4.768388013473622, 15.615635678247752, 18.74430107223201, 0.09999999999999974, 180.0, 788, 751692, 980, 184.88731410000037
981, 4.6936380118835626, 15.59880762926237, 18.74193660706047, 0.10000000000000099, 115.0, 635, 752327, 981, 154.86362129999907
982, 5.089380457871397, 15.610542622418471, 18.750336950597628, 0.10000000000000066, 60.0, 355, 752682, 982, 88.04976660000102
983, 5.051641084944694, 15.588933900882527, 18.711584717408755, 0.09999999999999788, 555.0, 1197, 753879, 983, 346.080873299994
984, 4.626475259122559, 15.582240125377341, 18.711795812405313, 0.1000000000000005, 135.0, 691, 754570, 984, 174.14211730000534
985, 5.235641931864258, 15.584247225251161, 18.70728313034448, 0.09999999999999908, 300.0, 899, 755469, 985, 214.72538180000265
986, 6.08434308174426, 15.591816918307511, 18.712479816416582, 0.09999999999999884, 555.0, 945, 756414, 986, 87.98106199999893
987, 5.570270689282172, 15.585466541516421, 18.720041182344694, 0.09999999999999848, 230.0, 1029, 757443, 987, 99.69623600000341
988, 5.977171333766205, 15.609659955228445, 18.739607474383185, 0.10000000000000094, 125.0, 646, 758089, 988, 59.725299499994435
989, 6.28871264651015, 15.614651543273208, 18.760927130836997, 0.09999999999999934, 440.0, 851, 758940, 989, 72.60419019999972
990, 5.42136354650463, 15.620962358690477, 18.76061620702734, 0.0999999999999986, 150.0, 999, 759939, 990, 85.17215219999343
991, 5.245073080716557, 15.886018634199026, 19.07991593951361, 0.09999999999999858, 270.0, 1003, 760942, 991, 90.79821680000168
992, 4.85038170142501, 15.909157803479363, 19.092325603260715, 0.1000000000000009, 35.0, 510, 761452, 992, 48.39227440000104
993, 5.071841943913989, 15.924479999011188, 19.126896605967367, 0.09999999999999928, 175.0, 862, 762314, 993, 79.12826249999489
994, 5.181517284078134, 15.9344831134962, 19.13387563954229, 0.09999999999999874, 115.0, 966, 763280, 994, 97.79960190000565
995, 5.251578934819011, 15.950770014423435, 19.137962447990805, 0.10000000000000096, 100.0, 590, 763870, 995, 55.804602199998044
996, 5.739619152496011, 15.9615670239343, 19.171263832632352, 0.09999999999999858, 245.0, 1003, 764873, 996, 91.66262909999932
997, 5.156636001698882, 15.929543092986133, 19.135665470194592, 0.09999999999999931, 320.0, 856, 765729, 997, 77.67465190000075
998, 4.586007431808271, 15.906324490998921, 19.09393021834524, 0.10000000000000085, 105.0, 475, 766204, 998, 42.79941010000039
999, 4.64265246845908, 15.934740520735918, 19.12547856023756, 0.10000000000000096, 125.0, 590, 766794, 999, 53.52924029999849
1000, 5.474838492669622, 15.951675810781467, 19.16294667672138, 0.09999999999999795, 280.0, 1176, 767970, 1000, 107.08037189999595
1001, 6.150863541925088, 16.0121072559634, 19.220225702387452, 0.10000000000000099, 110.0, 619, 768589, 1001, 56.49932339999941
1002, 5.057686343178692, 15.992210447931864, 19.200807647245476, 0.09999999999999946, 190.0, 830, 769419, 1002, 75.8949930000017
1003, 5.614850474699684, 16.008366335163945, 19.223580998959747, 0.09999999999999803, 460.0, 1150, 770569, 1003, 112.95320460000221
1004, 4.941209504542323, 16.032113637538316, 19.250082451484108, 0.10000000000000064, 50.0, 346, 770915, 1004, 32.77102300000115
1005, 5.4987748927540245, 16.039711120152713, 19.25505008842006, 0.09999999999999971, 135.0, 792, 771707, 1005, 72.94450089999737
1006, 4.657860424300502, 16.02405788930886, 19.25194623119604, 0.0999999999999996, 150.0, 809, 772516, 1006, 74.31469959999959
1007, 5.083921017249425, 16.033741560100037, 19.249347889276198, 0.0999999999999996, 310.0, 810, 773326, 1007, 74.7524779000014
1008, 5.72694094362971, 16.021955824517583, 19.230419372583363, 0.10000000000000098, 190.0, 616, 773942, 1008, 57.04399099999864
1009, 5.468283786082679, 16.051121564073128, 19.27818993551946, 0.09999999999999706, 515.0, 1563, 775505, 1009, 144.30064229999698
1010, 5.604202949083769, 16.064610736327765, 19.292935582448745, 0.09999999999999938, 210.0, 845, 776350, 1010, 78.31089899999643
1011, 5.500586168494434, 16.090420883242825, 19.301857074769604, 0.09999999999999831, 295.0, 1071, 777421, 1011, 99.26887569999963
1012, 5.2579106967824965, 16.101266359680924, 19.332385762921707, 0.0999999999999976, 175.0, 1307, 778728, 1012, 121.39903299999423
1013, 4.921250482842291, 16.104965949226038, 19.328833792192874, 0.09999999999999933, 185.0, 854, 779582, 1013, 79.33182709999528
1014, 5.123566750861421, 16.22303642653212, 19.490531230274634, 0.10000000000000099, 120.0, 632, 780214, 1014, 58.69517479999922
1015, 5.262015034679813, 16.438743298703972, 19.72941721569408, 0.09999999999999971, 180.0, 792, 781006, 1015, 73.77651649999461
1016, 5.324899296188354, 16.433406007385255, 19.724356158447264, 0.10000000000000099, 105.0, 625, 781631, 1016, 58.628019000003405
1017, 5.348522567502183, 16.44929880753214, 19.73617075131378, 0.09999999999999952, 415.0, 821, 782452, 1017, 76.68527950000134
1018, 5.803735758450989, 16.454606605070364, 19.753912815572242, 0.09999999999999853, 245.0, 1013, 783465, 1018, 94.52919680000196
1019, 4.897981605443087, 16.499003663496538, 19.80405565435236, 0.09999999999999744, 335.0, 1375, 784840, 1019, 128.84125810000114
1020, 5.242965949954334, 16.525880069653525, 19.853708421540954, 0.09999999999999876, 300.0, 964, 785804, 1020, 90.42061879999528
1021, 5.2967827385985755, 16.56539012104809, 19.89128741384472, 0.10000000000000073, 30.0, 389, 786193, 1021, 36.47467519999918
1022, 5.066952725452205, 16.524526125119056, 19.8466413435845, 0.09999999999999912, 235.0, 891, 787084, 1022, 83.40420319999976
1023, 5.925504593199389, 16.546638734193316, 19.867175899378072, 0.09999999999999865, 285.0, 987, 788071, 1023, 92.02421560000221
1024, 4.936273679798997, 16.54579194727572, 19.861263561394825, 0.10000000000000087, 45.0, 653, 788724, 1024, 61.03985760000069
1025, 5.321889245964182, 16.564429483564012, 19.889719244895172, 0.09999999999999806, 340.0, 1142, 789866, 1025, 107.64282739999908
1026, 5.4211478689857575, 16.687739685575576, 20.042746773001106, 0.0999999999999987, 245.0, 974, 790840, 1026, 91.13214660000085
1027, 5.29914790816332, 16.70779253874774, 20.061816240480432, 0.0999999999999988, 240.0, 955, 791795, 1027, 90.81845959999919
1028, 4.904216719178197, 16.672874758609783, 20.006924234587572, 0.100000000000001, 125.0, 638, 792433, 1028, 64.70084879999922
1029, 5.225492112220279, 16.667007021269374, 20.00674782684289, 0.09999999999999953, 330.0, 819, 793252, 1029, 81.57302740000159
1030, 5.379521070077631, 16.663511239778767, 20.019917209844042, 0.09999999999999787, 420.0, 1203, 794455, 1030, 113.33673740000086
1031, 5.5052119762666765, 16.67703602633776, 20.03677198478038, 0.10000000000000096, 105.0, 589, 795044, 1031, 56.37944520000019
1032, 5.250288735204768, 16.651834298962743, 19.99262075335066, 0.10000000000000092, 70.0, 535, 795579, 1032, 50.997890499995265
1033, 5.583909370665478, 16.702968474467525, 20.044261418396378, 0.09999999999999815, 260.0, 1117, 796696, 1033, 104.61324369999784
1034, 5.611005014540904, 16.711240177247888, 20.074285135378066, 0.0999999999999978, 325.0, 1226, 797922, 1034, 115.77795989999868
1035, 4.7485606120182915, 16.726432497388966, 20.07465238074215, 0.10000000000000075, 75.0, 403, 798325, 1035, 38.36330689999886
1036, 5.071955724537951, 16.71569392056141, 20.063650089560202, 0.0999999999999995, 225.0, 824, 799149, 1036, 77.50398860000132
1037, 5.337109575777303, 16.717918697594296, 20.07981717807516, 0.09999999999999898, 255.0, 917, 800066, 1037, 86.06161450000218
1038, 5.715334206850354, 16.635561931219563, 19.97946424592737, 0.09999999999999874, 405.0, 967, 801033, 1038, 91.54381990000547
1039, 5.278026048265415, 16.662888510752534, 20.004350094183305, 0.09999999999999949, 180.0, 826, 801859, 1039, 78.96651279999787
1040, 5.078644557345298, 16.705427036136886, 20.05438872200496, 0.0999999999999967, 730.0, 1798, 803657, 1040, 173.27012419999664
1041, 5.475650034757515, 16.711674354783256, 20.07885565669892, 0.0999999999999979, 565.0, 1194, 804851, 1041, 113.07428759999311
1042, 5.35821796955502, 16.710808134137345, 20.078262289413768, 0.09999999999999955, 210.0, 817, 805668, 1042, 77.01616070000455
1043, 5.522879523591379, 16.753817848944934, 20.11172257648425, 0.10000000000000032, 150.0, 712, 806380, 1043, 67.29227410000021
1044, 5.454883932400105, 16.727859593149443, 20.088713192821142, 0.09999999999999963, 180.0, 804, 807184, 1044, 75.76327960000344
1045, 4.898741916297988, 16.724533762920107, 20.06993026171035, 0.10000000000000075, 80.0, 407, 807591, 1045, 38.52970810000261
1046, 5.408104403946621, 16.730721115301115, 20.092444800106787, 0.09999999999999824, 400.0, 1091, 808682, 1046, 103.66952190000302
1047, 5.177243552752959, 16.717321543007944, 20.07227960041151, 0.09999999999999777, 365.0, 1238, 809920, 1047, 116.85813790000248
1048, 5.285568015152957, 16.803811964823613, 20.175646391517034, 0.10000000000000087, 80.0, 491, 810411, 1048, 47.01416729999619
1049, 5.210825477739489, 16.86275793751457, 20.24912341586172, 0.09999999999999881, 245.0, 951, 811362, 1049, 90.84435649999796
1050, 4.958836124888782, 16.84397069613139, 20.200640886679462, 0.10000000000000064, 50.0, 348, 811710, 1050, 37.65659709999454
1051, 5.760253534965697, 16.85334794674967, 20.232048920060116, 0.09999999999999942, 410.0, 838, 812548, 1051, 84.51699129999906
1052, 5.6571985291846, 16.86139901479085, 20.255122482461275, 0.10000000000000095, 80.0, 567, 813115, 1052, 56.90828480000346
1053, 5.385423081608255, 16.818357806806446, 20.199250137261057, 0.09999999999999909, 190.0, 897, 814012, 1053, 89.79250799999863
1054, 5.610977949096861, 16.85776423726154, 20.245226375112797, 0.09999999999999813, 285.0, 1119, 815131, 1054, 112.09291329999542
1055, 5.659757978880584, 16.850267642766088, 20.233490597549363, 0.10000000000000098, 80.0, 603, 815734, 1055, 60.14253749999625
1056, 5.2103887557983395, 16.83667571026346, 20.217440194076634, 0.09999999999999963, 185.0, 805, 816539, 1056, 81.04258490000211
1057, 5.625566244006537, 16.848273009584663, 20.234754895479487, 0.09999999999999773, 295.0, 1254, 817793, 1057, 123.36539579999953
1058, 5.177401456607586, 16.881236507561788, 20.274583412699723, 0.09999999999999944, 220.0, 836, 818629, 1058, 81.3970221999989
1059, 5.175605388436207, 16.9120599835418, 20.298894092648528, 0.1000000000000008, 50.0, 430, 819059, 1059, 42.33773530000326
1060, 5.178944348899368, 16.889775066334177, 20.271902884273487, 0.09999999999999898, 115.0, 918, 819977, 1060, 91.08466100000078
1061, 4.850490313432586, 16.91154600331481, 20.31876137961804, 0.10000000000000066, 80.0, 355, 820332, 1061, 36.38241240000207
1062, 5.577852936704522, 16.90835622082586, 20.291452646255493, 0.10000000000000069, 75.0, 368, 820700, 1062, 35.41590790000191
1063, 5.464161606658675, 16.899925507664364, 20.292015950939067, 0.09999999999999999, 155.0, 754, 821454, 1063, 75.89925800000492
1064, 5.438470573605967, 16.906150205705707, 20.29843538406168, 0.10000000000000067, 135.0, 673, 822127, 1064, 61.720661599996674
1065, 4.55737840056799, 16.891152506421324, 20.26571287471018, 0.10000000000000099, 80.0, 628, 822755, 1065, 61.5517841999972
1066, 5.479356532264501, 16.888623505085707, 20.280212646722795, 0.09999999999999766, 425.0, 1280, 824035, 1066, 123.16071079999529
1067, 5.8219049870967865, 16.913798193498092, 20.30798117608735, 0.1000000000000008, 130.0, 660, 824695, 1067, 63.282582699997874
1068, 5.498762159212028, 16.920862463029664, 20.300397398285053, 0.10000000000000088, 170.0, 651, 825346, 1068, 56.56165219999821
1069, 4.757127614039227, 16.88246120366835, 20.2673026264162, 0.10000000000000074, 185.0, 665, 826011, 1069, 58.36357660000067
1070, 5.544509326346669, 16.901305382808278, 20.28962006875807, 0.09999999999999842, 380.0, 1041, 827052, 1070, 89.94566119999945
1071, 5.08472627630262, 16.89152010575355, 20.280540184573198, 0.10000000000000063, 150.0, 677, 827729, 1071, 60.60287059999973
1072, 5.513939143956162, 16.93292929816792, 20.326266808546226, 0.10000000000000085, 135.0, 655, 828384, 1072, 60.818062199999986
1073, 5.3346091337301385, 16.926405819013592, 20.32251884899653, 0.09999999999999828, 290.0, 1077, 829461, 1073, 97.94626759999665
1074, 5.268267325259663, 16.922409589000292, 20.317634378412112, 0.10000000000000092, 35.0, 542, 830003, 1074, 48.75592219999817
1075, 4.826729964475338, 16.96842026777294, 20.386283973351915, 0.10000000000000031, 180.0, 714, 830717, 1075, 65.68762860000425
1076, 5.0759873820073675, 16.968842871694854, 20.37385643005371, 0.0999999999999995, 360.0, 825, 831542, 1076, 73.40543810000236
1077, 4.653681097565026, 16.991127892198232, 20.37944029446306, 0.09999999999999801, 375.0, 1160, 832702, 1077, 104.26580079999985
1078, 4.891978254711086, 16.970617844299838, 20.36558104374192, 0.1000000000000004, 145.0, 704, 833406, 1078, 60.56265469999926
1079, 5.514239552265669, 16.94984216286619, 20.34575024732698, 0.09999999999999816, 290.0, 1111, 834517, 1079, 98.23739709999063
1080, 4.7459831668420795, 16.89194829431594, 20.280601930114837, 0.10000000000000077, 110.0, 663, 835180, 1080, 59.59309150000627
1081, 5.385173153407818, 16.921878050695646, 20.321208378769807, 0.09999999999999772, 240.0, 1257, 836437, 1081, 115.32400059999782
1082, 4.728290350974016, 16.95595231801711, 20.350509182190123, 0.09999999999999852, 295.0, 1017, 837454, 1082, 103.19451279999339
1083, 5.004737435911393, 17.00520177686651, 20.41596623080949, 0.09999999999999906, 225.0, 901, 838355, 1083, 86.38187840000319
1084, 4.934473237700083, 16.95298803394491, 20.3259997530417, 0.10000000000000066, 75.0, 352, 838707, 1084, 32.27873590000672
1085, 4.933280158380652, 16.939463613895256, 20.331571298889987, 0.09999999999999773, 295.0, 1253, 839960, 1085, 114.84777139998914
1086, 4.988270376932503, 17.02853872846849, 20.460781543089613, 0.10000000000000088, 40.0, 505, 840465, 1086, 46.2397873000009
1087, 5.18806119010358, 17.033465718556783, 20.45467875817579, 0.09999999999999859, 455.0, 1002, 841467, 1087, 91.17352379999647
1088, 5.0685967800755805, 17.078288670633274, 20.491121772544375, 0.09999999999999892, 230.0, 929, 842396, 1088, 78.82938229999854
1089, 5.654799262289944, 17.06110690422209, 20.484997915185016, 0.1000000000000009, 110.0, 506, 842902, 1089, 42.31698960000358
1090, 4.714652828363439, 17.066869492595945, 20.496283454489816, 0.10000000000000081, 110.0, 659, 843561, 1090, 54.99389549999614
1091, 5.646455229857029, 17.032689701427113, 20.44413465664381, 0.1000000000000008, 110.0, 429, 843990, 1091, 36.66398709999339
1092, 5.00176669939301, 17.09711897587834, 20.530968127285476, 0.0999999999999964, 480.0, 2055, 846045, 1092, 184.64573499999824
1093, 5.587841812002508, 17.14700085754636, 20.59141263478919, 0.10000000000000099, 195.0, 632, 846677, 1093, 56.96463639999274
1094, 4.95879622366146, 17.16317519537345, 20.6123403622756, 0.10000000000000021, 55.0, 726, 847403, 1094, 65.43655499999295
1095, 5.63186520136821, 17.1472823346415, 20.587981047226556, 0.0999999999999989, 155.0, 933, 848336, 1095, 84.23979360000521
1096, 5.234251178865847, 17.11416375533394, 20.538827657284944, 0.10000000000000095, 40.0, 575, 848911, 1096, 51.7997672999918
1097, 5.1990384827268885, 17.126806573130917, 20.556503838414173, 0.0999999999999991, 215.0, 893, 849804, 1097, 80.30520539999998
1098, 4.918422794531262, 17.16595257564085, 20.624779235526404, 0.09999999999999831, 250.0, 1071, 850875, 1098, 96.53845970000839
1099, 5.418243387097696, 17.217686590257582, 20.663630714928857, 0.09999999999999953, 330.0, 819, 851694, 1099, 73.72904879999987
1100, 5.183971434741035, 17.216486554015372, 20.685331839317005, 0.09999999999999865, 270.0, 987, 852681, 1100, 88.79366480000317
1101, 5.016918319980533, 17.24483698034562, 20.716110809414374, 0.09999999999999926, 440.0, 865, 853546, 1101, 77.86770180000167
1102, 4.072656600841647, 17.249633620908337, 20.723060925000862, 0.10000000000000074, 45.0, 397, 853943, 1102, 35.76452630000131
1103, 4.72631856242876, 17.170056754070277, 20.623079705129804, 0.10000000000000081, 140.0, 659, 854602, 1103, 59.353039399997215
1104, 4.83301222204362, 17.203779644934123, 20.653353432520923, 0.0999999999999972, 345.0, 1490, 856092, 1104, 133.9252550999954
1105, 4.816459571266174, 17.215402558898926, 20.680048399353026, 0.09999999999999774, 520.0, 1250, 857342, 1105, 112.34700639999937
1106, 4.808779372697995, 17.243634890332633, 20.720777808295356, 0.0999999999999996, 240.0, 810, 858152, 1106, 72.79441800000495
1107, 5.099418116895644, 17.24617367535382, 20.731192921017026, 0.10000000000000074, 150.0, 666, 858818, 1107, 59.8951681000035
1108, 5.507565769342195, 17.25305406182213, 20.716392100736456, 0.10000000000000063, 105.0, 678, 859496, 1108, 61.002998600000865
1109, 4.906695765798742, 17.26348982146292, 20.74311524593469, 0.0999999999999995, 180.0, 825, 860321, 1109, 74.04634179999994
1110, 4.549648961442673, 17.292472688023917, 20.78421135291368, 0.10000000000000071, 305.0, 668, 860989, 1110, 60.35800170000584
1111, 4.606366248639751, 17.35254741912563, 20.854092062336125, 0.0999999999999992, 240.0, 876, 861865, 1111, 79.44200419999834
1112, 5.649136372803138, 17.37979668356281, 20.87015136584057, 0.09999999999999971, 200.0, 793, 862658, 1112, 71.48734900000272
1113, 4.859661259160576, 17.315833577180168, 20.810724454666303, 0.10000000000000094, 110.0, 554, 863212, 1113, 50.1629782999953
1114, 4.813589739986976, 17.348956174291914, 20.828915953894757, 0.09999999999999895, 190.0, 922, 864134, 1114, 83.27080739999656
1115, 4.981910890301702, 17.382378305579973, 20.87263875423242, 0.09999999999999833, 470.0, 1067, 865201, 1115, 96.20735470000363
1116, 4.553990575386265, 17.36779932519878, 20.862627482845493, 0.10000000000000073, 100.0, 387, 865588, 1116, 35.34463659999892
1117, 5.59856006367188, 17.39708934397798, 20.90253368925067, 0.09999999999999908, 240.0, 899, 866487, 1117, 81.42964879999636
1118, 5.396898785374015, 17.429205920644247, 20.919873567134204, 0.09999999999999734, 485.0, 1421, 867908, 1118, 128.00871610001195
1119, 4.6118753735608475, 17.43539513797122, 20.950979795302306, 0.09999999999999962, 425.0, 807, 868715, 1119, 72.6258400999941
1120, 5.473590769970363, 17.471151901847133, 20.978179529331886, 0.10000000000000081, 120.0, 659, 869374, 1120, 59.49497689999407
1121, 5.486096597348054, 17.543083795219417, 21.061503625501917, 0.09999999999999751, 315.0, 1343, 870717, 1121, 121.01360659999773
1122, 4.871323597064818, 17.57056842289918, 21.094828662015587, 0.09999999999999937, 180.0, 846, 871563, 1122, 76.36975300000631
1123, 5.334540860017596, 17.577648425170548, 21.106892850815736, 0.10000000000000064, 75.0, 349, 871912, 1123, 31.58022920000076
1124, 5.322406196106841, 17.539850975829456, 21.054391539279607, 0.10000000000000096, 30.0, 587, 872499, 1124, 53.07395109999925
1125, 5.14511066513297, 17.54404242715718, 21.0607835251608, 0.0999999999999996, 180.0, 810, 873309, 1125, 72.95588810001209
1126, 4.511061635173735, 17.54058351673064, 21.0648170325274, 0.10000000000000069, 75.0, 366, 873675, 1126, 32.99332029999641
1127, 5.251135614845488, 17.50353926199454, 21.02262261002152, 0.10000000000000092, 80.0, 540, 874215, 1127, 48.66040670000075
1128, 5.4728960136333145, 17.49362068482671, 20.987674762924993, 0.10000000000000088, 85.0, 498, 874713, 1128, 44.95947709999746
1129, 4.838970391249478, 17.482108714112897, 20.99672790355621, 0.0999999999999989, 265.0, 933, 875646, 1129, 84.00498830000288
1130, 6.142119624293768, 17.53060917569022, 21.04961781216483, 0.10000000000000084, 145.0, 468, 876114, 1130, 42.30292060000647
1131, 4.979298505510278, 17.488999490658347, 21.00020466146367, 0.09999999999999941, 215.0, 839, 876953, 1131, 75.54659060000267
1132, 5.069907819156546, 17.51394949476403, 21.027027932994336, 0.09999999999999755, 240.0, 1328, 878281, 1132, 119.85478769999463
1133, 4.816069175570791, 17.527881428942703, 21.05084313189013, 0.10000000000000088, 125.0, 651, 878932, 1133, 58.60023999999976
1134, 5.0253618206903505, 17.558589208896016, 21.07506328914107, 0.10000000000000082, 105.0, 449, 879381, 1134, 40.299314799995045
1135, 4.629344488766002, 17.599202844466287, 21.130296555880843, 0.09999999999999923, 210.0, 870, 880251, 1135, 78.26775349999662
1136, 5.369040709436294, 17.77643128666101, 21.34384276608933, 0.0999999999999994, 400.0, 841, 881092, 1136, 75.49940960000094
1137, 4.986327360470098, 17.757115656598252, 21.313848719037978, 0.09999999999999964, 185.0, 802, 881894, 1137, 71.92327379999915
1138, 5.628329984069298, 17.78883848566308, 21.357354164123535, 0.10000000000000094, 155.0, 558, 882452, 1138, 50.09678530000383
1139, 5.152318743894798, 17.76208866003788, 21.331656865399292, 0.09999999999999971, 135.0, 792, 883244, 1139, 71.1566271000047
1140, 5.228851455827834, 17.741874822428528, 21.304300796258058, 0.09999999999999934, 245.0, 852, 884096, 1140, 76.55179240000143
1141, 5.178888896125308, 17.70667779234034, 21.270257794081108, 0.09999999999999938, 345.0, 845, 884941, 1141, 76.21210289999726
1142, 5.124272492615986, 17.71054254201897, 21.25652978591275, 0.09999999999999883, 300.0, 948, 885889, 1142, 85.18780809998862
1143, 5.368737275227904, 17.69920352220535, 21.271554462909698, 0.09999999999999966, 165.0, 800, 886689, 1143, 72.07124349998776
1144, 4.845420394685659, 17.729327924461092, 21.295486830758936, 0.10000000000000078, 75.0, 421, 887110, 1144, 37.84958280000137
1145, 4.345574300489367, 17.701838718173317, 21.270270172730434, 0.10000000000000091, 105.0, 649, 887759, 1145, 58.456634300004225
1146, 5.345929545860551, 17.743931904910006, 21.294192373481252, 0.10000000000000081, 105.0, 659, 888418, 1146, 55.41742300000624
1147, 5.49249383279079, 17.768582248193614, 21.322020462510498, 0.09999999999999874, 250.0, 965, 889383, 1147, 78.9213119000051
1148, 5.156886111389106, 17.83524582153772, 21.414117436814692, 0.09999999999999959, 180.0, 811, 890194, 1148, 66.21045410000079
1149, 5.283280512538116, 18.054055619281858, 21.687616154840594, 0.09999999999999809, 435.0, 1134, 891328, 1149, 92.5916675000044
1150, 6.137888850530988, 18.079069977286476, 21.7195689283327, 0.10000000000000085, 130.0, 477, 891805, 1150, 38.94165440001234
1151, 4.6999896944874395, 18.0814174067365, 21.720543400562594, 0.10000000000000056, 115.0, 685, 892490, 1151, 57.579607099993154
1152, 5.595156735405226, 18.162659654017272, 21.802834772521074, 0.09999999999999719, 515.0, 1494, 893984, 1152, 122.2446917000052
1153, 6.1103963467496385, 18.15325947296925, 21.80702388169027, 0.1000000000000009, 75.0, 507, 894491, 1153, 41.49898219999159
1154, 5.35638039909912, 18.18789972683799, 21.84428875795753, 0.0999999999999971, 320.0, 1542, 896033, 1154, 125.59905369998887
1155, 4.8740592091116435, 18.169509734533065, 21.816849573343582, 0.09999999999999969, 215.0, 797, 896830, 1155, 65.05095699999947
1156, 5.328193622165256, 18.234897601751634, 21.88210403772048, 0.0999999999999996, 170.0, 810, 897640, 1156, 66.19630099998903
1157, 5.598933115253529, 18.281709235691466, 21.957614449179097, 0.09999999999999885, 215.0, 942, 898582, 1157, 76.85358500000439
1158, 5.0066827338689945, 18.281117082339282, 21.955679873974002, 0.10000000000000057, 165.0, 684, 899266, 1158, 55.895976300002076
1159, 5.070353461117007, 18.324738438093064, 22.015023719770976, 0.09999999999999898, 280.0, 918, 900184, 1159, 74.83742569999595
1160, 5.32674763290031, 18.70297813866437, 22.469896762929064, 0.10000000000000078, 105.0, 423, 900607, 1160, 34.554997600003844
1161, 5.86688835171314, 18.700090056232526, 22.447110699905274, 0.09999999999999916, 435.0, 883, 901490, 1161, 72.0233911999967
1162, 5.347523336973249, 18.69489769550584, 22.45138022855202, 0.09999999999999963, 220.0, 805, 902295, 1162, 65.95278989999497
1163, 5.586291025285526, 18.72865229555408, 22.491826511100125, 0.09999999999999978, 160.0, 782, 903077, 1163, 64.17280490000849
1164, 5.604141932913057, 18.672262670878112, 22.432011068037415, 0.09999999999999838, 300.0, 1051, 904128, 1164, 92.69271689999732
1165, 5.921283998792036, 18.670243169359594, 22.429780981495384, 0.09999999999999801, 460.0, 1158, 905286, 1165, 94.64759099998628
1166, 6.027250664693684, 18.639693286831818, 22.37293062263361, 0.10000000000000067, 75.0, 358, 905644, 1166, 29.109918100002687
1167, 5.410215527765988, 18.678831847333118, 22.425529303471688, 0.09999999999999729, 630.0, 1448, 907092, 1167, 118.61734749999596
1168, 5.741345723290249, 18.7350329834951, 22.4940932390377, 0.09999999999999916, 355.0, 884, 907976, 1168, 72.05062040001212
1169, 5.263748404925902, 18.734934116788576, 22.489980057365297, 0.10000000000000035, 185.0, 709, 908685, 1169, 57.875891999996384
1170, 5.031422966443782, 18.700006019412065, 22.457844668754174, 0.09999999999999913, 280.0, 889, 909574, 1170, 72.72897060000105
1171, 5.887156468333927, 18.702832111511952, 22.444334841789082, 0.10000000000000078, 85.0, 423, 909997, 1171, 34.81261919999088
1172, 5.600327414265737, 18.498026748809163, 22.20547599575428, 0.1000000000000004, 110.0, 703, 910700, 1172, 56.81666409999889
1173, 5.245516453781267, 18.48631331346331, 22.181640837314355, 0.09999999999999822, 260.0, 1096, 911796, 1173, 88.64799100000528
1174, 5.4730551110022265, 18.48851075918668, 22.207708040029996, 0.1000000000000007, 75.0, 377, 912173, 1174, 30.764185699998052
1175, 6.556604402288794, 18.50632926940918, 22.209193296432495, 0.10000000000000074, 90.0, 400, 912573, 1175, 32.6541220999934
1176, 5.742521869695385, 18.5324142807372, 22.242313882939794, 0.09999999999999742, 495.0, 1379, 913952, 1176, 112.53601489998982
1177, 6.315240926012512, 18.595286462473315, 22.324297644740852, 0.09999999999999765, 520.0, 1290, 915242, 1177, 105.20839559999877
1178, 6.097382926121923, 18.61645506647707, 22.353265072189213, 0.10000000000000085, 130.0, 655, 915897, 1178, 53.561107699992135
1179, 5.628134566027627, 18.637072753256387, 22.35462337539387, 0.10000000000000096, 145.0, 587, 916484, 1179, 47.958749700002954
1180, 5.640625729908864, 18.6166248956502, 22.335337510640123, 0.0999999999999998, 400.0, 781, 917265, 1180, 63.78417339999578
1181, 6.267956013834283, 18.591135244095668, 22.310509413815616, 0.09999999999999966, 185.0, 801, 918066, 1181, 65.35847960000683
1182, 5.378152464626294, 18.586691623743206, 22.302709249764536, 0.10000000000000099, 145.0, 619, 918685, 1182, 50.594722100009676
1183, 5.7423228364286985, 18.773551616150343, 22.540752887990298, 0.0999999999999967, 800.0, 1803, 920488, 1183, 146.96695240000554
1184, 6.532754386084052, 19.276991408187275, 23.132997667606723, 0.09999999999999817, 350.0, 1109, 921597, 1184, 90.6941450000013
1185, 6.456898616161197, 19.27125799357891, 23.129699686169623, 0.100000000000001, 165.0, 640, 922237, 1185, 52.291344199999
1186, 5.931173640114764, 19.255833033403736, 23.122045189325064, 0.0999999999999976, 245.0, 1304, 923541, 1186, 106.46844189999683
1187, 5.854324054595961, 19.32233514449431, 23.19172410889019, 0.09999999999999919, 245.0, 879, 924420, 1187, 71.93397099999129
1188, 5.871016972910629, 19.282577446427325, 23.148519891207336, 0.10000000000000069, 125.0, 671, 925091, 1188, 54.93001180001011
1189, 6.079877134285817, 19.279159003104212, 23.15315596911372, 0.09999999999999916, 255.0, 882, 925973, 1189, 72.33647959999507
1190, 5.536795650665668, 19.234250046099405, 23.08989456433288, 0.09999999999999964, 215.0, 803, 926776, 1190, 65.71010779999779
1191, 5.889969838517053, 19.305841670717513, 23.185112812405542, 0.09999999999999941, 230.0, 840, 927616, 1191, 68.71719830000075
1192, 5.813795325734199, 19.31774442655231, 23.189714251527, 0.09999999999999824, 200.0, 1090, 928706, 1192, 89.06230360000336
1193, 5.475698800817613, 19.284714421918316, 23.141640840038175, 0.10000000000000006, 135.0, 744, 929450, 1193, 61.11969770000724
1194, 5.628458077998439, 19.24524394492932, 23.110835755352483, 0.09999999999999912, 175.0, 892, 930342, 1194, 73.12031470000511
1195, 5.966634410065274, 19.131967307985292, 22.974094860313475, 0.1000000000000009, 145.0, 516, 930858, 1195, 42.41378030000487
1196, 5.885124343148391, 19.108832070721277, 22.950301872054187, 0.10000000000000088, 110.0, 651, 931509, 1196, 53.42075359998853
1197, 6.002039033543568, 19.139055271488413, 22.99415468016957, 0.09999999999999794, 300.0, 1179, 932688, 1197, 96.65621669999382
1198, 5.763824788899555, 19.118400605153017, 22.966098673850347, 0.09999999999999784, 415.0, 1214, 933902, 1198, 101.77358440001262
1199, 5.44329258218585, 19.124500344196957, 22.95268640064058, 0.09999999999999751, 725.0, 1344, 935246, 1199, 110.95750269999553
1200, 5.583624847281364, 19.118501964692147, 22.949843096989458, 0.09999999999999891, 210.0, 930, 936176, 1200, 76.29573730000993
1201, 5.301267195106449, 19.15217987003183, 22.976356982467767, 0.10000000000000074, 155.0, 665, 936841, 1201, 54.721071899999515
1202, 6.3075028633127115, 19.175027892613176, 22.996297194225953, 0.10000000000000088, 105.0, 505, 937346, 1202, 41.53669429999718
1203, 5.733959199671812, 19.16033533248068, 22.998201283947353, 0.10000000000000099, 145.0, 641, 937987, 1203, 52.66695120000804
1204, 5.441266519263407, 19.092871782065416, 22.915506712552133, 0.10000000000000017, 195.0, 731, 938718, 1204, 60.275549799989676
1205, 5.432074739149946, 19.061016597274193, 22.88406819414608, 0.09999999999999915, 385.0, 886, 939604, 1205, 72.70323749999807
1206, 7.150782872376771, 19.067382458982795, 22.889503088490716, 0.10000000000000084, 105.0, 464, 940068, 1206, 38.248830600001384
1207, 5.802025080026693, 19.240901376733827, 23.091933825507237, 0.09999999999999969, 260.0, 796, 940864, 1207, 65.55962730001193
1208, 5.250254210004109, 19.24479664292812, 23.11256164330778, 0.09999999999999871, 310.0, 971, 941835, 1208, 79.68591060000472
1209, 5.566085179936153, 19.228751083793764, 23.06806505382254, 0.10000000000000099, 55.0, 618, 942453, 1209, 50.810193799989065
1210, 6.4870942601511645, 19.254388771463564, 23.108853518690694, 0.10000000000000082, 150.0, 657, 943110, 1210, 54.08670480000728
1211, 6.156870965681008, 19.219995491812675, 23.082278742174214, 0.09999999999999944, 390.0, 836, 943946, 1211, 68.6345629000134
1212, 6.8007988066963065, 19.263740760845373, 23.14427873706291, 0.10000000000000067, 75.0, 362, 944308, 1212, 29.771847200012417
1213, 6.198578229998097, 19.23333993102565, 23.10418552051891, 0.1000000000000008, 150.0, 660, 944968, 1213, 54.43115800000669
1214, 5.562717114295159, 19.2334646411709, 23.095236769922963, 0.09999999999999805, 355.0, 1144, 946112, 1214, 93.86505310000211
1215, 6.062544980774755, 19.31401286391738, 23.190734119296813, 0.09999999999999963, 215.0, 805, 946917, 1215, 66.18030770000769
1216, 6.404628245953856, 19.36980846799653, 23.255453946343785, 0.09999999999999727, 700.0, 1450, 948367, 1216, 119.25736529999995
1217, 6.280319054034495, 19.395177721977234, 23.273157659031096, 0.10000000000000062, 105.0, 336, 948703, 1217, 27.707671000011032
1218, 6.416620529938417, 19.352103250157054, 23.25406916683944, 0.09999999999999809, 660.0, 1134, 949837, 1218, 92.96488630000385
1219, 5.981742711789018, 19.56271576787666, 23.49041290083219, 0.09999999999999713, 390.0, 1526, 951363, 1219, 125.03091420000419
1220, 5.274632747853276, 19.595151636144315, 23.532828571994383, 0.10000000000000094, 105.0, 554, 951917, 1220, 45.591958100005286
1221, 6.08208387489308, 19.61957192175167, 23.58179462952849, 0.09999999999999921, 235.0, 873, 952790, 1221, 71.54954020000878
1222, 5.840621134763613, 19.61688212948944, 23.559142459749552, 0.09999999999999991, 135.0, 764, 953554, 1222, 62.723614399990765
1223, 6.305167074013695, 19.637649372353323, 23.5803712015715, 0.09999999999999815, 480.0, 1118, 954672, 1223, 91.84806620000745
1224, 5.504745971289548, 19.659285548817028, 23.609052634961678, 0.0999999999999995, 240.0, 825, 955497, 1224, 67.80085800000234
1225, 5.655539085121118, 19.722608427668728, 23.69338798153308, 0.09999999999999847, 360.0, 1032, 956529, 1225, 84.57646620000014
1226, 6.586494592103091, 19.7537654485458, 23.705036559027114, 0.1000000000000008, 65.0, 429, 956958, 1226, 35.53188399999635
1227, 6.0692657845765625, 19.703146381831473, 23.65466030337039, 0.10000000000000092, 100.0, 547, 957505, 1227, 45.23081649999949
1228, 5.508331039788379, 19.689696172047363, 23.64570803280856, 0.09999999999999955, 210.0, 818, 958323, 1228, 67.23456849998911
1229, 6.3000029748034585, 19.687555895165097, 23.6617246875554, 0.100000000000001, 120.0, 639, 958962, 1229, 52.598532799995155
1230, 6.219833277906591, 19.699733285178915, 23.665892698611433, 0.10000000000000057, 105.0, 684, 959646, 1230, 56.178440300005605
1231, 5.630130006134697, 19.760843498206064, 23.743170116388686, 0.100000000000001, 120.0, 638, 960284, 1231, 52.513991600004374
1232, 6.568569185838743, 19.76300825760542, 23.747587135091052, 0.09999999999999915, 210.0, 886, 961170, 1232, 72.89332149999973
1233, 5.55214815064371, 19.771025082537236, 23.739222338311414, 0.09999999999999898, 265.0, 917, 962087, 1233, 75.45580179999524
1234, 5.721419653174227, 19.80581461894293, 23.789210051087377, 0.10000000000000037, 265.0, 707, 962794, 1234, 58.317097300008754
1235, 6.6828833964573775, 19.767950756819122, 23.727124306124434, 0.10000000000000067, 55.0, 363, 963157, 1235, 29.915766899997834
1236, 5.966322378409828, 19.74894690790549, 23.726586737627716, 0.09999999999999883, 190.0, 947, 964104, 1236, 77.84780540000065
1237, 5.759167125009646, 19.77924448229891, 23.764421174232194, 0.09999999999999953, 245.0, 819, 964923, 1237, 67.6075303999969
1238, 5.897789776581223, 19.7570792152443, 23.71450311146042, 0.09999999999999738, 575.0, 1397, 966320, 1238, 114.83709349999845
1239, 6.18327265295689, 19.78152736505555, 23.76811082100493, 0.10000000000000044, 105.0, 699, 967019, 1239, 57.687779800005956
1240, 5.537928902936952, 19.742110675101106, 23.700931912571257, 0.0999999999999989, 415.0, 934, 967953, 1240, 77.14277800000855
1241, 6.186730236215463, 19.776565592028128, 23.748470105044902, 0.10000000000000091, 75.0, 521, 968474, 1241, 42.957781000004616
1242, 6.126257080190322, 19.773589829837576, 23.727577868629904, 0.1000000000000006, 125.0, 680, 969154, 1242, 56.11093429999892
1243, 6.125313332861793, 19.834176742247422, 23.81082869794247, 0.09999999999999822, 230.0, 1096, 970250, 1243, 90.53383380000014
1244, 6.117128185066608, 19.988427489394443, 24.002295082862226, 0.09999999999999824, 440.0, 1090, 971340, 1244, 89.9874020999996
1245, 5.778516792873452, 19.9905351693454, 23.999684663200092, 0.10000000000000077, 225.0, 663, 972003, 1245, 54.634288000001106
1246, 5.875685569061752, 19.994456513240653, 23.999044923671754, 0.09999999999999813, 235.0, 1121, 973124, 1246, 92.45868480000354
1247, 5.826508516977622, 20.030155469012517, 24.046837643768054, 0.09999999999999942, 180.0, 837, 973961, 1247, 68.90186169999652
1248, 5.470218319440144, 20.018048232401313, 24.022489372475405, 0.10000000000000087, 100.0, 653, 974614, 1248, 53.802453899988905
1249, 6.122417064692011, 19.960927213790928, 23.960712386546017, 0.10000000000000082, 120.0, 453, 975067, 1249, 37.45103609999933
1250, 6.4141050001322215, 19.96183878688489, 23.96666389400676, 0.10000000000000066, 50.0, 354, 975421, 1250, 29.365594200004125
1251, 5.6990105868592025, 19.912605729513185, 23.920459879188474, 0.10000000000000096, 110.0, 593, 976014, 1251, 49.00726699999359
1252, 5.880225607079044, 19.91840692961927, 23.918725800745694, 0.10000000000000024, 125.0, 721, 976735, 1252, 59.35041949999868
1253, 6.165779843305548, 19.90651316046715, 23.914620620012283, 0.09999999999999877, 195.0, 960, 977695, 1253, 79.09191259999352
1254, 6.461183530255249, 19.89887521950158, 23.882773926652145, 0.0999999999999994, 120.0, 841, 978536, 1254, 69.26915930000541
1255, 6.400450511211934, 19.931412101828535, 23.93865818977356, 0.09999999999999896, 495.0, 920, 979456, 1255, 75.6964971999987
1256, 6.500931337416251, 19.95930218093405, 23.95388369045943, 0.1, 110.0, 751, 980207, 1256, 61.72403140000824
1257, 6.018779659575928, 19.98828090631162, 23.99826510615242, 0.09999999999999706, 260.0, 1565, 981772, 1257, 128.4651981000061
1258, 6.221350991747715, 20.03662686809979, 24.04615636891813, 0.10000000000000092, 135.0, 547, 982319, 1258, 45.32886319998943
1259, 6.862626463495275, 20.05140797809888, 24.081972055537726, 0.1000000000000007, 55.0, 372, 982691, 1259, 30.727180400004727
1260, 5.484900344746658, 20.016501501382116, 24.031453330832793, 0.10000000000000075, 150.0, 664, 983355, 1260, 54.6157111999928
1261, 5.867746688416193, 20.0169149970769, 24.0262894097954, 0.09999999999999969, 215.0, 797, 984152, 1261, 65.45786969999608
1262, 5.577032607674415, 19.914190642087963, 23.910159018447477, 0.10000000000000091, 85.0, 649, 984801, 1262, 53.42011240001011
1263, 6.188880573769319, 19.88988814375917, 23.875380606145903, 0.09999999999999924, 195.0, 868, 985669, 1263, 71.34167750000779
1264, 5.215341724393095, 19.917305818839324, 23.89295069553726, 0.10000000000000027, 125.0, 718, 986387, 1264, 59.070466999997734
1265, 5.975913689088295, 19.91766487500247, 23.900116257807788, 0.10000000000000092, 125.0, 544, 986931, 1265, 44.76861410000129
1266, 5.171706647472044, 19.920062349257567, 23.925404984690797, 0.10000000000000063, 55.0, 339, 987270, 1266, 27.917377699995995
1267, 5.995203412714458, 19.871496210653316, 23.85395149957566, 0.10000000000000071, 50.0, 378, 987648, 1267, 31.290422100006253
1268, 6.049590544856113, 19.846234697732868, 23.816012758645954, 0.10000000000000096, 135.0, 644, 988292, 1268, 53.37940419999359
1269, 6.096595028557703, 19.846372075105837, 23.82754854931257, 0.0999999999999988, 285.0, 955, 989247, 1269, 78.7408609000122
1270, 5.213501628007912, 19.877165163230433, 23.87230312737235, 0.09999999999999952, 375.0, 822, 990069, 1270, 67.9331203000038
1271, 5.445139756930873, 20.02242457975727, 24.028307391924393, 0.09999999999999734, 475.0, 1421, 991490, 1271, 117.61070140000083
1272, 6.324586656563927, 20.08094942835957, 24.120080313670723, 0.09999999999999962, 155.0, 806, 992296, 1272, 66.93637100000342
1273, 5.623188870608733, 20.086837752091753, 24.123564154534392, 0.09999999999999959, 230.0, 811, 993107, 1273, 67.10345189999498
1274, 5.8040368334600565, 20.053697649595502, 24.083184716861936, 0.09999999999999717, 390.0, 1501, 994608, 1274, 124.06767279999622
1275, 5.9202584272758525, 20.093061113357543, 24.12092784318057, 0.09999999999999917, 210.0, 880, 995488, 1275, 72.82580200000666
1276, 5.353460164783999, 20.10037288185238, 24.137056751768718, 0.09999999999999847, 220.0, 1032, 996520, 1276, 85.3913395999989
1277, 6.08766216057527, 20.161269816297597, 24.21123393959081, 0.09999999999999717, 365.0, 1501, 998021, 1277, 124.18485999999393
1278, 5.832679412205412, 20.27756054232819, 24.35621332399773, 0.09999999999999971, 185.0, 792, 998813, 1278, 65.5780800999928
1279, 6.065064627464484, 20.21999840296554, 24.26812133956619, 0.10000000000000057, 80.0, 683, 999496, 1279, 56.699456399990595
