,loss,mae,mean_q,mean_eps,episode_reward,nb_episode_steps,nb_steps,episode,duration
0,0,0,0,0,160.0,685,685,0,1.3974710000000004
1, 0, 0, 0, 0, 165.0, 1169, 1854, 1, 2.3441779999999994
2, 0, 0, 0, 0, 100.0, 560, 2414, 2, 1.1718454999999999
3, 0, 0, 0, 0, 105.0, 657, 3071, 3, 1.3549569999999989
4, 0, 0, 0, 0, 120.0, 586, 3657, 4, 1.2245307000000007
5, 0, 0, 0, 0, 110.0, 600, 4257, 5, 1.271453600000001
6, 0, 0, 0, 0, 80.0, 383, 4640, 6, 0.7881559000000014
7, 0, 0, 0, 0, 185.0, 782, 5422, 7, 1.6207922999999997
8, 0, 0, 0, 0, 120.0, 768, 6190, 8, 1.5693118000000013
9, 0, 0, 0, 0, 130.0, 772, 6962, 9, 1.6256448
10, 0, 0, 0, 0, 55.0, 516, 7478, 10, 1.0766782999999975
11, 0, 0, 0, 0, 110.0, 603, 8081, 11, 1.2368761
12, 0, 0, 0, 0, 145.0, 672, 8753, 12, 1.3863398999999994
13, 0, 0, 0, 0, 110.0, 559, 9312, 13, 1.1499458999999987
14, 0, 0, 0, 0, 50.0, 381, 9693, 14, 0.847498299999998
15, 0, 0, 0, 0, 135.0, 664, 10357, 15, 1.6779189000000017
16, 0, 0, 0, 0, 110.0, 508, 10865, 16, 1.0657844999999995
17, 0, 0, 0, 0, 75.0, 548, 11413, 17, 1.1637830999999998
18, 0, 0, 0, 0, 140.0, 630, 12043, 18, 1.288363399999998
19, 0, 0, 0, 0, 105.0, 664, 12707, 19, 1.3696284999999975
20, 0, 0, 0, 0, 40.0, 417, 13124, 20, 0.887100199999999
21, 0, 0, 0, 0, 135.0, 619, 13743, 21, 1.3335594999999998
22, 0, 0, 0, 0, 60.0, 527, 14270, 22, 1.0934600000000003
23, 0, 0, 0, 0, 55.0, 403, 14673, 23, 0.8550755999999993
24, 0, 0, 0, 0, 110.0, 523, 15196, 24, 1.0478509000000003
25, 0, 0, 0, 0, 365.0, 898, 16094, 25, 1.7582099999999983
26, 0, 0, 0, 0, 150.0, 817, 16911, 26, 1.7279908000000006
27, 0, 0, 0, 0, 330.0, 1384, 18295, 27, 2.6871550999999982
28, 0, 0, 0, 0, 80.0, 444, 18739, 28, 0.9433717000000001
29, 0, 0, 0, 0, 105.0, 615, 19354, 29, 1.2573912000000007
30, 0, 0, 0, 0, 160.0, 818, 20172, 30, 1.6477825999999993
31, 0, 0, 0, 0, 445.0, 1120, 21292, 31, 2.2570914
32, 0, 0, 0, 0, 210.0, 661, 21953, 32, 1.4028259999999975
33, 0, 0, 0, 0, 115.0, 639, 22592, 33, 1.3228843999999995
34, 0, 0, 0, 0, 210.0, 716, 23308, 34, 1.4568364000000003
35, 0, 0, 0, 0, 230.0, 978, 24286, 35, 1.974553499999999
36, 0, 0, 0, 0, 130.0, 443, 24729, 36, 0.9406588000000013
37, 0, 0, 0, 0, 135.0, 604, 25333, 37, 1.2200482000000008
38, 0, 0, 0, 0, 135.0, 774, 26107, 38, 1.5817455000000038
39, 0, 0, 0, 0, 155.0, 605, 26712, 39, 1.2348697999999985
40, 0, 0, 0, 0, 75.0, 521, 27233, 40, 1.0510531000000043
41, 0, 0, 0, 0, 155.0, 710, 27943, 41, 1.4408068999999983
42, 0, 0, 0, 0, 120.0, 648, 28591, 42, 1.3950788999999943
43, 0, 0, 0, 0, 80.0, 531, 29122, 43, 1.1165400000000005
44, 0, 0, 0, 0, 210.0, 1009, 30131, 44, 1.9998793999999975
45, 0, 0, 0, 0, 145.0, 648, 30779, 45, 1.3340762000000126
46, 0, 0, 0, 0, 240.0, 874, 31653, 46, 1.784349800000001
47, 0, 0, 0, 0, 130.0, 751, 32404, 47, 1.5042905999999903
48, 0, 0, 0, 0, 370.0, 1144, 33548, 48, 2.3568546999999995
49, 0, 0, 0, 0, 80.0, 385, 33933, 49, 0.8056886000000105
50, 0, 0, 0, 0, 100.0, 467, 34400, 50, 0.9483444999999904
51, 0, 0, 0, 0, 125.0, 598, 34998, 51, 1.2330893999999972
52, 0, 0, 0, 0, 180.0, 733, 35731, 52, 1.4938975999999968
53, 0, 0, 0, 0, 190.0, 871, 36602, 53, 1.7666285000000101
54, 0, 0, 0, 0, 125.0, 716, 37318, 54, 1.4861568999999974
55, 0, 0, 0, 0, 215.0, 847, 38165, 55, 1.7197692000000018
56, 0, 0, 0, 0, 80.0, 422, 38587, 56, 0.8838104000000016
57, 0, 0, 0, 0, 210.0, 987, 39574, 57, 1.9879260999999957
58, 0, 0, 0, 0, 155.0, 661, 40235, 58, 1.3700477999999947
59, 0, 0, 0, 0, 210.0, 673, 40908, 59, 1.3813999000000052
60, 0, 0, 0, 0, 95.0, 439, 41347, 60, 0.9281495999999976
61, 0, 0, 0, 0, 485.0, 875, 42222, 61, 1.7688631999999984
62, 0, 0, 0, 0, 180.0, 599, 42821, 62, 1.2329082999999912
63, 0, 0, 0, 0, 35.0, 405, 43226, 63, 0.8839394000000027
64, 0, 0, 0, 0, 50.0, 372, 43598, 64, 0.7871203999999921
65, 0, 0, 0, 0, 215.0, 1226, 44824, 65, 2.4471704999999986
66, 0, 0, 0, 0, 75.0, 387, 45211, 66, 0.8118344999999891
67, 0, 0, 0, 0, 185.0, 680, 45891, 67, 1.4081480999999911
68, 0, 0, 0, 0, 30.0, 500, 46391, 68, 1.0431377999999967
69, 0, 0, 0, 0, 410.0, 788, 47179, 69, 1.6014128999999997
70, 0, 0, 0, 0, 130.0, 633, 47812, 70, 1.3181555999999972
71, 0, 0, 0, 0, 180.0, 575, 48387, 71, 1.193733800000004
72, 0, 0, 0, 0, 225.0, 943, 49330, 72, 1.873020000000011
73, 0, 0, 0, 0, 190.0, 798, 50128, 73, 1.6696436999999946
74, 0, 0, 0, 0, 30.0, 540, 50668, 74, 1.1043154000000044
75, 0, 0, 0, 0, 260.0, 759, 51427, 75, 1.570697999999993
76, 0, 0, 0, 0, 115.0, 526, 51953, 76, 1.104008499999992
77, 0, 0, 0, 0, 505.0, 1062, 53015, 77, 2.1304487999999964
78, 0, 0, 0, 0, 305.0, 682, 53697, 78, 1.40539840000001
79, 0, 0, 0, 0, 125.0, 581, 54278, 79, 1.2077323999999976
80, 0, 0, 0, 0, 75.0, 517, 54795, 80, 1.0763875000000098
81, 0, 0, 0, 0, 90.0, 610, 55405, 81, 1.2462653999999986
82, 0, 0, 0, 0, 65.0, 373, 55778, 82, 0.835616800000011
83, 0, 0, 0, 0, 180.0, 607, 56385, 83, 1.2675787999999955
84, 0, 0, 0, 0, 65.0, 391, 56776, 84, 0.8118939999999952
85, 0, 0, 0, 0, 125.0, 498, 57274, 85, 1.0248274999999865
86, 0, 0, 0, 0, 230.0, 998, 58272, 86, 2.0398581000000036
87, 0, 0, 0, 0, 155.0, 1036, 59308, 87, 2.1030912000000086
88, 0, 0, 0, 0, 210.0, 652, 59960, 88, 1.4127170999999805
89, 0, 0, 0, 0, 185.0, 909, 60869, 89, 1.8680115000000228
90, 0, 0, 0, 0, 60.0, 459, 61328, 90, 0.9511794000000009
91, 0, 0, 0, 0, 110.0, 543, 61871, 91, 1.128367400000002
92, 0, 0, 0, 0, 45.0, 640, 62511, 92, 1.3242963999999802
93, 0, 0, 0, 0, 185.0, 840, 63351, 93, 1.6860483000000102
94, 0, 0, 0, 0, 135.0, 531, 63882, 94, 1.1101550999999859
95, 0, 0, 0, 0, 185.0, 991, 64873, 95, 2.0876704000000075
96, 0, 0, 0, 0, 120.0, 511, 65384, 96, 1.0524528999999916
97, 0, 0, 0, 0, 75.0, 626, 66010, 97, 1.3151175000000137
98, 0, 0, 0, 0, 280.0, 969, 66979, 98, 1.9305530000000033
99, 0, 0, 0, 0, 45.0, 493, 67472, 99, 1.0345925000000022
100, 0, 0, 0, 0, 155.0, 498, 67970, 100, 1.0220140999999785
101, 0, 0, 0, 0, 135.0, 623, 68593, 101, 1.2851987999999892
102, 0, 0, 0, 0, 155.0, 666, 69259, 102, 1.376390299999997
103, 0, 0, 0, 0, 665.0, 1144, 70403, 103, 2.3383012999999835
104, 0, 0, 0, 0, 160.0, 801, 71204, 104, 1.6618636000000038
105, 0, 0, 0, 0, 50.0, 588, 71792, 105, 1.1902585999999928
106, 0, 0, 0, 0, 80.0, 568, 72360, 106, 1.1794553000000008
107, 0, 0, 0, 0, 105.0, 543, 72903, 107, 1.1921338999999875
108, 0, 0, 0, 0, 205.0, 856, 73759, 108, 1.8082517999999936
109, 0, 0, 0, 0, 135.0, 684, 74443, 109, 1.3699511000000086
110, 0, 0, 0, 0, 190.0, 820, 75263, 110, 1.6509180000000185
111, 0, 0, 0, 0, 100.0, 622, 75885, 111, 1.2533325999999931
112, 0, 0, 0, 0, 120.0, 604, 76489, 112, 1.2713462000000106
113, 0, 0, 0, 0, 20.0, 636, 77125, 113, 1.2438921000000107
114, 0, 0, 0, 0, 140.0, 640, 77765, 114, 1.3183621999999957
115, 0, 0, 0, 0, 85.0, 561, 78326, 115, 1.2213620000000276
116, 0, 0, 0, 0, 135.0, 491, 78817, 116, 1.0224268999999993
117, 0, 0, 0, 0, 135.0, 639, 79456, 117, 1.3308719999999994
118, 0, 0, 0, 0, 150.0, 581, 80037, 118, 1.205005199999988
119, 0, 0, 0, 0, 190.0, 636, 80673, 119, 1.3666810999999939
120, 0, 0, 0, 0, 235.0, 999, 81672, 120, 2.0953877999999975
121, 0, 0, 0, 0, 45.0, 488, 82160, 121, 1.0276350999999977
122, 0, 0, 0, 0, 155.0, 589, 82749, 122, 1.2253947000000096
123, 0, 0, 0, 0, 55.0, 438, 83187, 123, 0.9364905999999849
124, 0, 0, 0, 0, 95.0, 404, 83591, 124, 0.8317771000000107
125, 0, 0, 0, 0, 150.0, 641, 84232, 125, 1.3218128999999976
126, 0, 0, 0, 0, 125.0, 554, 84786, 126, 1.1330387000000144
127, 0, 0, 0, 0, 80.0, 454, 85240, 127, 1.0033639000000107
128, 0, 0, 0, 0, 80.0, 528, 85768, 128, 1.0833349000000112
129, 0, 0, 0, 0, 90.0, 377, 86145, 129, 0.7762639000000036
130, 0, 0, 0, 0, 105.0, 449, 86594, 130, 0.9272095000000036
131, 0, 0, 0, 0, 40.0, 546, 87140, 131, 1.1192585999999949
132, 0, 0, 0, 0, 445.0, 907, 88047, 132, 1.8224489999999776
133, 0, 0, 0, 0, 240.0, 734, 88781, 133, 1.4810946999999999
134, 0, 0, 0, 0, 80.0, 377, 89158, 134, 0.7779035999999735
135, 0, 0, 0, 0, 210.0, 939, 90097, 135, 1.887059999999991
136, 0, 0, 0, 0, 290.0, 956, 91053, 136, 1.898998199999994
137, 0, 0, 0, 0, 110.0, 517, 91570, 137, 1.0684537000000205
138, 0, 0, 0, 0, 205.0, 1046, 92616, 138, 2.133977999999985
139, 0, 0, 0, 0, 25.0, 395, 93011, 139, 0.8300246000000016
140, 0, 0, 0, 0, 115.0, 690, 93701, 140, 1.4133147000000008
141, 0, 0, 0, 0, 215.0, 812, 94513, 141, 1.6276541000000009
142, 0, 0, 0, 0, 70.0, 507, 95020, 142, 1.0467700000000093
143, 0, 0, 0, 0, 180.0, 533, 95553, 143, 1.0921974999999975
144, 0, 0, 0, 0, 150.0, 713, 96266, 144, 1.4454872999999964
145, 0, 0, 0, 0, 70.0, 583, 96849, 145, 1.1871744000000035
146, 0, 0, 0, 0, 100.0, 512, 97361, 146, 1.056909399999995
147, 0, 0, 0, 0, 195.0, 926, 98287, 147, 1.874303900000001
148, 0, 0, 0, 0, 45.0, 438, 98725, 148, 0.9254674999999963
149, 0, 0, 0, 0, 115.0, 593, 99318, 149, 1.2623589000000095
150, 0, 0, 0, 0, 120.0, 603, 99921, 150, 1.2436265000000049
151, 51.98908141285082, 50.63549524605076, 63.11436949061397, 0.9097286499999995, 210.0, 682, 100603, 151, 5.9379048000000125
152, 31.770889798093098, 50.740034354539105, 62.00788942746562, 0.9090783999999996, 170.0, 843, 101446, 152, 7.486182000000014
153, 27.587931001754033, 50.726616674756244, 61.94001167539566, 0.9084155499999998, 110.0, 630, 102076, 153, 5.614167199999997
154, 31.92836253950821, 50.687474171779975, 62.04162172820986, 0.9078985000000005, 125.0, 519, 102595, 154, 4.697186500000015
155, 25.604715065602903, 50.6501087612576, 61.76615067234746, 0.9074219500000001, 45.0, 540, 103135, 155, 4.874242199999998
156, 25.277727657713147, 50.54048229258801, 61.47466064052198, 0.9068877999999997, 180.0, 647, 103782, 156, 5.793742600000002
157, 24.810795972003273, 50.423324267069496, 61.143523662244505, 0.9062348499999996, 210.0, 804, 104586, 157, 7.252794499999993
158, 27.735505056381225, 50.579034747717515, 61.36158119057709, 0.9056345499999997, 75.0, 530, 105116, 158, 4.824540400000018
159, 24.119804064185587, 50.64140596285949, 61.27361688569397, 0.9051067000000003, 105.0, 643, 105759, 159, 5.829059000000029
160, 26.266901349926563, 50.53667157212972, 61.302952343616525, 0.9045910000000003, 90.0, 503, 106262, 160, 4.642137300000002
161, 22.705240710494444, 50.46617856959707, 61.21145496171774, 0.9041900499999996, 60.0, 388, 106650, 161, 3.527599500000008
162, 25.844429028406235, 50.47676391291004, 61.227923694750345, 0.9036837999999995, 135.0, 737, 107387, 162, 6.665820199999985
163, 24.300533705677477, 50.44418906584609, 61.03809119287481, 0.9029089000000008, 260.0, 985, 108372, 163, 8.89014370000001
164, 22.293270423615084, 50.333655371344335, 60.78218631240979, 0.9021587500000005, 60.0, 682, 109054, 164, 6.190091399999972
165, 24.256771098735722, 50.49169681361787, 61.160346452579944, 0.9015035499999999, 180.0, 774, 109828, 165, 7.11216079999997
166, 28.98055048965701, 52.50631586367872, 63.52361263162042, 0.9008213499999999, 155.0, 742, 110570, 166, 6.761843700000043
167, 21.939930335420076, 52.94393398722664, 63.88919475430348, 0.9002678500000001, 80.0, 488, 111058, 167, 4.447962700000005
168, 21.91664587240168, 52.91375979255228, 63.86530030092454, 0.8997116499999999, 120.0, 748, 111806, 168, 6.83367990000005
169, 22.81072100100874, 52.92154509356233, 63.98016776779071, 0.8990443000000002, 120.0, 735, 112541, 169, 6.782545400000004
170, 21.663903531678226, 52.940706804258014, 63.88718347811918, 0.8985173499999997, 65.0, 436, 112977, 170, 4.075873800000011
171, 21.307777406172654, 52.85398370426448, 63.88262191313661, 0.8978571999999995, 420.0, 1031, 114008, 171, 9.421550500000023
172, 21.427463068733356, 52.775625348531015, 63.74164496840586, 0.8971493499999997, 105.0, 542, 114550, 172, 5.010061500000006
173, 19.378253163660276, 52.77544428320492, 63.546748259488275, 0.8966606500000004, 30.0, 544, 115094, 173, 5.001485599999967
174, 14.867947629597634, 52.750406239130726, 63.55525188358951, 0.8962187500000002, 15.0, 438, 115532, 174, 4.07527680000004
175, 21.17845642066029, 52.77096088682212, 63.64090274546663, 0.8956251999999996, 235.0, 881, 116413, 175, 8.241536999999994
176, 14.960541889197593, 52.67839216811193, 63.51479575308231, 0.8948565999999996, 180.0, 827, 117240, 176, 7.899023100000022
177, 18.212285693277394, 52.78672045992132, 63.5898316533942, 0.8942792499999996, 20.0, 456, 117696, 177, 4.390725999999972
178, 19.211738154387994, 52.778603945306216, 63.644557005343444, 0.8937244000000005, 210.0, 777, 118473, 178, 7.516253000000006
179, 16.694529193065545, 52.71294998313873, 63.493817188361284, 0.8930430999999999, 90.0, 737, 119210, 179, 7.1341137
180, 15.885440930819057, 52.54381349284178, 63.297476434403926, 0.89242885, 155.0, 628, 119838, 180, 6.055134099999975
181, 15.902281024726346, 52.893628148672164, 63.92581766301935, 0.8917057000000008, 135.0, 979, 120817, 181, 9.473586700000055
182, 13.768275242609693, 52.956461344333675, 64.06725039955796, 0.8909254000000005, 145.0, 755, 121572, 182, 7.295315499999958
183, 14.38441282946889, 52.95354626353194, 64.02342407412645, 0.8904011500000001, 30.0, 410, 121982, 183, 3.978208699999982
184, 15.088757856132974, 52.857188684672415, 64.12340928751917, 0.8899002999999994, 180.0, 703, 122685, 184, 6.9082074000000375
185, 13.230366714702344, 52.86900072391002, 63.9580109067054, 0.8889692500000003, 420.0, 1366, 124051, 185, 13.157087400000023
186, 14.881327526262629, 52.77868158217759, 63.989446065579244, 0.8880467500000006, 75.0, 684, 124735, 186, 6.728175099999987
187, 15.828115891446085, 52.81648160897049, 63.931480823778635, 0.8873717499999998, 355.0, 816, 125551, 187, 7.983024099999966
188, 12.260078069158075, 52.727462220154294, 63.78302940260178, 0.8867197000000003, 135.0, 633, 126184, 188, 6.230199700000014
189, 13.957777880161647, 52.57941179690154, 63.617047298567094, 0.88620715, 15.0, 506, 126690, 189, 4.982336499999974
190, 13.321895851987474, 52.68669796666355, 63.733212962049116, 0.8856621999999998, 185.0, 705, 127395, 190, 6.912283300000013
191, 14.275913374633378, 52.8476093333381, 63.894543158438616, 0.8850529, 125.0, 649, 128044, 191, 6.391727800000012
192, 12.0335836043421, 52.719965625282946, 63.77379310052127, 0.8844890499999996, 75.0, 604, 128648, 192, 6.001954000000012
193, 12.542695167037726, 52.78657363094179, 63.814990749466894, 0.8838986500000001, 105.0, 708, 129356, 193, 7.031225800000016
194, 12.868317189095896, 52.8260199470359, 63.97730099534519, 0.8832601000000002, 155.0, 711, 130067, 194, 7.01252820000002
195, 15.292836481403457, 54.30768783478869, 65.63386509258285, 0.8827124500000001, 40.0, 506, 130573, 195, 5.066432799999973
196, 10.90997948400753, 54.36690373371557, 65.64574927103888, 0.8822665, 65.0, 485, 131058, 196, 4.838538500000027
197, 16.058480801745358, 54.41749950963208, 65.7570383935912, 0.8818376499999998, 80.0, 468, 131526, 197, 4.6840554999999995
198, 13.71838315588802, 54.34463866995699, 65.5991230703599, 0.8813048499999994, 210.0, 716, 132242, 198, 7.087464100000034
199, 11.910967306148283, 54.30422225623681, 65.47717067920065, 0.8807527000000002, 80.0, 511, 132753, 199, 5.112083499999926
200, 15.184885753475072, 54.50918657725094, 65.88946149549412, 0.8802869499999997, 100.0, 524, 133277, 200, 5.299883700000009
201, 13.959630419665237, 54.51142426157385, 65.86329430991071, 0.8794976500000007, 355.0, 1230, 134507, 201, 12.311094000000026
202, 11.653819293325597, 54.56263216192072, 66.0261648756085, 0.8786471499999994, 125.0, 660, 135167, 202, 6.562789599999974
203, 11.597384522358576, 54.652508749890686, 66.034418998073, 0.8779883499999999, 135.0, 804, 135971, 203, 8.019094300000006
204, 12.413760785218123, 54.52344651274629, 65.86242116385473, 0.877258, 410.0, 819, 136790, 204, 8.28066590000003
205, 12.707808705532189, 54.38576831239642, 65.65007637871636, 0.8766667, 80.0, 495, 137285, 205, 5.018225700000016
206, 13.738752759993076, 54.54286439665432, 65.97996537438755, 0.8762351499999997, 35.0, 464, 137749, 206, 4.670896799999923
207, 9.722833075385163, 54.46768776871897, 65.7002200172061, 0.8758089999999998, 65.0, 483, 138232, 207, 4.97681179999995
208, 11.769317118878405, 54.51408314367192, 65.78940065724316, 0.8752739499999997, 165.0, 706, 138938, 208, 7.0448635000000195
209, 13.028269142915423, 54.53790105764683, 65.92865925110303, 0.8745818500000002, 240.0, 832, 139770, 209, 8.384233400000085
210, 9.997468609280057, 54.19745636516147, 65.4007387108273, 0.8738834500000002, 105.0, 720, 140490, 210, 7.233478300000002
211, 7.789941255210781, 54.1328065318446, 65.2019403183565, 0.8732525499999997, 135.0, 682, 141172, 211, 6.930458000000044
212, 6.155996658628987, 54.13801819585985, 65.14410143206196, 0.8726666500000005, 80.0, 620, 141792, 212, 6.344495499999994
213, 10.118498936704055, 54.206225077311196, 65.29305982383299, 0.8720758000000003, 90.0, 693, 142485, 213, 7.129713899999956
214, 11.096528404997784, 54.17946725352315, 65.37932544837733, 0.8715915999999999, 55.0, 383, 142868, 214, 3.932633399999986
215, 6.650569699588835, 54.15921193453932, 65.18792261607906, 0.8710718500000003, 135.0, 772, 143640, 215, 7.828378599999951
216, 7.894231391113077, 54.16357037845074, 65.22204130543959, 0.8703891999999996, 180.0, 745, 144385, 216, 7.6228892000000315
217, 7.761378249578309, 54.08263133236772, 65.17244250500178, 0.8698231000000003, 135.0, 513, 144898, 217, 5.309570399999984
218, 8.459617017399855, 54.13022302764227, 65.21732499072114, 0.8693033500000001, 125.0, 642, 145540, 218, 6.598609900000042
219, 7.148903259423774, 54.24541139978123, 65.30239030132144, 0.8687286999999998, 210.0, 635, 146175, 219, 6.539821699999948
220, 9.181555160580066, 54.134914198497796, 65.22617149609047, 0.8681077, 180.0, 745, 146920, 220, 7.677488500000095
221, 9.898017736894, 54.12315467697183, 65.21510084000222, 0.8674223499999995, 230.0, 778, 147698, 221, 7.994295899999997
222, 7.903321784339909, 54.012853724324806, 65.0670129906418, 0.8666510500000001, 230.0, 936, 148634, 222, 9.665438699999982
223, 10.098326072915025, 54.02653519286094, 65.13833976148965, 0.8659593999999996, 130.0, 601, 149235, 223, 6.264046199999939
224, 9.174506162304477, 53.979122291635235, 64.99902962320328, 0.8650540000000002, 240.0, 1411, 150646, 224, 14.554972299999918
225, 7.7400955515711205, 53.89677856970525, 64.93651578737342, 0.8641706500000004, 105.0, 552, 151198, 225, 5.747339399999987
226, 8.580564970864314, 53.841065995047025, 64.92846276381306, 0.8635370500000007, 205.0, 856, 152054, 226, 8.908174200000076
227, 6.400842388112521, 53.91645788409046, 64.9053342170322, 0.8629772500000003, 80.0, 388, 152442, 227, 4.072026700000038
228, 7.8173155446075695, 53.9432712073465, 64.97856670490746, 0.8625709, 30.0, 515, 152957, 228, 5.482305099999962
229, 7.857460638667856, 53.95707043239049, 64.92638712610517, 0.8620871499999999, 80.0, 560, 153517, 229, 5.910488500000042
230, 9.511061432991559, 53.91418177801197, 64.96736865519874, 0.8614791999999997, 155.0, 791, 154308, 230, 8.309436699999992
231, 11.064793751917808, 53.83981379257259, 64.98610739725673, 0.8608811499999999, 155.0, 538, 154846, 231, 5.657728600000041
232, 8.269029148075612, 53.83802213615545, 64.81043546737017, 0.8603973999999996, 105.0, 537, 155383, 232, 5.651817000000051
233, 7.478098251913261, 53.75778228210349, 64.70560472179356, 0.8598808000000001, 135.0, 611, 155994, 233, 6.4674539000000095
234, 8.02775446815848, 53.85762810092899, 64.81033383264474, 0.8592215499999997, 130.0, 854, 156848, 234, 8.986280299999976
235, 7.956922554788775, 53.85095597968443, 64.8921705399056, 0.8586298000000002, 155.0, 461, 157309, 235, 4.907845100000031
236, 6.295414917658915, 53.8192769345984, 64.75967820429169, 0.8581681000000002, 85.0, 565, 157874, 236, 6.027372000000014
237, 9.576715274600526, 53.90001777705231, 64.94793760996463, 0.8576699499999995, 75.0, 542, 158416, 237, 5.768306100000018
238, 7.90842802271269, 53.91984120520582, 64.96298556731679, 0.8571232000000004, 105.0, 673, 159089, 238, 7.14268590000006
239, 9.62092352204942, 53.77783281606124, 64.83006962073392, 0.8565534999999999, 110.0, 593, 159682, 239, 6.323837700000013
240, 4.9319269992516075, 53.82613860654159, 64.75886902607662, 0.8559671499999998, 110.0, 710, 160392, 240, 7.614177100000006
241, 9.35167503476143, 53.91873438517253, 64.98825906880697, 0.8553101500000007, 155.0, 750, 161142, 241, 8.01404709999997
242, 8.493923529627777, 53.844654522244895, 64.91756413474916, 0.8547458499999997, 80.0, 504, 161646, 242, 5.430056499999978
243, 6.987270556509421, 53.92240869632359, 64.92009532876854, 0.8541532000000002, 140.0, 813, 162459, 243, 8.717851199999927
244, 8.646723706574335, 53.9473911758757, 65.03587049869435, 0.8536023999999998, 80.0, 411, 162870, 244, 4.414289300000064
245, 8.511593820342096, 53.913948287062546, 64.9323524835625, 0.8527698999999993, 595.0, 1439, 164309, 245, 15.419278500000019
246, 6.541456503630647, 53.8998759386517, 64.8868108392564, 0.8514536500000005, 440.0, 1486, 165795, 246, 15.926315999999929
247, 7.3395278078993575, 53.90613277671263, 64.90267292494626, 0.8506103499999997, 55.0, 388, 166183, 247, 4.233589499999994
248, 7.173769581069549, 53.86540222167969, 64.86566963990529, 0.8502197500000003, 50.0, 480, 166663, 248, 5.260224999999991
249, 9.674036506855606, 53.97311847817664, 65.09140483070823, 0.8496365500000006, 410.0, 816, 167479, 249, 8.771140400000036
250, 7.186175924138863, 53.966350340889434, 64.96603435474438, 0.8485732000000002, 600.0, 1547, 169026, 250, 16.5821641
251, 6.459495542194113, 54.05377345002456, 65.06564336199752, 0.8476434999999997, 135.0, 519, 169545, 251, 5.70037329999991
252, 6.200772760242007, 54.19230529932941, 65.26009857048423, 0.8470382499999998, 225.0, 826, 170371, 252, 9.024650299999962
253, 5.7297198952963715, 54.537408737035896, 65.65365011875446, 0.8463857499999995, 180.0, 624, 170995, 253, 6.865270399999986
254, 5.4711748101096465, 54.516639509301136, 65.57855901761033, 0.8458048000000001, 135.0, 667, 171662, 254, 7.386652799999979
255, 7.218831250625776, 54.46659107906063, 65.64782270571081, 0.8452094499999997, 125.0, 656, 172318, 255, 7.242490800000041
256, 7.538311281486561, 54.30411126990067, 65.5234254435489, 0.84474325, 85.0, 380, 172698, 256, 4.230062699999962
257, 10.332818008547452, 54.467739641965935, 65.68913427189966, 0.84439315, 65.0, 398, 173096, 257, 4.366781400000036
258, 7.6943959157941935, 54.38295558699988, 65.4744097845895, 0.8439746499999999, 105.0, 532, 173628, 258, 5.889223399999992
259, 6.118052167787078, 54.40524508017862, 65.49248383453538, 0.8434094499999999, 85.0, 724, 174352, 259, 8.012422300000026
260, 9.003370056633793, 54.35090430558377, 65.51004328606639, 0.8427115000000001, 215.0, 827, 175179, 260, 9.11016959999995
261, 5.663307898377243, 54.37511446281006, 65.4856949782953, 0.8420256999999994, 165.0, 697, 175876, 261, 7.752365499999996
262, 5.229624516135309, 54.42009279204578, 65.45699452345933, 0.8414352999999999, 155.0, 615, 176491, 262, 6.817286099999933
263, 5.746737650205359, 54.245018544724175, 65.30714428761931, 0.8408084499999999, 180.0, 778, 177269, 263, 8.716879800000015
264, 5.880420669938086, 54.33628416140742, 65.40976149547913, 0.8401879000000003, 135.0, 601, 177870, 264, 6.751193599999965
265, 7.712462458337284, 54.28124519559538, 65.28987946017864, 0.8397388000000001, 80.0, 397, 178267, 265, 4.4683688000000075
266, 9.053967232677838, 54.390222828220246, 65.53835968916098, 0.8391321999999991, 210.0, 951, 179218, 266, 10.594773299999929
267, 5.315341911842705, 54.22336925587184, 65.23473007578245, 0.8384486500000001, 90.0, 568, 179786, 267, 6.397857899999963
268, 6.743996738888961, 53.94572598340343, 65.02149491150583, 0.8379509499999995, 80.0, 538, 180324, 268, 6.095871400000078
269, 6.2835543895921395, 53.75727110252887, 64.77125101976196, 0.8374717000000003, 90.0, 527, 180851, 269, 5.960874899999908
270, 7.6644348714508315, 53.71874261343014, 64.7130970181381, 0.8367962499999998, 230.0, 974, 181825, 270, 11.028722099999868
271, 6.292560034247387, 53.869878129494566, 64.85312051417834, 0.8360438500000001, 135.0, 698, 182523, 271, 7.9062507000001006
272, 5.934228419158303, 53.79556230638848, 64.75986950514746, 0.83551015, 75.0, 488, 183011, 272, 5.5283922000000985
273, 7.319964834302664, 53.778400999307635, 64.82560039758683, 0.8350025499999998, 110.0, 640, 183651, 273, 7.2392110000000685
274, 7.416497940591347, 53.79203180574755, 64.7864106711052, 0.8340355000000002, 335.0, 1509, 185160, 274, 16.962121400000115
275, 7.608916894947771, 53.83583750001869, 64.84932531149427, 0.8330625999999999, 130.0, 653, 185813, 275, 7.434933499999943
276, 5.635963136381342, 53.77977940090874, 64.71591550869834, 0.8324078500000002, 190.0, 802, 186615, 276, 9.093822499999987
277, 6.639883555674105, 53.80952000468658, 64.82147132777969, 0.8316158500000002, 155.0, 958, 187573, 277, 10.87391649999995
278, 6.217229699113487, 53.67395025182653, 64.57918402589398, 0.8308202499999995, 180.0, 810, 188383, 278, 9.255499900000132
279, 5.455829810192757, 53.78010764976967, 64.72256431650102, 0.8302123, 105.0, 541, 188924, 279, 6.180012899999838
280, 5.381343552125298, 53.68204140964943, 64.59679679801624, 0.8297199999999997, 100.0, 553, 189477, 280, 6.341046200000164
281, 7.226257876146699, 54.16809361394519, 65.24584539169759, 0.8288407000000005, 210.0, 1401, 190878, 281, 15.946066700000074
282, 5.454889143129875, 54.37803733211824, 65.38461056413321, 0.8280144999999999, 125.0, 435, 191313, 282, 5.02301680000005
283, 7.876785901011731, 54.524994349910926, 65.69293671245723, 0.8276446000000001, 60.0, 387, 191700, 283, 4.505965399999923
284, 8.274237108713514, 54.45047273117218, 65.59723520226008, 0.8270650000000006, 265.0, 901, 192601, 284, 10.301533600000084
285, 5.805633354137479, 54.353988245913854, 65.51706358468434, 0.8264971000000002, 30.0, 361, 192962, 285, 4.197236799999928
286, 7.204963279116636, 54.62297976137412, 65.69180386475843, 0.8261564499999998, 75.0, 396, 193358, 286, 4.647142099999883
287, 7.20013997130096, 54.39044035434723, 65.52127142429352, 0.8256182499999999, 130.0, 800, 194158, 287, 9.1526073
288, 5.960848990961527, 54.331789843241374, 65.38905368707118, 0.82490725, 180.0, 780, 194938, 288, 9.043202299999848
289, 5.465381081779627, 54.33895386135118, 65.38966088574672, 0.8242417000000002, 140.0, 699, 195637, 289, 8.111456500000031
290, 4.863500856442057, 54.319461788493356, 65.34955665928543, 0.8235739000000003, 150.0, 785, 196422, 290, 9.131568300000026
291, 6.174126419026929, 54.392571294350745, 65.49436337394117, 0.8228467, 165.0, 831, 197253, 291, 9.716644899999892
292, 8.405609745039714, 54.471478409577394, 65.66894541533523, 0.8221221999999997, 140.0, 779, 198032, 292, 9.067998400000079
293, 7.821274218055937, 54.29742381456163, 65.35200814141167, 0.8212654000000007, 390.0, 1125, 199157, 293, 13.180097599999954
294, 6.230255307136071, 54.478975567857006, 65.54618108904404, 0.8203771000000002, 210.0, 849, 200006, 294, 9.959343399999852
295, 6.2670139266334415, 54.95870084107377, 66.22456072741792, 0.8197002999999995, 135.0, 655, 200661, 295, 7.74184020000007
296, 5.22286961620485, 54.95998553460318, 66.2100145187432, 0.8187697, 305.0, 1413, 202074, 296, 16.60399529999995
297, 4.984509853227485, 55.0796562253226, 66.24285359339491, 0.8174872000000004, 210.0, 1437, 203511, 297, 16.881530800000064
298, 5.090266947384475, 55.02701032022558, 66.17250179780596, 0.8166092499999998, 15.0, 514, 204025, 298, 6.166005900000073
299, 6.540586833909307, 55.04389753538309, 66.28538875973102, 0.8160287500000005, 155.0, 776, 204801, 299, 9.24809839999989
300, 6.304063843491742, 54.86182956744338, 66.05140364078609, 0.8155035999999999, 75.0, 391, 205192, 300, 4.684486900000138
301, 4.938304389117497, 55.116899437521305, 66.35908643030393, 0.8150027500000004, 210.0, 722, 205914, 301, 8.585375999999997
302, 4.5564980910811235, 55.087613856836114, 66.30230186099098, 0.81443215, 75.0, 546, 206460, 302, 6.581932899999856
303, 6.219618617220128, 55.012292061895586, 66.23571103104705, 0.8138903499999995, 155.0, 658, 207118, 303, 7.838061499999867
304, 6.70739985757566, 55.09281083753893, 66.2878727412724, 0.8133368500000001, 50.0, 572, 207690, 304, 6.8752049999998235
305, 5.5081740909296535, 55.10071848228225, 66.2839010317323, 0.8126758000000002, 230.0, 897, 208587, 305, 10.85134650000009
306, 7.200991055576139, 54.97799051093143, 66.21395287217136, 0.8118959500000001, 190.0, 836, 209423, 306, 10.077748800000109
307, 6.014339689006831, 55.10267113624735, 66.30641751593731, 0.8113505499999997, 50.0, 376, 209799, 307, 4.587658799999872
308, 3.7637216823203916, 55.17009654747048, 66.38339738797416, 0.81100405, 80.0, 394, 210193, 308, 4.754678799999965
309, 6.2823726954200705, 55.329430599820995, 66.66384453979263, 0.8105868999999999, 105.0, 533, 210726, 309, 6.459190000000035
310, 6.994967431752455, 55.2842044164264, 66.54039445301844, 0.8100635499999999, 155.0, 630, 211356, 310, 7.617133299999978
311, 7.463380911956133, 55.35392557276357, 66.70855476203138, 0.8095073500000004, 80.0, 606, 211962, 311, 7.3274087000002055
312, 4.790829382504378, 55.257739840530036, 66.50404765411938, 0.8090632000000002, 20.0, 381, 212343, 312, 4.675408799999786
313, 4.576775365813965, 55.136061347653516, 66.31375186218808, 0.80869105, 75.0, 446, 212789, 313, 5.35447750000003
314, 7.10970191859521, 55.25548657964191, 66.53440808481514, 0.8080155999999992, 300.0, 1055, 213844, 314, 12.816468799999939
315, 6.476299859747127, 55.103154409499396, 66.28859865796436, 0.80729515, 105.0, 546, 214390, 315, 6.740295600000081
316, 6.642618154844691, 55.206076629660934, 66.4144510732438, 0.8064325000000006, 410.0, 1371, 215761, 316, 16.589851199999885
317, 5.769078858354778, 55.322481230533484, 66.59388773369066, 0.8055185499999995, 105.0, 660, 216421, 317, 8.090904899999941
318, 4.27376102940195, 55.29513018426289, 66.5493672986493, 0.8049524500000002, 20.0, 598, 217019, 318, 7.330245899999909
319, 5.827237623876071, 55.231392325664984, 66.48974780395666, 0.80433505, 135.0, 774, 217793, 319, 9.533121000000165
320, 8.89633777796245, 55.3224458788262, 66.68256244346743, 0.8037122500000003, 110.0, 610, 218403, 320, 7.525924900000064
321, 4.818708760899911, 55.170974607000986, 66.36164477837728, 0.8030790999999998, 155.0, 797, 219200, 321, 9.860138600000028
322, 6.1256976234149345, 55.10418464723698, 66.39626704759834, 0.8025026500000001, 85.0, 484, 219684, 322, 5.979313099999899
323, 6.463719839715597, 55.11029730132132, 66.36589382634018, 0.8019878500000001, 75.0, 660, 220344, 323, 8.193548100000044
324, 5.4030650195976095, 54.910100026564166, 66.08918833491778, 0.8013344499999998, 335.0, 792, 221136, 324, 9.891922600000044
325, 4.502711441182353, 54.879937614759235, 65.99922313151096, 0.8006437000000001, 110.0, 743, 221879, 325, 9.266771400000152
326, 5.80868213731824, 54.90888479829744, 66.09544966603053, 0.8000735499999997, 90.0, 524, 222403, 326, 6.576599299999998
327, 5.497393238994715, 54.95243849628549, 66.15891503715973, 0.7994624499999999, 125.0, 834, 223237, 327, 10.445803000000069
328, 4.4546218386491745, 54.84757791536557, 65.96354005691853, 0.7987910499999998, 120.0, 658, 223895, 328, 8.186292600000115
329, 4.1986655607747805, 54.93917188445408, 66.10561433305327, 0.7982146000000006, 120.0, 623, 224518, 329, 7.856703500000094
330, 6.7612505907107465, 54.90301631116139, 66.10183126805953, 0.7975513000000001, 185.0, 851, 225369, 330, 10.639814099999967
331, 6.840929377371748, 55.03501731279277, 66.28315084335098, 0.7968384999999998, 105.0, 733, 226102, 331, 9.247593800000004
332, 9.772405875062942, 54.9644813293457, 66.20903905639648, 0.7962274, 70.0, 625, 226727, 332, 7.895706400000108
333, 6.902828033985217, 54.861882274965694, 66.06299152132831, 0.7955906499999998, 210.0, 790, 227517, 333, 9.901601600000049
334, 8.019857915253166, 54.84440031895369, 66.11770361933567, 0.7948994500000002, 155.0, 746, 228263, 334, 9.359246499999927
335, 5.308342116112395, 54.95404496303824, 66.1205980907115, 0.7943315499999998, 90.0, 516, 228779, 335, 6.549714600000016
336, 5.9481429721612935, 54.77289840980067, 65.88973903739883, 0.7935877000000001, 310.0, 1137, 229916, 336, 14.48255539999991
337, 3.9433787709816173, 55.85567121543432, 67.15653063657255, 0.7928483499999998, 90.0, 506, 230422, 337, 6.401107800000091
338, 6.8115342318857275, 56.10578793935825, 67.54878012174564, 0.7923601000000001, 50.0, 579, 231001, 338, 7.372968800000081
339, 4.138079436404294, 55.99304517370756, 67.41727555384401, 0.7918799499999999, 75.0, 488, 231489, 339, 6.273851700000023
340, 5.557060813266924, 55.94337755859773, 67.4015660371516, 0.7913844999999996, 135.0, 613, 232102, 340, 7.8677974000002
341, 5.766853474236869, 55.98727748073527, 67.39742331812339, 0.7905295000000009, 615.0, 1287, 233389, 341, 16.360399500000085
342, 5.277375295568558, 56.047051145130034, 67.46029176401788, 0.7896322000000003, 155.0, 707, 234096, 342, 9.11362250000002
343, 5.5224593888856415, 55.96034014130844, 67.3271612194477, 0.7890291999999999, 120.0, 633, 234729, 343, 8.119339999999966
344, 6.31958654220216, 56.04458123445511, 67.4751491367817, 0.78845635, 90.0, 640, 235369, 344, 8.254044199999953
345, 7.964069795327212, 55.92855735288273, 67.39965866234984, 0.7878394000000003, 160.0, 731, 236100, 345, 9.373968399999967
346, 5.672592307051903, 55.81588053401512, 67.14939832687378, 0.7872260499999998, 105.0, 632, 236732, 346, 8.16793860000007
347, 10.663969723478196, 55.8888981713189, 67.44270100669256, 0.7866581500000002, 65.0, 630, 237362, 347, 8.198280000000068
348, 5.993996611217887, 56.01432200750762, 67.40832865179273, 0.7861014999999997, 55.0, 607, 237969, 348, 7.821612500000128
349, 5.932324910453712, 55.95919924810623, 67.35813173128737, 0.7854026499999996, 225.0, 946, 238915, 349, 12.318870399999923
350, 5.091648721870031, 55.90141025021919, 67.24793065096684, 0.7846246, 155.0, 783, 239698, 350, 10.15522440000018
351, 4.079696626410264, 55.78835908371527, 67.08592360894554, 0.7839509500000003, 120.0, 714, 240412, 351, 9.359442800000124
352, 6.788345620072469, 55.87440299057379, 67.28915370848121, 0.78344515, 80.0, 410, 240822, 352, 5.36800089999997
353, 6.431239288046582, 55.84565504819262, 67.26305082451059, 0.7827584499999991, 515.0, 1116, 241938, 353, 14.551813500000208
354, 7.352164393688521, 55.88857744516951, 67.3486211380262, 0.78193585, 135.0, 712, 242650, 354, 9.274076900000182
355, 8.526393971099376, 55.900718425882275, 67.32660458005708, 0.7813283500000003, 130.0, 638, 243288, 355, 8.369046600000047
356, 4.970071561666353, 55.88697538693474, 67.25291193335816, 0.7805142999999998, 420.0, 1171, 244459, 356, 15.333980399999973
357, 5.436007330636183, 55.981104985555014, 67.34859162902832, 0.77964985, 140.0, 750, 245209, 357, 9.911434899999904
358, 4.153696002583576, 55.92256514894895, 67.26326112548134, 0.7790751999999999, 65.0, 527, 245736, 358, 6.970746799999915
359, 5.521400024719825, 55.90489522199696, 67.31422499480715, 0.7784429500000005, 210.0, 878, 246614, 359, 11.6015582
360, 6.41091278785622, 55.79452131940173, 67.13450161203161, 0.7777706499999999, 75.0, 616, 247230, 360, 8.177048400000103
361, 6.8794870707273486, 55.89080856933594, 67.32722240600586, 0.7772121999999999, 110.0, 625, 247855, 361, 8.31756089999999
362, 4.904880055404211, 55.76095881662708, 67.12415272363953, 0.7766528500000003, 105.0, 618, 248473, 362, 8.2705504999999
363, 9.771334498377204, 56.003717608858295, 67.57833284152025, 0.7761582999999996, 105.0, 481, 248954, 363, 6.3964608999999655
364, 6.673852718546746, 55.93072176442563, 67.33291681530406, 0.7756637500000003, 100.0, 618, 249572, 364, 8.262342899999794
365, 6.771618892743601, 55.45785010993148, 66.72017248143031, 0.7749828999999999, 205.0, 895, 250467, 365, 11.941905099999985
366, 6.38553012503616, 55.415810531206866, 66.68504148583848, 0.7740936999999994, 220.0, 1081, 251548, 366, 14.477293199999849
367, 5.062788101997393, 55.42253349788153, 66.67810435081596, 0.7733660499999997, 50.0, 536, 252084, 367, 7.200309300000072
368, 7.817322438055947, 55.424160563452006, 66.79152278110121, 0.7727446000000004, 170.0, 845, 252929, 368, 11.489520599999878
369, 6.729254104341697, 55.40525534546491, 66.71009389636586, 0.77217895, 80.0, 412, 253341, 369, 5.557763500000192
370, 5.386993943476492, 55.348453359243834, 66.6148840063193, 0.7715286999999993, 335.0, 1033, 254374, 370, 13.947237200000018
371, 4.146603502419464, 55.32796061453212, 66.51983272154818, 0.77083075, 135.0, 518, 254892, 371, 6.980566400000043
372, 4.905572439277129, 55.202458811330274, 66.44310636695052, 0.7699834000000001, 210.0, 1365, 256257, 372, 18.420262200000025
373, 6.096340342290143, 55.39548468045448, 66.64465687372913, 0.7690734999999995, 135.0, 657, 256914, 373, 8.897174300000188
374, 7.266394344937967, 55.423713524820315, 66.74575248248061, 0.7685515000000002, 35.0, 503, 257417, 374, 6.879257000000052
375, 4.548996839743607, 55.404881280474555, 66.62993323718914, 0.7678783000000006, 155.0, 993, 258410, 375, 13.473977000000104
376, 4.884244097336646, 55.440778137535176, 66.71595736131019, 0.7671803500000002, 90.0, 558, 258968, 376, 7.651575599999887
377, 5.351386729051482, 55.37341490691563, 66.60263073759259, 0.76669075, 60.0, 530, 259498, 377, 7.234507800000074
378, 7.2764146197127335, 56.00942518681656, 67.49062541679099, 0.7661606499999996, 105.0, 648, 260146, 378, 8.893942100000004
379, 5.325786209795979, 58.263616618085365, 70.14562741681236, 0.7653497500000006, 230.0, 1154, 261300, 379, 15.807495700000118
380, 7.984020776027127, 58.37762078736958, 70.36269890634637, 0.7646594499999999, 65.0, 380, 261680, 380, 5.245186400000193
381, 4.148178409628963, 58.22602013898894, 70.0165220166816, 0.7642414000000001, 30.0, 549, 262229, 381, 7.623467099999971
382, 7.147234246588736, 58.40672153896756, 70.35662370086997, 0.76374325, 155.0, 558, 262787, 382, 7.75457090000009
383, 7.3992079187151605, 58.16223720955638, 70.01701808186759, 0.76328875, 60.0, 452, 263239, 383, 6.248599000000013
384, 6.821081513199976, 58.253697042840955, 70.12705204231878, 0.7628455000000001, 100.0, 533, 263772, 384, 7.380783899999642
385, 8.800296841973537, 58.30927892107712, 70.3141094257957, 0.7623320499999998, 115.0, 608, 264380, 385, 8.44176940000034
386, 4.4149245619773865, 58.170793856954745, 69.88931438294559, 0.76180915, 125.0, 554, 264934, 386, 7.688544599999659
387, 5.712126312311739, 58.198913760044995, 70.02027795244666, 0.76107025, 270.0, 1088, 266022, 387, 15.000234099999943
388, 7.75211136300761, 58.26931284663074, 70.14997661083862, 0.7604011, 105.0, 399, 266421, 388, 5.594660799999929
389, 5.2003786559554115, 58.19826655331337, 70.02652727913636, 0.7598799999999999, 380.0, 759, 267180, 389, 10.624888199999987
390, 5.4619239107745745, 58.324687788847186, 70.14170168305382, 0.7591725999999999, 180.0, 813, 267993, 390, 11.36584700000003
391, 6.305175957821925, 58.108019326586245, 69.94673855282845, 0.7585615, 80.0, 545, 268538, 391, 7.69868120000001
392, 5.752699283144122, 58.14657146587995, 69.9932182472036, 0.7575867999999996, 245.0, 1621, 270159, 392, 22.559070099999644
393, 5.034149233938877, 57.5736230633989, 69.27917963921922, 0.7565913999999997, 125.0, 591, 270750, 393, 8.257127099999707
394, 8.866458067395648, 57.744190309868486, 69.57482234246092, 0.7559960500000005, 120.0, 732, 271482, 394, 10.363911100000223
395, 6.5221481075601115, 57.70605686810775, 69.3918085289548, 0.7553525500000001, 135.0, 698, 272180, 395, 9.819663400000081
396, 5.322348088905542, 57.76275138790652, 69.48568618800145, 0.7547716, 95.0, 593, 272773, 396, 8.413232200000039
397, 4.680341384294881, 57.80544223207416, 69.50726616477662, 0.7542226000000001, 55.0, 627, 273400, 397, 8.845357599999716
398, 4.949707182111411, 57.71644537695523, 69.44548696320632, 0.7536794499999997, 55.0, 580, 273980, 398, 8.231883999999809
399, 4.218330824380014, 57.716334991703995, 69.43578499798673, 0.7531426000000003, 80.0, 613, 274593, 399, 8.68832139999995
400, 3.638378624813725, 57.75622571116746, 69.49949665262241, 0.7526885500000001, 35.0, 396, 274989, 400, 5.655871400000251
401, 4.889894650015526, 57.81520718803452, 69.49580478553173, 0.7521372999999993, 190.0, 829, 275818, 401, 11.835338200000024
402, 5.995027095715017, 57.75357833669461, 69.55343338060906, 0.7514794000000001, 120.0, 633, 276451, 402, 9.059775799999898
403, 10.652214954252498, 57.992879124155024, 69.94629153483163, 0.7509925, 105.0, 449, 276900, 403, 6.493094299999939
404, 4.234571616441559, 57.68587877368677, 69.38738545094888, 0.7504475500000004, 165.0, 762, 277662, 404, 10.843984699999965
405, 9.259925427111062, 57.79854533335826, 69.6119666915756, 0.7499548000000001, 20.0, 333, 277995, 405, 4.806168900000102
406, 7.897580326789111, 57.82057057496221, 69.69049177807882, 0.7495560999999997, 55.0, 553, 278548, 406, 7.92896249999967
407, 6.633205188880403, 57.60697343284518, 69.31011843403026, 0.7490759500000002, 45.0, 514, 279062, 407, 7.3574649000001955
408, 5.5885952116306905, 57.728784040390345, 69.41817837304606, 0.7485760000000001, 80.0, 597, 279659, 408, 8.59148419999974
409, 5.120312408162997, 57.43272409879244, 69.08280796931341, 0.7480148499999996, 180.0, 650, 280309, 409, 9.35972240000001
410, 5.106111908055815, 57.05780201440253, 68.58382824784151, 0.7474730500000001, 55.0, 554, 280863, 410, 8.008219400000144
411, 7.071865722991771, 57.014054786431394, 68.68777224043725, 0.7470320500000001, 70.0, 426, 281289, 411, 6.1802998000002844
412, 5.143836631559844, 57.10142139772976, 68.708612925528, 0.7465509999999996, 90.0, 643, 281932, 412, 9.266032900000027
413, 4.589526346637582, 57.15371875373685, 68.75682076629327, 0.7460852499999998, 10.0, 392, 282324, 413, 5.680251399999634
414, 5.091804432397484, 57.12400868253888, 68.72993438233485, 0.7455987999999999, 100.0, 689, 283013, 414, 9.995191800000157
415, 4.04307377638278, 57.061940024880805, 68.60698055113801, 0.74499805, 155.0, 646, 283659, 415, 9.391224100000272
416, 10.01380506038347, 57.39301987510314, 69.16006180054363, 0.74453905, 45.0, 374, 284033, 416, 5.547702400000162
417, 6.989064341104122, 57.1834198962683, 68.81168091434172, 0.74413585, 90.0, 522, 284555, 417, 7.673247700000047
418, 3.814884799799716, 57.057289803674976, 68.59955197711324, 0.7436687499999997, 55.0, 516, 285071, 418, 7.538880499999777
419, 7.41200370064282, 57.119183655719844, 68.72327512475287, 0.7431427000000002, 80.0, 653, 285724, 419, 9.558883100000003
420, 5.486645774381189, 56.97738534969865, 68.6157498690904, 0.7425054999999999, 210.0, 763, 286487, 420, 11.16946420000022
421, 6.8351694472492435, 57.06700505625154, 68.75698818377595, 0.7418908000000003, 155.0, 603, 287090, 421, 8.819033000000218
422, 4.816353851274864, 57.01599864701967, 68.61347547092953, 0.7413530500000001, 35.0, 592, 287682, 422, 8.734806700000263
423, 5.38019616233948, 56.94680933595229, 68.58265213399207, 0.7406780499999994, 215.0, 908, 288590, 423, 13.502258200000142
424, 5.735633285334392, 56.91109144317437, 68.47377664949089, 0.7400521000000001, 30.0, 483, 289073, 424, 7.131205300000147
425, 6.62661848854035, 56.95061070108648, 68.50469395679794, 0.7394693499999997, 140.0, 812, 289885, 425, 12.050064099999872
426, 4.201072769642729, 57.94880378736793, 69.6456557053786, 0.7388524, 110.0, 559, 290444, 426, 8.31071589999965
427, 5.373027343798314, 58.128228877194374, 69.96291392314195, 0.7381067499999994, 200.0, 1098, 291542, 427, 16.276269700000285
428, 4.338110392439295, 58.11425786328739, 69.87022919626631, 0.7373084500000001, 135.0, 676, 292218, 428, 10.064034200000151
429, 5.5487422111739475, 58.173764400947384, 70.00094464930092, 0.7366352499999999, 125.0, 820, 293038, 429, 12.359549600000264
430, 4.431136469270775, 58.22202190391986, 70.01304970577836, 0.7360273, 80.0, 531, 293569, 430, 8.137618800000382
431, 5.690687537514246, 58.09072448143592, 69.95779138418344, 0.7354958499999998, 115.0, 650, 294219, 431, 9.710552099999859
432, 3.935794302783435, 58.27414561404458, 70.12889013169686, 0.7350256000000001, 30.0, 395, 294614, 432, 5.9377957000001516
433, 4.247519564238619, 58.26531431478522, 70.07427616766466, 0.7345693, 110.0, 619, 295233, 433, 9.290474899999936
434, 5.214781068325331, 58.13009095575265, 69.95623830200391, 0.7337309500000002, 260.0, 1244, 296477, 434, 18.639049599999908
435, 4.6530094911042115, 58.03034371531482, 69.82172168053894, 0.7328646999999999, 105.0, 681, 297158, 435, 10.260799300000144
436, 4.643582204446556, 58.207084710339466, 70.04276933152991, 0.7319606499999991, 420.0, 1328, 298486, 436, 19.905919899999844
437, 4.788089739665708, 58.29288964461114, 70.11042102615403, 0.7310687499999994, 55.0, 654, 299140, 437, 9.891737099999773
438, 5.896735598603285, 58.25429702634878, 70.13682097680608, 0.7303865500000002, 210.0, 862, 300002, 438, 13.0960498000004
439, 5.413488590993832, 57.84616261118466, 69.61157971411636, 0.7297803999999997, 155.0, 485, 300487, 439, 7.433151500000349
440, 6.4777237808642285, 57.81235535939535, 69.61301867167155, 0.7292597500000004, 180.0, 672, 301159, 440, 10.394845700000133
441, 9.512896719875686, 57.968113164289285, 69.97625665927151, 0.7287611500000001, 140.0, 436, 301595, 441, 6.664901400000417
442, 7.3579760606526765, 58.057663516590544, 69.93250414198198, 0.7283754999999998, 60.0, 421, 302016, 442, 6.497699000000011
443, 4.540761697226518, 57.74403339831235, 69.4654520317583, 0.7279007500000004, 50.0, 634, 302650, 443, 9.683644400000048
444, 3.984675039750299, 57.682010924894044, 69.38152284975405, 0.7274089000000001, 80.0, 459, 303109, 444, 7.000310799999625
445, 5.758453072113468, 57.82706063826454, 69.58558778201832, 0.7270340499999998, 55.0, 374, 303483, 445, 5.7773755999996865
446, 5.454863984943615, 57.83824540599168, 69.54257314844685, 0.7265016999999998, 210.0, 809, 304292, 446, 12.404653500000222
447, 5.861630606129766, 57.78193209330241, 69.53740359624227, 0.7258676500000001, 60.0, 600, 304892, 447, 9.255997100000059
448, 4.969620231921372, 57.74390089756582, 69.50977167146297, 0.7252907499999999, 120.0, 682, 305574, 448, 10.559869799999888
449, 4.1371744166033855, 57.79109345772416, 69.47898558833172, 0.7247975500000001, 30.0, 414, 305988, 449, 6.4960095000001274
450, 9.395979788183242, 57.94581623718104, 69.85202115081077, 0.7244371, 35.0, 387, 306375, 450, 5.972319199999674
451, 6.603724193626652, 57.78157396207269, 69.66310138359007, 0.7239879999999994, 115.0, 611, 306986, 451, 9.556518099999721
452, 5.6690022639893725, 57.80987268803167, 69.51710832352732, 0.7233458499999997, 240.0, 816, 307802, 452, 12.724733300000025
453, 4.139471416395644, 57.56867998206097, 69.22552151223887, 0.7227198999999996, 105.0, 575, 308377, 453, 8.907445100000132
454, 5.07442230098086, 57.85031445122464, 69.57220275585468, 0.7219697500000003, 345.0, 1092, 309469, 454, 17.003234799999973
455, 5.850505827544758, 57.886314634786736, 69.60853118647564, 0.7212024999999995, 70.0, 613, 310082, 455, 9.589008299999932
456, 6.200841261507535, 58.81731153054142, 70.8121763061417, 0.7204105000000003, 225.0, 1147, 311229, 456, 17.89279209999995
457, 5.45471280609634, 58.89006183631506, 70.84326221820751, 0.7196572000000002, 90.0, 527, 311756, 457, 8.29697810000016
458, 4.605029979213736, 58.77208710864074, 70.73718211238545, 0.7191208000000001, 110.0, 665, 312421, 458, 10.514021800000137
459, 6.189996368797338, 58.842763199143576, 70.77919984448508, 0.7184912499999996, 120.0, 734, 313155, 459, 11.597335999999814
460, 4.102309804438035, 58.66610868429836, 70.51199903850313, 0.7179831999999998, 65.0, 395, 313550, 460, 6.32891410000002
461, 5.109657805596573, 58.93629082942355, 70.95102053656095, 0.7174949500000001, 210.0, 690, 314240, 461, 10.896269700000175
462, 4.147985957477284, 58.736064935248166, 70.62375985312431, 0.7168321000000001, 155.0, 783, 315023, 462, 12.418294399999922
463, 6.102566161925353, 58.78239182407416, 70.79636569717556, 0.7162480000000002, 110.0, 515, 315538, 463, 8.190549500000088
464, 6.71211406348213, 58.82753804934922, 70.7670470822242, 0.7158488499999998, 55.0, 372, 315910, 464, 5.999086799999986
465, 4.489204731431197, 58.75978493690491, 70.63380729068409, 0.7154438499999999, 60.0, 528, 316438, 465, 8.465921900000012
466, 4.987266255345336, 58.91107007203025, 70.88315313808366, 0.7149556, 75.0, 557, 316995, 466, 8.936992100000225
467, 4.360112681379339, 58.74370755443379, 70.66265476597756, 0.7143948999999997, 155.0, 689, 317684, 467, 10.983612500000163
468, 4.414293987452984, 58.83976647694906, 70.77013888041178, 0.7138148500000003, 90.0, 600, 318284, 468, 9.612373800000114
469, 5.557328619095795, 58.877841625255726, 70.85412642708414, 0.7131371499999998, 390.0, 906, 319190, 469, 14.575779899999816
470, 6.222306030574653, 58.80523762240596, 70.79273334287872, 0.7124185000000003, 145.0, 691, 319881, 470, 11.06083660000013
471, 5.030997781223291, 58.41555500278225, 70.25524054192877, 0.7117610500000001, 180.0, 770, 320651, 471, 12.324030400000083
472, 6.440917511598902, 58.29336690817408, 70.1996391685363, 0.7109114500000003, 455.0, 1118, 321769, 472, 17.934091499999795
473, 4.8719367598587615, 58.39487958704151, 70.22822621183575, 0.7100505999999995, 410.0, 795, 322564, 473, 12.884661099999903
474, 6.038796615628054, 58.2809943215272, 70.12670588456724, 0.7093999000000001, 165.0, 651, 323215, 474, 10.631490600000234
475, 6.484193049432817, 58.39364141669155, 70.27376792214133, 0.7088346999999998, 80.0, 605, 323820, 475, 9.814184999999725
476, 8.265597310579357, 58.41365828948928, 70.33734905590782, 0.7082713000000004, 135.0, 647, 324467, 476, 10.849931000000197
477, 6.527164087082795, 58.318622374457945, 70.17512745259276, 0.7077002500000001, 105.0, 622, 325089, 477, 10.287779300000238
478, 7.899521070924438, 58.39898627956117, 70.25889105274165, 0.7070877999999993, 155.0, 739, 325828, 478, 12.013359599999603
479, 3.9099221265438544, 58.3202773666942, 70.10141348033575, 0.7064488, 110.0, 681, 326509, 479, 11.228858299999956
480, 6.232928927987814, 58.238139451753106, 70.08054201318583, 0.7056518500000001, 285.0, 1090, 327599, 480, 17.754874100000052
481, 4.710229663661233, 58.19802507269319, 70.02355650644454, 0.7047361, 235.0, 945, 328544, 481, 15.522733199999948
482, 4.1542204088768, 58.199469452885566, 70.02375673251137, 0.7040309500000002, 90.0, 622, 329166, 482, 10.268004800000199
483, 3.760312230286435, 58.16700897868882, 69.96482115525465, 0.7035404500000002, 90.0, 468, 329634, 483, 7.778092699999888
484, 5.486705729647365, 58.11652967448125, 69.98107920888135, 0.7031538999999997, 5.0, 391, 330025, 484, 6.489415600000029
485, 5.456205648105247, 57.7090154170092, 69.4066932448335, 0.7027390000000003, 110.0, 531, 330556, 485, 8.848271300000306
486, 6.378966723819692, 57.88648440119273, 69.70013315806132, 0.7022746, 65.0, 501, 331057, 486, 8.30547690000003
487, 6.407676742672113, 57.80170316618632, 69.59780967526319, 0.7017170499999997, 145.0, 738, 331795, 487, 12.187326000000212
488, 5.729838003540223, 57.723060293835594, 69.4910388704434, 0.70086025, 330.0, 1166, 332961, 488, 19.38530290000017
489, 5.706014321125173, 57.74172933380325, 69.55060571199888, 0.7000583499999997, 75.0, 616, 333577, 489, 10.384653600000092
490, 3.6321366022706503, 57.802871373043025, 69.49522474390515, 0.699553, 110.0, 507, 334084, 490, 8.514187899999797
491, 4.383116751679654, 57.670562556050776, 69.35819639961231, 0.6990327999999999, 105.0, 649, 334733, 491, 10.833295199999611
492, 5.82820351864197, 57.70217247220293, 69.41264183358612, 0.6980085999999998, 925.0, 1627, 336360, 492, 26.969490100000257
493, 8.87485404820114, 57.798454816790596, 69.62528471324755, 0.6970280500000005, 40.0, 552, 336912, 493, 9.34975889999987
494, 3.7248451400198332, 57.807788311447226, 69.49101152999626, 0.69645385, 120.0, 724, 337636, 494, 12.192129699999896
495, 5.999238045870161, 57.856546062633306, 69.66661507542148, 0.6957612999999992, 210.0, 815, 338451, 495, 13.63322960000005
496, 5.036336049407359, 57.88550573804601, 69.6877301019213, 0.6949499500000006, 370.0, 988, 339439, 496, 16.522775899999942
497, 5.750516878870817, 58.03712356529108, 69.81255995390009, 0.6939671500000004, 635.0, 1196, 340635, 497, 20.06416799999988
498, 3.521724439222654, 58.14781460638856, 69.92697680333737, 0.6930630999999994, 185.0, 813, 341448, 498, 13.658386699999937
499, 7.386702348673066, 58.094212879506195, 69.9761401430273, 0.6925230999999998, 50.0, 387, 341835, 499, 6.49445199999991
500, 7.928270089037625, 57.904790725237056, 69.77532249026828, 0.6920573499999999, 165.0, 648, 342483, 500, 10.87001250000003
501, 4.096533913913238, 58.13577827759956, 69.90627042285342, 0.6915304000000001, 180.0, 523, 343006, 501, 8.739561200000026
502, 6.4006462418012795, 57.983088304330636, 69.80932889543138, 0.69109525, 65.0, 444, 343450, 502, 7.488036500000362
503, 5.029331336923214, 58.10645557858166, 69.89279679609704, 0.6904611999999997, 195.0, 965, 344415, 503, 16.13828700000022
504, 7.055206163930214, 58.05836339500861, 69.91901772972045, 0.6898055500000001, 90.0, 492, 344907, 504, 8.312214900000072
505, 6.81022982543088, 58.14581110535102, 69.99359531863824, 0.6892678, 80.0, 703, 345610, 505, 11.78757940000014
506, 5.234683398186462, 58.06151061505079, 69.80435368418694, 0.68872105, 45.0, 512, 346122, 506, 8.595009000000118
507, 3.876628570810166, 58.061549934569086, 69.78924261401858, 0.688132, 110.0, 797, 346919, 507, 13.351662200000192
508, 7.369111110090411, 58.24565103224346, 70.2257222533226, 0.6875717499999997, 55.0, 448, 347367, 508, 7.565061999999671
509, 3.9076452388529206, 57.99891582612069, 69.70446507182639, 0.6870632500000003, 165.0, 682, 348049, 509, 11.517037900000105
510, 5.327557189845855, 58.10397743122196, 69.94902296562415, 0.6865227999999999, 35.0, 519, 348568, 510, 8.831295299999965
511, 6.404460302411282, 58.09131171010452, 69.98870123332917, 0.6860925999999997, 110.0, 437, 349005, 511, 7.4162139000000025
512, 8.87978488689835, 58.10593675065517, 70.03064715477728, 0.6856030000000003, 160.0, 651, 349656, 512, 10.932146499999817
513, 5.232695674013432, 57.75584754995328, 69.48223245803483, 0.6849765999999998, 325.0, 741, 350397, 513, 12.414481799999976
514, 4.598161699471774, 57.4464337389905, 69.08747439617878, 0.6841926999999998, 160.0, 1001, 351398, 514, 16.85514090000015
515, 5.710177111287354, 57.41487296746702, 69.20135709217617, 0.6835658499999999, 45.0, 392, 351790, 515, 6.730586799999855
516, 5.259840209434229, 57.48226762429262, 69.2019346291237, 0.6830560000000001, 155.0, 741, 352531, 516, 12.52195359999996
517, 5.288147256829146, 57.38207389081834, 69.04985363469648, 0.6823333, 210.0, 865, 353396, 517, 14.603574700000081
518, 4.155852214254831, 57.420687199642785, 69.06876664011102, 0.6815165499999997, 165.0, 950, 354346, 518, 16.082178800000293
519, 6.18940404201376, 57.50492061746532, 69.21972274780273, 0.68082805, 35.0, 580, 354926, 519, 9.763761700000032
520, 4.256517676271404, 57.27300424938982, 68.8526751648724, 0.6802480000000001, 70.0, 709, 355635, 520, 11.984238599999571
521, 5.0768114353175715, 57.315194857437, 68.9410868754429, 0.6796747000000002, 35.0, 565, 356200, 521, 9.513473800000156
522, 3.9296431016187863, 57.39576617713548, 69.03005488107631, 0.6791135499999995, 110.0, 682, 356882, 522, 11.5495820000001
523, 5.4106177735577585, 57.43019431223988, 69.12208428824191, 0.6786073, 35.0, 443, 357325, 523, 7.4811313000000155
524, 4.440590876977887, 57.3502265815448, 68.96046814882666, 0.6779890000000003, 260.0, 931, 358256, 524, 15.638859400000001
525, 3.9139348706200314, 57.43100560781118, 69.05375988522091, 0.6771538000000004, 200.0, 925, 359181, 525, 15.649709600000278
526, 6.483379690603889, 57.31756420827283, 68.93379665038746, 0.6765638499999999, 100.0, 386, 359567, 526, 6.512876999999662
527, 6.641452828758977, 57.18995797414181, 68.87352231155903, 0.6761462499999998, 45.0, 542, 360109, 527, 9.165369700000156
528, 7.080842648383912, 56.85072155399723, 68.40968977438438, 0.6756026500000002, 110.0, 666, 360775, 528, 11.251848099999734
529, 6.105376289525567, 56.8823455146632, 68.45978580463601, 0.6749978499999997, 135.0, 678, 361453, 529, 11.447672299999795
530, 4.571279818138584, 56.950178867749834, 68.48341613457892, 0.6740978500000002, 425.0, 1322, 362775, 530, 22.38276900000028
531, 7.296714577060193, 57.01327460765839, 68.64351393222809, 0.67314295, 140.0, 800, 363575, 531, 13.558957499999906
532, 4.88444950286253, 56.990117183732394, 68.56456917656793, 0.6726007000000003, 80.0, 405, 363980, 532, 6.906536999999844
533, 4.334697293069989, 56.93033851479264, 68.47455055907253, 0.6720138999999998, 335.0, 899, 364879, 533, 15.183487600000262
534, 5.876897159594313, 57.235614541388706, 68.90546736320925, 0.6714414999999999, 50.0, 373, 365252, 534, 6.32850180000014
535, 4.846971545204756, 56.88451757581875, 68.44600543405971, 0.6710176, 85.0, 569, 365821, 535, 9.667552500000056
536, 5.301994315144178, 56.899501734553155, 68.44474531431456, 0.6703452999999996, 235.0, 925, 366746, 536, 15.703211200000169
537, 5.778001464875658, 56.954589909928146, 68.55934858263056, 0.6695658999999999, 210.0, 807, 367553, 537, 13.700822899999821
538, 5.618845094669793, 56.96188313827902, 68.51207295529129, 0.6686708500000004, 415.0, 1182, 368735, 538, 20.055365600000187
539, 4.573458318222077, 56.94692130798989, 68.46459041757787, 0.6679697499999997, 55.0, 376, 369111, 539, 6.461200999999619
540, 5.490727159579919, 56.89692743904039, 68.36705160606955, 0.6675242500000002, 105.0, 614, 369725, 540, 10.550881499999832
541, 7.126433393098617, 56.8518958482586, 68.40722671884005, 0.6670832500000002, 35.0, 366, 370091, 541, 6.313894599999912
542, 5.506409146076571, 56.61941635243214, 68.16040966284537, 0.6666102999999997, 210.0, 685, 370776, 542, 12.121165799999744
543, 7.981820736152049, 56.679438563493584, 68.20208668708801, 0.6659276500000004, 230.0, 832, 371608, 543, 14.16117660000009
544, 5.552968314764175, 56.64890022369093, 68.12906821492756, 0.6651770499999998, 360.0, 836, 372444, 544, 14.389553800000158
545, 4.704934700271328, 56.50768584331483, 67.92007574416299, 0.6645650500000001, 35.0, 524, 372968, 545, 8.977982599999905
546, 5.9125840573304, 56.50964398438903, 68.04473704195571, 0.6639377500000002, 410.0, 870, 373838, 546, 14.9179594000002
547, 5.249126803638443, 56.43296622624473, 67.9310861799452, 0.6632627500000003, 105.0, 630, 374468, 547, 10.803751899999952
548, 6.040304559678975, 56.625687836901534, 68.1609756939572, 0.66267235, 110.0, 682, 375150, 548, 11.767230899999959
549, 5.468168208866451, 56.64649583630614, 68.18901676907866, 0.6618668499999992, 270.0, 1108, 376258, 549, 19.353181799999675
550, 4.845310395167155, 56.66182814654182, 68.1471637321921, 0.6609857499999999, 215.0, 850, 377108, 550, 14.952495800000179
551, 7.318789875724402, 56.63149811774075, 68.20755835140453, 0.6604426000000001, 45.0, 357, 377465, 551, 6.36005329999989
552, 6.295975416490182, 56.59838070119442, 68.1300920924067, 0.6599701, 110.0, 693, 378158, 552, 12.10379980000016
553, 3.394063406356115, 56.61086957509281, 68.05425838053075, 0.6594813999999999, 75.0, 393, 378551, 553, 6.927081100000123
554, 5.346327794666092, 56.688243312835695, 68.1866440709432, 0.6590345500000002, 50.0, 600, 379151, 554, 10.72751500000004
555, 3.419886944194635, 56.513600343539395, 67.9631966072836, 0.6584729500000002, 105.0, 648, 379799, 555, 11.592916799999784
556, 5.185849629287366, 56.531930476059145, 67.9900498378424, 0.6579991, 95.0, 405, 380204, 556, 7.275477600000158
557, 5.371149811831916, 56.62929656610256, 68.15998352422947, 0.6573556000000003, 210.0, 1025, 381229, 557, 18.021118600000136
558, 6.298432299153721, 56.753821554864025, 68.20910798257856, 0.6566229999999995, 80.0, 603, 381832, 558, 10.630085899999813
559, 5.124500642609351, 56.50380104300902, 68.00812622542234, 0.6561334000000001, 80.0, 485, 382317, 559, 8.635819699999956
560, 7.372503971379169, 56.62126241530815, 68.1486213071503, 0.6556069, 125.0, 685, 383002, 560, 12.095640699999876
561, 4.669731187447906, 56.53920443608211, 67.97850085038405, 0.6550646499999997, 120.0, 520, 383522, 561, 9.16682609999998
562, 5.028252178531014, 56.536041912216966, 68.01548538969995, 0.6544702000000002, 240.0, 801, 384323, 562, 14.061890399999811
563, 5.422572436393378, 56.81929163675822, 68.32521377380736, 0.6537339999999995, 350.0, 835, 385158, 563, 14.60603089999995
564, 5.242852428928018, 56.586697369530086, 68.09502325057983, 0.6529802499999999, 115.0, 840, 385998, 564, 14.917599600000358
565, 5.549732055989179, 56.7966304333179, 68.34865845519226, 0.6524289999999997, 90.0, 385, 386383, 565, 6.8292584999999235
566, 5.473497840426803, 56.62589031165073, 68.1298620583705, 0.6519718000000002, 105.0, 631, 387014, 566, 11.338050800000019
567, 5.364730327261127, 56.677132677081865, 68.16155243281848, 0.6512135499999998, 340.0, 1054, 388068, 567, 18.621865399999933
568, 6.6288284549551895, 56.69402920801227, 68.17765303150861, 0.6504431500000003, 100.0, 658, 388726, 568, 11.762251900000138
569, 6.826479283535969, 56.606647462512, 68.13141691702812, 0.6498504999999999, 105.0, 659, 389385, 569, 11.753669900000205
570, 4.1495247891340306, 56.33116077645115, 67.71933795585834, 0.6491287000000003, 255.0, 945, 390330, 570, 16.847699099999772
571, 4.7023662500545145, 56.059801817809394, 67.41498069716832, 0.6483330999999998, 230.0, 823, 391153, 571, 14.84156189999976
572, 3.424845433391125, 56.075162717580604, 67.40436449152276, 0.6474124000000001, 225.0, 1223, 392376, 572, 22.128773999999794
573, 3.9401984785229733, 56.10534168634659, 67.50484291467912, 0.64651105, 260.0, 780, 393156, 573, 13.524702799999432
574, 5.797528724462767, 56.070275373444034, 67.50985171969162, 0.6458707000000001, 145.0, 643, 393799, 574, 11.409460000000763
575, 3.8810076166376803, 56.000285620601986, 67.2825931152841, 0.6453603999999995, 155.0, 491, 394290, 575, 8.297643400000197
576, 4.023516059665778, 56.08456206356726, 67.4094140253053, 0.6448330000000003, 110.0, 681, 394971, 576, 11.281975900000361
577, 4.950381825556078, 56.057106284208075, 67.46152510812261, 0.6441588999999999, 385.0, 817, 395788, 577, 13.501532100000077
578, 7.920028375148183, 56.0552277140098, 67.52588050200207, 0.64360945, 50.0, 404, 396192, 578, 6.723936200000026
579, 4.72099969922706, 56.1107467954809, 67.47666377732249, 0.6431900500000002, 80.0, 528, 396720, 579, 8.68174160000035
580, 6.121930941213079, 56.081780800699185, 67.47407397743032, 0.6426846999999998, 120.0, 595, 397315, 580, 9.873889800000143
581, 5.986654606642145, 56.05014469955907, 67.47716685439602, 0.6420457000000003, 180.0, 825, 398140, 581, 13.722934299999906
582, 7.4883588956532074, 56.09453825324044, 67.53069226407261, 0.64127035, 260.0, 898, 399038, 582, 14.881682199999887
583, 4.734179251838343, 56.09148517804655, 67.45503442937678, 0.64063855, 75.0, 506, 399544, 583, 8.456383499999902
584, 7.255130342318257, 55.827856234094256, 67.22865220393098, 0.6397655499999996, 505.0, 1434, 400978, 584, 23.756914399999914
585, 3.5991892024767997, 55.820607342412764, 67.06399055426331, 0.6389317000000001, 75.0, 419, 401397, 585, 7.138810600000397
586, 7.109326435429395, 55.68980429739655, 67.04094360386802, 0.6385483, 10.0, 433, 401830, 586, 7.293361099999856
587, 6.032139481851659, 55.783853731978056, 67.12658228280064, 0.6380717500000003, 120.0, 626, 402456, 587, 10.435898400000042
588, 4.317623750101657, 55.65462458508569, 66.89152102800286, 0.6375038500000001, 155.0, 636, 403092, 588, 10.65846479999982
589, 7.694009337644532, 55.720575941161066, 67.11174183971477, 0.6366929499999993, 315.0, 1166, 404258, 589, 19.415598200000204
590, 5.80974690657523, 55.65859128810741, 66.98324169936004, 0.6358766499999999, 130.0, 648, 404906, 590, 10.919384300000274
591, 4.896599852328021, 55.72489553315869, 67.03942737818763, 0.63536995, 80.0, 478, 405384, 591, 8.005931300000157
592, 5.1936688780360205, 55.613740148423595, 66.97085856184175, 0.6348704500000001, 150.0, 632, 406016, 592, 10.642241999999897
593, 8.101596450564307, 55.715060146761616, 67.09265294545133, 0.6343304499999999, 125.0, 568, 406584, 593, 9.634251599999516
594, 4.1441800349900095, 55.717603157386456, 66.98861317964834, 0.6337045000000002, 415.0, 823, 407407, 594, 13.94181529999969
595, 4.4916219229268775, 55.596855193663856, 66.89094943314869, 0.6328207000000003, 500.0, 1141, 408548, 595, 19.215534099999786
596, 5.189053314556229, 55.7028665847526, 67.03652426268589, 0.6318990999999999, 395.0, 907, 409455, 596, 15.388569099999586
597, 3.806253695443495, 55.76064321413562, 67.07027270188972, 0.6313100499999997, 65.0, 402, 409857, 597, 6.8787671999998565
598, 4.390942081305034, 55.65483754662906, 66.9625405367683, 0.6308231500000003, 210.0, 680, 410537, 598, 11.553071499999533
599, 8.035000659808327, 55.85574667564424, 67.3212640496749, 0.6303038500000001, 5.0, 474, 411011, 599, 8.093971700000111
600, 5.455331641373299, 55.71946322509998, 67.01380594782957, 0.6298538499999997, 75.0, 526, 411537, 600, 8.995953499999814
601, 5.197582202254182, 55.73561150545901, 67.01654501406023, 0.6294434499999999, 105.0, 386, 411923, 601, 6.56476289999955
602, 7.279449284166187, 55.873945436678135, 67.29486778190544, 0.6289700500000001, 105.0, 666, 412589, 602, 11.383723300000383
603, 5.209526472170669, 55.70937585026385, 67.00696059996824, 0.6282968499999995, 180.0, 830, 413419, 603, 14.161894799999573
604, 4.437143720785777, 55.772213049994576, 67.09877668027525, 0.6276196000000003, 185.0, 675, 414094, 604, 11.657794099999592
605, 7.554792723821518, 55.81171487029035, 67.20232543371674, 0.6271362999999996, 80.0, 399, 414493, 605, 6.882706500000495
606, 4.51078572986364, 55.8019039447491, 67.12404708113101, 0.6266818000000003, 200.0, 611, 415104, 606, 10.50725169999987
607, 4.683156958728044, 55.646637266462626, 66.92867265306077, 0.62610715, 110.0, 666, 415770, 607, 11.481854500000736
608, 6.604517925573247, 55.76688005719866, 67.14347519465855, 0.6254924499999995, 210.0, 700, 416470, 608, 11.96673760000067
609, 7.8824646191439705, 55.856101446423395, 67.34431014282593, 0.6248773000000001, 130.0, 667, 417137, 609, 11.504796100000021
610, 4.999548838164225, 55.778224591947755, 67.01773369203491, 0.6242319999999996, 150.0, 767, 417904, 610, 13.161089899999752
611, 4.962850468052972, 55.79965736459477, 67.0791373714324, 0.6236915499999999, 105.0, 434, 418338, 611, 7.548487000000023
612, 7.20178662003176, 55.85022848144212, 67.17659590200718, 0.6233239, 55.0, 383, 418721, 612, 6.671418799999628
613, 3.551111967302859, 55.68557984352112, 66.92137855529785, 0.6229715499999998, 5.0, 400, 419121, 613, 7.0022457999994
614, 4.6479639787595355, 55.76724622537802, 66.9969426039811, 0.62262775, 25.0, 364, 419485, 614, 6.3067934999999125
615, 4.539899704942086, 56.0988567263581, 67.43737238314083, 0.6220189000000002, 235.0, 989, 420474, 615, 17.046637999999803
616, 3.2433894823980696, 56.74722584731706, 68.27327534915837, 0.6212791, 220.0, 655, 421129, 616, 11.415224800000033
617, 6.4162011334837565, 56.734055383737214, 68.27649512845653, 0.6205627, 115.0, 937, 422066, 617, 16.30477989999963
618, 6.1023128405345695, 56.711054739266054, 68.24617156169343, 0.6196343499999996, 315.0, 1126, 423192, 618, 19.607111199999963
619, 4.620354827101697, 56.612101077050276, 68.1251447461315, 0.6189093999999999, 125.0, 485, 423677, 619, 8.502856400000383
620, 5.830639588738884, 56.81514507769925, 68.37507486527491, 0.6183415000000002, 215.0, 777, 424454, 620, 13.510878799999773
621, 8.027391191260769, 56.8933369993879, 68.46801179234907, 0.6176147500000002, 180.0, 838, 425292, 621, 14.685752599999432
622, 3.056392324846343, 56.67637509275964, 68.13480184307207, 0.6170783500000001, 75.0, 354, 425646, 622, 6.2977144000005865
623, 5.872444483141105, 56.79741222208197, 68.3313263763081, 0.6166814500000001, 120.0, 528, 426174, 623, 9.304631299999528
624, 4.594021555582254, 56.64253811178536, 68.10201159838972, 0.6160262499999999, 190.0, 928, 427102, 624, 16.270654499999182
625, 7.959437692093093, 56.90070069014136, 68.50213746170499, 0.6153674500000001, 125.0, 536, 427638, 625, 9.444307600000684
626, 5.425658720827102, 56.85677052612305, 68.3808534790039, 0.6148450000000001, 100.0, 625, 428263, 626, 10.895381100000122
627, 5.780170030417767, 56.728975960702606, 68.25635143048835, 0.6142667499999996, 80.0, 660, 428923, 627, 11.630878200000552
628, 4.670436617182579, 56.755022735968325, 68.23705345312172, 0.6136012000000001, 160.0, 819, 429742, 628, 14.545370099999673
629, 6.0426226491639925, 57.22397354057243, 68.82451517374308, 0.6129329499999996, 125.0, 666, 430408, 629, 11.854004399999212
630, 5.9636643386165495, 57.25125945209497, 68.88409163372144, 0.6123538, 155.0, 621, 431029, 630, 10.959704199999578
631, 5.2493957541340475, 57.44967626830906, 69.10587334864348, 0.6117035499999997, 165.0, 824, 431853, 631, 14.58898599999975
632, 7.693323060914586, 57.49591540295392, 69.24498477031861, 0.6110308000000002, 140.0, 671, 432524, 632, 11.916182299999491
633, 8.213060311735491, 57.50747320483649, 69.26150666499736, 0.6103337499999998, 240.0, 878, 433402, 633, 15.511213599999792
634, 6.367063793189385, 57.438775277605245, 69.0019489737118, 0.60975505, 75.0, 408, 433810, 634, 7.291916900000615
635, 3.166309365454842, 57.365772280973545, 69.0174825443941, 0.6094184500000003, 55.0, 340, 434150, 635, 6.141126299999996
636, 3.497298593469707, 57.391242343460455, 69.01949174577656, 0.6090985, 20.0, 371, 434521, 636, 6.669426400000702
637, 6.109975003567914, 57.433122306835344, 69.04160141618284, 0.6086358999999997, 155.0, 657, 435178, 637, 11.732207799999742
638, 4.474642923391014, 57.44508481469954, 69.12084917696366, 0.6080504500000001, 115.0, 644, 435822, 638, 11.550467899999603
639, 3.5217954967715337, 57.3037911007944, 68.88803359089061, 0.6074465499999997, 105.0, 698, 436520, 639, 12.561774400000104
640, 4.17846681346334, 57.50229372494463, 69.1564539204473, 0.60688405, 90.0, 552, 437072, 640, 9.911449199999879
641, 6.693010999976347, 57.41307141383489, 69.12672006090482, 0.6064628500000001, 75.0, 384, 437456, 641, 6.918420699999842
642, 8.695655988987733, 57.43330373793748, 69.213115329683, 0.6060011499999997, 120.0, 642, 438098, 642, 11.429575099999965
643, 4.202062498030674, 57.230933954761284, 68.81727462209713, 0.6054296500000003, 90.0, 628, 438726, 643, 11.244583200000307
644, 5.587817845721634, 57.537139492943176, 69.21408638467594, 0.6048162999999999, 125.0, 735, 439461, 644, 13.312519699999939
645, 3.7381420657185065, 57.25964145622928, 68.78662792123372, 0.6042565000000001, 140.0, 509, 439970, 645, 9.122404100000495
646, 5.932107011554991, 57.580688106675105, 69.29318595983372, 0.603568, 295.0, 1021, 440991, 646, 18.389147400000184
647, 5.188789060266417, 57.72457880312013, 69.40152577233908, 0.6026027499999996, 655.0, 1124, 442115, 647, 20.178871199999776
648, 6.01980457779225, 57.591169030149395, 69.23881893713498, 0.6018188499999996, 65.0, 618, 442733, 648, 11.312764799999968
649, 6.048424739823785, 57.75578367248062, 69.54943919613072, 0.6011924500000002, 180.0, 774, 443507, 649, 14.061140499999965
650, 6.461032112129033, 57.508199516095615, 69.1371034321032, 0.6005705499999998, 20.0, 608, 444115, 650, 11.047555499999362
651, 6.47312814939548, 57.858612497313686, 69.60690300805229, 0.59986855, 240.0, 952, 445067, 651, 17.311698200000137
652, 3.758381599453107, 57.80899336450387, 69.47708737038818, 0.5992682500000001, 90.0, 382, 445449, 652, 6.974922400000651
653, 7.521488232923762, 57.70277664419838, 69.46599761189869, 0.5986877500000001, 300.0, 908, 446357, 653, 16.520750699999553
654, 4.48867535019304, 57.810338566569165, 69.53465938027279, 0.5980411000000002, 155.0, 529, 446886, 654, 9.751123600000028
655, 6.68457973961798, 57.56701429673042, 69.27515377061836, 0.5975028999999995, 105.0, 667, 447553, 655, 12.214407299999948
656, 2.996793926740245, 57.57174714283593, 69.15428048211174, 0.59696965, 85.0, 518, 448071, 656, 9.487115699999777
657, 5.106448813417626, 57.69744981256279, 69.382299730583, 0.5963288499999999, 235.0, 906, 448977, 657, 16.500981000000138
658, 6.338640165067519, 57.71624718855179, 69.46951310814872, 0.5956057000000002, 125.0, 701, 449678, 658, 12.931864799999857
659, 6.728777462270408, 58.409213091419865, 70.2658616575168, 0.59498515, 200.0, 678, 450356, 659, 12.406814800000575
660, 3.5752072221144258, 58.84482295223265, 70.73883492065127, 0.5944987, 50.0, 403, 450759, 660, 7.462695799999892
661, 3.2391124677932477, 58.724062614733604, 70.60820571235989, 0.5941413999999997, 45.0, 391, 451150, 661, 7.231829999999718
662, 6.692884617911023, 58.9245580102228, 70.95098710758671, 0.5936121999999998, 160.0, 785, 451935, 662, 14.471871299999293
663, 4.7545605149871095, 58.72855884300734, 70.57973171089462, 0.5930335000000001, 45.0, 501, 452436, 663, 9.289925699999912
664, 4.85919840288335, 58.72597097708819, 70.61764211240022, 0.5925907000000002, 70.0, 483, 452919, 664, 8.962096599999313
665, 6.469698118252887, 58.712935724029876, 70.6778070869529, 0.5919602499999996, 285.0, 918, 453837, 665, 17.030575199999475
666, 7.224119099979964, 58.75919351594819, 70.74040181223097, 0.5912956, 115.0, 559, 454396, 666, 10.459804600000098
667, 6.168726969058462, 58.81607944046391, 70.74226175806915, 0.5907101499999998, 160.0, 742, 455138, 667, 13.816474799999924
668, 5.8175533714819165, 58.86926694721058, 70.82345144334307, 0.5900189500000004, 225.0, 794, 455932, 668, 14.916166300000441
669, 10.051747287420051, 59.01472834403941, 71.08174056248949, 0.5893898499999999, 45.0, 604, 456536, 669, 11.226838199999293
670, 4.289211648395948, 58.7703821640216, 70.7010376862297, 0.5887769500000001, 210.0, 758, 457294, 670, 14.090358399999786
671, 9.03984608055634, 58.76169291438145, 70.7592769541104, 0.5881627000000001, 120.0, 607, 457901, 671, 11.312696300000425
672, 6.248712261413573, 58.561655481353064, 70.45509942615305, 0.5876537499999996, 60.0, 524, 458425, 672, 9.832588100000066
673, 6.827371718103475, 58.81668832484541, 70.85394346976868, 0.5870710000000001, 260.0, 771, 459196, 673, 14.367771999999604
674, 4.811747864424111, 58.88439513109401, 70.79463661787753, 0.5864234499999997, 180.0, 668, 459864, 674, 12.496442199999365
675, 5.644063936614002, 58.86571320845056, 70.8140397936569, 0.58594915, 85.0, 386, 460250, 675, 7.306588400000692
676, 5.15336177003499, 58.92523762104445, 70.90251346482043, 0.5854033000000001, 255.0, 827, 461077, 676, 15.634201899999425
677, 4.673090283902957, 58.9772467695151, 70.89763795387294, 0.5845073500000001, 570.0, 1164, 462241, 677, 21.90240900000026
678, 7.524934771790202, 59.03527899839278, 71.05927367022032, 0.5835506499999996, 505.0, 962, 463203, 678, 18.042549300000246
679, 5.405531790533765, 58.84305693023833, 70.79580641030078, 0.5829368499999998, 45.0, 402, 463605, 679, 7.646619000000101
680, 4.599092873256488, 58.90171944195804, 70.8007913512003, 0.5822906500000001, 535.0, 1034, 464639, 680, 19.569627699999728
681, 6.833276640333676, 59.1326038800296, 71.11693707284897, 0.5815364500000002, 115.0, 642, 465281, 681, 12.067044299999907
682, 6.160567517222439, 59.07643725351886, 71.05606998832742, 0.5806431999999994, 290.0, 1343, 466624, 682, 25.430150199999844
683, 5.192383514571998, 59.25377019461939, 71.27482402607546, 0.5797733500000001, 65.0, 590, 467214, 683, 11.28199880000011
684, 6.424329924240577, 58.95022915527884, 70.93864847706483, 0.5792027499999994, 120.0, 678, 467892, 684, 12.893319800000427
685, 6.279399474397282, 59.17331413298807, 71.16084745429427, 0.5785516000000002, 395.0, 769, 468661, 685, 14.671936600000663
686, 5.149123262105425, 59.135573250270916, 71.09941856891717, 0.5778198999999995, 90.0, 857, 469518, 686, 16.31405249999989
687, 6.927942539728441, 59.180519999707556, 71.2183870399666, 0.5770567, 350.0, 839, 470357, 687, 16.032607400000416
688, 4.633149358173532, 59.162612812493435, 71.13672030869351, 0.5763443499999995, 160.0, 744, 471101, 688, 14.137610499999937
689, 5.932691308664766, 59.13769343575054, 71.14642026972643, 0.5758412499999999, 35.0, 374, 471475, 689, 7.136634600000434
690, 7.273850893920336, 59.23209071782993, 71.3367655272455, 0.5754492999999999, 50.0, 497, 471972, 690, 9.563724300000104
691, 11.046966987983206, 59.34875091573053, 71.46422752146715, 0.5748876999999996, 110.0, 751, 472723, 691, 14.380009400000745
692, 8.99030651916643, 59.16805254344096, 71.26401356102795, 0.5741533000000001, 65.0, 881, 473604, 692, 16.95286440000018
693, 4.241222243155655, 59.15708743211349, 71.1261177098942, 0.5732794000000002, 240.0, 1061, 474665, 693, 20.484601699999985
694, 4.0077279251117215, 59.189469721410184, 71.08366403951274, 0.5726287, 60.0, 385, 475050, 694, 7.556255599999531
695, 5.677655887631137, 59.17378495183829, 71.20058289475328, 0.5721125499999995, 225.0, 762, 475812, 695, 14.709564599999794
696, 4.7633692040218145, 59.241090559271065, 71.20956828400219, 0.5715981999999998, 80.0, 381, 476193, 696, 7.40459219999957
697, 5.322580393084208, 59.150418461980045, 71.09772245808297, 0.5710437999999999, 160.0, 851, 477044, 697, 16.435814800000117
698, 4.079337478399861, 59.21323662552179, 71.19725557963054, 0.5702018500000002, 475.0, 1020, 478064, 698, 19.7190528000001
699, 5.2467093027702925, 59.42388772136224, 71.50569908198884, 0.5695614999999997, 60.0, 403, 478467, 699, 7.874553500000729
700, 5.877176903654774, 59.3405552453289, 71.40613781749863, 0.569143, 110.0, 527, 478994, 700, 10.461591799999951
701, 3.307506564397003, 59.154082114456905, 71.11262856598152, 0.5686327000000001, 135.0, 607, 479601, 701, 11.843357099999594
702, 7.572050511307093, 59.04125399745545, 71.05408826152427, 0.5680431999999995, 135.0, 703, 480304, 702, 13.7202757999994
703, 5.7229778602459405, 58.719677592432774, 70.63439673046733, 0.56757205, 25.0, 344, 480648, 703, 6.76375999999982
704, 6.2024509638943, 58.550351374077074, 70.41495661302046, 0.5671796500000001, 35.0, 528, 481176, 704, 10.416800799999692
705, 5.559084452923411, 58.57050388724175, 70.45646911264002, 0.5664420999999994, 320.0, 1111, 482287, 705, 21.73928000000069
706, 3.9921173709322435, 58.65166455932068, 70.49560947518374, 0.5653423000000004, 400.0, 1333, 483620, 706, 25.985284399999728
707, 8.157984535180391, 58.640806969310994, 70.59297105912955, 0.564472, 30.0, 601, 484221, 707, 11.858124100000168
708, 4.54745260342246, 58.681801417517285, 70.60204825830208, 0.5640314499999999, 30.0, 378, 484599, 708, 7.4388584999996965
709, 6.418199397570946, 58.642574431475474, 70.53143919103286, 0.5634788500000001, 185.0, 850, 485449, 709, 16.70721010000034
710, 6.340975315204209, 58.726804490986616, 70.66898505166245, 0.5626252000000002, 250.0, 1047, 486496, 710, 20.73891260000073
711, 6.235843301405886, 58.68306436900147, 70.57858232993078, 0.5618453500000001, 110.0, 686, 487182, 711, 13.680729800000336
712, 5.763624687550476, 58.70075648046111, 70.61303406042728, 0.5612922999999999, 180.0, 543, 487725, 712, 10.74526590000005
713, 6.930898408034096, 58.78635980453959, 70.7727618422245, 0.5607545499999997, 140.0, 652, 488377, 713, 12.85548579999977
714, 3.4874580197579026, 58.63721281013741, 70.43105549843895, 0.5601893500000001, 95.0, 604, 488981, 714, 11.996894399999292
715, 5.690428001944684, 58.608776683649744, 70.45110541729888, 0.5596997499999997, 145.0, 484, 489465, 715, 9.5339984000002
716, 3.3752165525187587, 58.60000945680085, 70.40686279811939, 0.5591620000000004, 65.0, 711, 490176, 716, 14.091479499999878
717, 3.2885364651516245, 58.37409083188235, 70.18583491817935, 0.5584325499999998, 345.0, 910, 491086, 717, 18.061469600000237
718, 8.016483425341471, 58.452174138541174, 70.367942732994, 0.5577112000000003, 135.0, 693, 491779, 718, 13.706103099999382
719, 2.9295288209789363, 58.39069695209139, 70.17150520439723, 0.55722025, 50.0, 398, 492177, 719, 7.881012499999997
720, 4.991810589991696, 58.420920373590825, 70.23618538067313, 0.55649845, 465.0, 1206, 493383, 720, 23.937322299999323
721, 4.697293933201454, 58.53816071181148, 70.40690798063395, 0.5556258999999999, 155.0, 733, 494116, 721, 14.54268409999986
722, 7.710983899621228, 58.4967784154079, 70.48134017741897, 0.5550247000000003, 125.0, 603, 494719, 722, 12.064828699999453
723, 5.358437942446403, 58.66495190680947, 70.61650760709524, 0.5544910000000002, 90.0, 583, 495302, 723, 11.620893899999828
724, 3.6738377561962063, 58.45819489739158, 70.26157862056385, 0.5540306499999997, 60.0, 440, 495742, 724, 8.721582899999703
725, 5.030664176115487, 58.56126131598405, 70.41375647191926, 0.5533754500000003, 245.0, 1016, 496758, 725, 20.35620259999996
726, 6.085645077953633, 58.45641545561171, 70.31579718442308, 0.5524817499999995, 290.0, 970, 497728, 726, 19.429145099999914
727, 4.616554820173079, 58.46886885938027, 70.30630008505403, 0.5517325000000001, 170.0, 695, 498423, 727, 13.888533400000597
728, 6.215778738103565, 58.50186971587843, 70.39540287550275, 0.5509490499999998, 310.0, 1046, 499469, 728, 20.94912209999984
729, 3.590188380719328, 58.40542504636301, 70.19107499151873, 0.5500382499999998, 150.0, 978, 500447, 729, 19.73630840000078
730, 3.6556084578490013, 58.36871391062237, 70.16478786809975, 0.5492462500000003, 255.0, 782, 501229, 730, 15.995846099999653
731, 4.8012573531857825, 58.440403440006875, 70.23561336424936, 0.5486342500000001, 30.0, 578, 501807, 731, 11.643455899999935
732, 8.051910493083192, 58.41404935883796, 70.38454362545187, 0.5480272000000003, 165.0, 771, 502578, 732, 15.635522800000217
733, 6.956744091255094, 58.33492486047809, 70.18800542415882, 0.5473477, 160.0, 739, 503317, 733, 14.906273599999622
734, 8.649814302168986, 58.267716023012454, 70.14994719189414, 0.5467285, 155.0, 637, 503954, 734, 12.950049299999591
735, 6.321805452408849, 58.34168051109939, 70.14595009068974, 0.54622225, 60.0, 488, 504442, 735, 9.921661999999742
736, 8.768031933931503, 58.41668977633605, 70.32492280191804, 0.5457132999999998, 110.0, 643, 505085, 736, 13.117547799999556
737, 6.264914403147995, 58.26447205543518, 70.08368810653687, 0.5448839500000002, 645.0, 1200, 506285, 737, 24.227638399999705
738, 6.199377128711799, 58.28279550451981, 70.096872731259, 0.5439677499999994, 145.0, 836, 507121, 738, 16.98634309999943
739, 5.780115021428386, 58.35707722221755, 70.20059869603027, 0.5432392000000001, 165.0, 783, 507904, 739, 15.980674000000363
740, 4.260561167203707, 58.29201206574805, 70.10245832652349, 0.5426159499999998, 110.0, 602, 508506, 740, 12.354227599999831
741, 3.721124323235976, 58.43926401283991, 70.217709502098, 0.5419621, 200.0, 851, 509357, 741, 17.338902000000417
742, 5.884939395863793, 58.348014915938926, 70.1355010133929, 0.5411723499999994, 170.0, 904, 510261, 742, 18.507975199999237
743, 8.279475356853892, 58.67613436211068, 70.66222503031734, 0.5403952000000001, 190.0, 823, 511084, 743, 16.93870330000027
744, 4.962520904695759, 58.69365848231519, 70.54039450180836, 0.5396036500000002, 310.0, 936, 512020, 744, 19.201297099999465
745, 4.394356176921645, 58.54451329514787, 70.42926445007325, 0.5388494499999998, 210.0, 740, 512760, 745, 15.21889850000025
746, 7.6284882360073025, 58.62980920658555, 70.60759976409203, 0.5383229500000001, 45.0, 430, 513190, 746, 8.90590340000017
747, 5.0372454298132245, 58.740254881547735, 70.62915395542899, 0.5377928500000001, 145.0, 748, 513938, 747, 15.42077270000027
748, 5.399939021530138, 58.58130795442605, 70.46236593856949, 0.5369585499999999, 345.0, 1106, 515044, 748, 22.900853899999674
749, 4.251641958918135, 58.541130441039485, 70.35647426610996, 0.5361634000000001, 105.0, 661, 515705, 749, 13.729081399999814
750, 6.069670157131265, 58.66156531635084, 70.60328272351047, 0.5354555499999999, 215.0, 912, 516617, 750, 18.90957510000044
751, 5.716623128045987, 58.56471073323008, 70.48025724040033, 0.5348161000000002, 155.0, 509, 517126, 751, 10.682343700000274
752, 4.726556776412602, 58.49201396781366, 70.2728750221574, 0.5343521499999998, 80.0, 522, 517648, 752, 10.849022099999274
753, 4.48238637489932, 58.405752484210126, 70.24802109359146, 0.533944, 95.0, 385, 518033, 753, 8.011475499999506
754, 7.168901562635133, 58.56622429036383, 70.4438644594221, 0.5335295500000001, 100.0, 536, 518569, 754, 11.24017079999976
755, 5.997556190544028, 58.59917638101552, 70.45571888042336, 0.5331222999999999, 35.0, 369, 518938, 755, 7.686013200000161
756, 6.098022082836187, 58.64539519878996, 70.5195310776975, 0.53252785, 485.0, 952, 519890, 756, 19.83954360000007
757, 6.313956685804872, 59.07714032614103, 71.0800460820557, 0.5314298500000002, 705.0, 1488, 521378, 757, 30.87463260000004
758, 7.3433959735741325, 59.055464608328684, 71.05271945293218, 0.5303728, 205.0, 861, 522239, 758, 18.017192800000885
759, 5.249164048852867, 58.96957439017695, 70.89431070082681, 0.52982425, 80.0, 358, 522597, 759, 8.023081399999683
760, 5.4036492376110035, 59.07902344712266, 71.05251260705896, 0.5294633499999998, 85.0, 444, 523041, 760, 10.207825599999524
761, 6.157965202655088, 58.99736456688842, 70.94440513982761, 0.5289219999999999, 235.0, 759, 523800, 761, 16.118230399999447
762, 4.430140225494705, 58.92537999357613, 70.86335401714973, 0.5283181000000002, 110.0, 583, 524383, 762, 12.32221699999991
763, 6.006538655795649, 59.008413269526095, 70.93990980415042, 0.5273735499999997, 940.0, 1516, 525899, 763, 31.73770969999987
764, 6.4948799088718845, 59.24409499176175, 71.29144316357461, 0.5264155000000003, 120.0, 613, 526512, 764, 12.90175199999976
765, 6.999766017190921, 59.14149238513066, 71.18515982077672, 0.5255780499999999, 385.0, 1248, 527760, 765, 26.369679100000212
766, 7.1026390762111475, 59.28709021835951, 71.33046086282756, 0.5248513000000001, 35.0, 367, 528127, 766, 7.974492299999838
767, 5.3714728282156985, 58.97522331927126, 70.88807825436088, 0.5243922999999996, 145.0, 653, 528780, 767, 13.995508000000882
768, 4.760373516256139, 59.109955406914196, 71.02177651118869, 0.5238617499999998, 150.0, 526, 529306, 768, 11.069573400000081
769, 6.179509744598939, 58.955745173799386, 70.89674243481707, 0.5231624499999997, 235.0, 1028, 530334, 769, 21.793745699999818
770, 3.261476704997754, 58.289251086033815, 70.02880650091609, 0.5224546, 115.0, 545, 530879, 770, 11.631238699999813
771, 5.179736215124305, 58.339880865604194, 70.11840531392725, 0.5217066999999996, 290.0, 1117, 531996, 771, 23.66103209999983
772, 3.911803686579534, 58.48348197546047, 70.3153709702052, 0.5208967, 110.0, 683, 532679, 772, 14.58544880000045
773, 3.07238170082085, 58.164782937002364, 69.9099875556098, 0.5203544499999998, 75.0, 522, 533201, 773, 11.275650900000073
774, 3.4189105451748265, 58.20229561602483, 69.95802591667801, 0.51989995, 75.0, 488, 533689, 774, 10.448454299999867
775, 5.847358276798891, 58.38046224300678, 70.24438448594167, 0.5193059500000001, 250.0, 832, 534521, 775, 17.846667400000115
776, 6.109393541243195, 58.51058638029994, 70.37203749767325, 0.5186057499999998, 105.0, 724, 535245, 776, 15.389503600000353
777, 4.514850965711106, 58.45108761277949, 70.25244175886907, 0.5179051000000001, 185.0, 833, 536078, 777, 17.828072899999825
778, 3.0395129688206266, 58.33799365309418, 70.11261318811302, 0.5173655500000001, 65.0, 366, 536444, 778, 7.914661300000262
779, 4.80210271244527, 58.214833639653214, 69.97066309399594, 0.5170168, 15.0, 409, 536853, 779, 8.810644299999694
780, 7.411564473242046, 58.39036548838896, 70.23889626283696, 0.5166644500000003, 75.0, 374, 537227, 780, 8.072418200000357
781, 6.00643588261154, 58.39994142963421, 70.26180110848725, 0.51620545, 155.0, 646, 537873, 781, 13.891915700000027
782, 5.121274209175354, 58.55477721385467, 70.43347130799904, 0.5157392500000001, 30.0, 390, 538263, 782, 8.38993599999958
783, 6.5408003150230805, 58.38932997638668, 70.20550536129991, 0.5152132, 135.0, 779, 539042, 783, 16.730805500000315
784, 4.93561946157366, 58.37752739906311, 70.21156380653382, 0.5146826499999999, 45.0, 400, 539442, 784, 8.82660130000022
785, 7.823015096925968, 58.468611514591565, 70.34447055392795, 0.5140409500000004, 335.0, 1026, 540468, 785, 22.130677099999957
786, 3.3930911843905625, 58.5235356802351, 70.38485771350646, 0.5132588499999996, 120.0, 712, 541180, 786, 15.439707600000474
787, 5.17087188085816, 58.45435363269243, 70.28294233103267, 0.5123894500000002, 630.0, 1220, 542400, 787, 26.41162660000009
788, 6.233497674501966, 58.351448216037376, 70.21245699150617, 0.5113373500000004, 255.0, 1118, 543518, 788, 24.437250400000266
789, 5.604174522656577, 58.44085287515822, 70.30508101736072, 0.5103905499999997, 450.0, 986, 544504, 789, 21.610592799999722
790, 5.264701275197451, 58.398744816108035, 70.20655315834404, 0.5096115999999999, 160.0, 745, 545249, 790, 16.381473299999925
791, 6.782838728321531, 58.50778479976508, 70.42498249316033, 0.5090405499999998, 135.0, 524, 545773, 791, 11.538224199999604
792, 3.9239170958890632, 58.75928798750335, 70.57513585558125, 0.50857525, 155.0, 510, 546283, 792, 11.11562210000011
793, 5.217495259304507, 58.631619052726684, 70.45298366386349, 0.5081315500000001, 80.0, 476, 546759, 793, 10.359321300000374
794, 5.485501024989645, 58.44049907152794, 70.29548333148207, 0.5073327999999993, 240.0, 1299, 548058, 794, 28.328003600000557
795, 6.699582473356444, 58.36321086711712, 70.18750434394356, 0.5064985000000001, 165.0, 555, 548613, 795, 12.199917699999787
796, 9.54433087056632, 58.57464639985443, 70.54569354998368, 0.5058406000000003, 400.0, 907, 549520, 796, 19.872466600000735
797, 5.233273804217637, 58.06788229703425, 69.80840770897264, 0.5049833499999998, 245.0, 998, 550518, 797, 21.841983600000276
798, 3.505000144411425, 57.942250486421266, 69.64258221955654, 0.5041355500000002, 310.0, 886, 551404, 798, 19.510484800000086
799, 5.303363124564798, 57.73285453427922, 69.42337769811803, 0.5034200499999997, 190.0, 704, 552108, 799, 15.465249799999583
800, 7.297508794961286, 57.75352789133165, 69.53365771123262, 0.5027153500000001, 190.0, 862, 552970, 800, 19.042769900000167
801, 7.958192944372256, 57.778911373158195, 69.47334548475828, 0.50215375, 75.0, 386, 553356, 801, 8.50663110000005
802, 7.2445239660215295, 57.878194423571024, 69.722178674724, 0.50171725, 80.0, 584, 553940, 802, 12.931874200000493
803, 6.526964359266749, 57.70075604976603, 69.37363257739199, 0.501085, 140.0, 821, 554761, 803, 18.12019599999985
804, 4.8878438041378764, 57.802806839925026, 69.47051946570787, 0.5003559999999999, 155.0, 799, 555560, 804, 17.69610769999963
805, 6.748500496833149, 57.93738705907277, 69.7383974193337, 0.49954555000000006, 335.0, 1002, 556562, 805, 22.195095799999763
806, 7.745095813091387, 57.691512618148536, 69.46191581926848, 0.49888945, 125.0, 456, 557018, 806, 10.162773300000481
807, 6.279550149739229, 57.78632194473899, 69.58156596415142, 0.49838004999999996, 145.0, 676, 557694, 807, 15.04999829999997
808, 5.504252288893115, 57.78017694365851, 69.45315046034628, 0.4977801999999996, 105.0, 657, 558351, 808, 14.587724199999684
809, 5.666763199322213, 57.62110049857602, 69.27047695438237, 0.4969603000000001, 565.0, 1165, 559516, 809, 25.879136200000175
810, 7.167753050558514, 58.10355762696602, 69.91289738310334, 0.49605265, 350.0, 852, 560368, 810, 19.02439139999933
811, 6.4913720219980835, 58.11927462733069, 69.87850432432899, 0.4954370500000001, 55.0, 516, 560884, 811, 11.645595399999365
812, 5.252962121870178, 58.3074681476689, 70.11658805569864, 0.49472199999999983, 360.0, 1073, 561957, 812, 23.996116599999368
813, 5.3102982022060425, 58.289274398039616, 70.09653575937737, 0.4939426000000001, 140.0, 659, 562616, 813, 14.721771099999387
814, 9.553763612968861, 58.253048945517435, 70.11497801759818, 0.4933994500000001, 20.0, 548, 563164, 814, 12.352229200000693
815, 7.0138162965997894, 58.13855722630985, 69.88409673154743, 0.49294629999999984, 20.0, 459, 563623, 815, 10.40260119999948
816, 9.290600235803403, 58.34007107002148, 70.29723195753236, 0.49249135, 80.0, 552, 564175, 816, 12.504471000000194
817, 5.533988554775715, 58.187571427481515, 70.00335565294539, 0.49192795, 180.0, 700, 564875, 817, 15.768032000000858
818, 10.226563203534702, 58.29030985173171, 70.1675343397187, 0.4911701499999999, 240.0, 984, 565859, 818, 22.18259070000022
819, 5.427897453904152, 58.08489281598259, 69.81558300242705, 0.4903448500000002, 210.0, 850, 566709, 819, 19.809354600000006
820, 4.693878515488511, 58.43565764820904, 70.2473135082, 0.4897171, 85.0, 545, 567254, 820, 12.802610899999308
821, 4.914439548449804, 58.271406328355944, 70.05075624033715, 0.48903895000000003, 175.0, 962, 568216, 821, 21.803219100000206
822, 5.117722295666789, 58.16642471145798, 69.92528580047272, 0.4884013000000001, 80.0, 455, 568671, 822, 10.397648000000117
823, 5.166345148056678, 58.25558243145432, 70.04186001997058, 0.4878014499999994, 240.0, 878, 569549, 823, 19.86248169999999
824, 5.361415942106824, 58.07816644759127, 69.80977814047844, 0.4871125000000001, 105.0, 653, 570202, 824, 14.839222000000518
825, 4.910864321032756, 57.64968429281425, 69.30853859502854, 0.48655269999999967, 120.0, 591, 570793, 825, 13.472809599999891
826, 7.929932168711509, 57.72379719870431, 69.55254331316267, 0.48603475, 55.0, 560, 571353, 826, 12.720447599999716
827, 6.880147599766554, 57.58465004906866, 69.31962468001643, 0.48541734999999997, 295.0, 812, 572165, 827, 18.443800799999735
828, 7.09524964147932, 57.57324518214718, 69.23566457268831, 0.4848175, 105.0, 521, 572686, 828, 12.065825599999698
829, 4.456623200593584, 57.722480118199904, 69.36595076748837, 0.4842244000000001, 185.0, 797, 573483, 829, 18.224824699999772
830, 4.722175839745012, 57.44970710008664, 69.00993784280648, 0.4835664999999997, 130.0, 665, 574148, 830, 15.189763999999741
831, 3.252846729941666, 57.45906286239624, 69.07167927026748, 0.4829792499999999, 185.0, 640, 574788, 831, 14.744718400000238
832, 4.913960895637825, 57.56228772123593, 69.20886715118078, 0.4824000999999997, 155.0, 647, 575435, 832, 14.903114699999605
833, 5.57675598528508, 57.56329252054763, 69.24078060690425, 0.4815847000000002, 220.0, 1165, 576600, 833, 26.74350500000037
834, 5.162545072507452, 57.49447154998779, 69.08531627329913, 0.48074364999999963, 225.0, 704, 577304, 834, 16.287658600000213
835, 6.237896281552602, 57.651730089302525, 69.318560211917, 0.4802400999999997, 75.0, 415, 577719, 835, 9.628433399999267
836, 3.893666027465587, 57.754759217825374, 69.45079758721839, 0.479827, 115.0, 503, 578222, 836, 11.64543169999979
837, 5.6395416987438995, 57.58456171353658, 69.24945437113443, 0.4790606499999999, 425.0, 1200, 579422, 837, 27.441106999999647
838, 5.336138905205748, 57.34439511327019, 68.95250848580523, 0.47821284999999975, 140.0, 684, 580106, 838, 15.873924599999555
839, 7.90156577161961, 56.82500869029164, 68.3661542584007, 0.4774960000000003, 140.0, 909, 581015, 839, 21.137569800000165
840, 3.9940736090867364, 56.81446939017904, 68.31849532390959, 0.47690784999999997, 105.0, 398, 581413, 840, 9.348184599999513
841, 4.173747920843422, 57.023654483315724, 68.51023728000662, 0.4763170000000001, 555.0, 915, 582328, 841, 21.11343829999987
842, 5.998445488547495, 57.02849583334766, 68.55485539145313, 0.47571355000000004, 35.0, 426, 582754, 842, 10.019057900000007
843, 5.781228243153204, 56.60871504870328, 68.03763957457109, 0.4753238499999999, 75.0, 440, 583194, 843, 10.480578100000457
844, 3.7685011135372317, 56.94248801718954, 68.42020622327013, 0.4748459500000001, 100.0, 622, 583816, 844, 14.770895200000268
845, 9.520705674123557, 56.91700327327486, 68.47818191616521, 0.47425465, 200.0, 692, 584508, 845, 16.165764800000034
846, 6.783354648073813, 56.92266433639335, 68.53255537219513, 0.47376370000000007, 50.0, 399, 584907, 846, 9.320632000000842
847, 4.320888308879664, 56.8498691223873, 68.34848257911987, 0.4730563000000003, 220.0, 1173, 586080, 847, 27.406250799999725
848, 3.4705225968204303, 56.91039020557122, 68.41517831460988, 0.47225439999999996, 135.0, 609, 586689, 848, 14.162748799999463
849, 5.0980190454788925, 56.827830444591854, 68.33903942468031, 0.47176569999999984, 155.0, 477, 587166, 849, 11.311330699999417
850, 4.111759300847208, 56.82304245487336, 68.29410829605595, 0.47120229999999985, 180.0, 775, 587941, 850, 18.313644099999692
851, 5.998256113980631, 56.99716388828006, 68.56546283635977, 0.47059390000000006, 110.0, 577, 588518, 851, 13.474781200000507
852, 4.949793941032636, 56.9989185466633, 68.47426444633858, 0.47001249999999994, 155.0, 715, 589233, 852, 16.826320999999552
853, 4.394157302468921, 56.99912848607975, 68.54528764068893, 0.4694054499999999, 185.0, 634, 589867, 853, 14.883232400000452
854, 4.4483821489090145, 57.43564445436463, 69.06339421826739, 0.4688298999999999, 105.0, 645, 590512, 854, 15.343734299999596
855, 6.542431573476643, 57.32272608280182, 68.90986379782359, 0.4683236499999998, 60.0, 480, 590992, 855, 11.366149400000722
856, 5.420182503147849, 57.54751961571829, 69.17458042417253, 0.46785565, 65.0, 560, 591552, 856, 13.342454000000544
857, 2.9901515237493546, 57.490711464827974, 69.05631742955025, 0.4673251000000002, 120.0, 619, 592171, 857, 14.622675900000104
858, 7.278056228321952, 57.48544244508486, 69.14242171210212, 0.46688004999999977, 90.0, 370, 592541, 858, 8.740916799999468
859, 3.8980024762260608, 57.559921333117366, 69.17529419140938, 0.46653805, 30.0, 390, 592931, 859, 9.401504299999942
860, 6.11003585145743, 57.46465366189858, 69.15081249338866, 0.46578924999999993, 660.0, 1274, 594205, 860, 30.096595300000445
861, 5.9100618062653885, 57.37795222482103, 68.9959375415063, 0.46475605000000025, 220.0, 1022, 595227, 861, 24.043529200001103
862, 6.081257785872158, 57.498659011783346, 69.11867861918361, 0.46381824999999977, 330.0, 1062, 596289, 862, 25.180701299999782
863, 4.925493277973078, 57.49113983995333, 69.0640160688265, 0.4630546, 95.0, 635, 596924, 863, 15.147626899999523
864, 4.4915398721425674, 57.47702879369868, 69.1297073450857, 0.46237239999999985, 445.0, 881, 597805, 864, 20.913031799998862
865, 9.74236149030582, 57.5468553367101, 69.42506941417209, 0.46179550000000014, 35.0, 401, 598206, 865, 9.664506999999503
866, 8.523240122292362, 57.54538873633847, 69.27803767364108, 0.46137069999999986, 80.0, 543, 598749, 866, 12.954141300000629
867, 7.15285581942921, 57.555781316573096, 69.18111047045144, 0.46089325000000003, 85.0, 518, 599267, 867, 12.298472800001036
868, 5.220697163813042, 57.37302194768732, 68.9558728351015, 0.4602889, 230.0, 825, 600092, 868, 19.63541140000052
869, 7.577035727626961, 56.61302371007994, 68.08527076201626, 0.4596665500000001, 100.0, 558, 600650, 869, 13.407982900000206
870, 5.50068514303291, 56.260340948240454, 67.68712958566385, 0.45922554999999987, 30.0, 422, 601072, 870, 10.164292199999181
871, 6.868005638424452, 56.48042640686035, 67.92196364960112, 0.45868914999999993, 180.0, 770, 601842, 871, 18.57921940000051
872, 7.608446344199359, 56.35808436278325, 67.85098250200794, 0.4580600500000001, 190.0, 628, 602470, 872, 15.09556799999882
873, 4.794378550040568, 56.34503324870466, 67.73315373485698, 0.4575331000000001, 15.0, 543, 603013, 873, 13.048942999999781
874, 6.128131191409551, 56.367959156525444, 67.79801859929012, 0.4568499999999995, 195.0, 975, 603988, 874, 23.52036920000137
875, 9.70907386639216, 56.38998446688876, 67.84129272781693, 0.4559617, 320.0, 999, 604987, 875, 24.054868799999895
876, 5.24284429730143, 56.241713844607226, 67.61935020526606, 0.4552111000000002, 155.0, 669, 605656, 876, 16.10301840000102
877, 6.341911328596655, 56.33197016065771, 67.73800110455716, 0.45443484999999995, 530.0, 1056, 606712, 877, 25.716534899998805
878, 5.884189544640151, 56.31153741845944, 67.7265573792857, 0.45377695, 70.0, 406, 607118, 878, 9.954888300000675
879, 5.537670135181613, 56.35160306245664, 67.78590452717077, 0.4533611500000001, 90.0, 518, 607636, 879, 12.57456220000131
880, 8.8387702289196, 56.26870904692186, 67.71301277798396, 0.4528373499999998, 175.0, 646, 608282, 880, 15.689393399999972
881, 2.452242733404526, 56.22312219246574, 67.5777786710988, 0.45238105, 80.0, 368, 608650, 881, 8.880737199999203
882, 7.4009207448740115, 56.2716345513004, 67.6893337732074, 0.45182395000000014, 205.0, 870, 609520, 882, 21.110671399999774
883, 8.799010034614628, 56.509316226677115, 68.05543186273606, 0.45115255, 135.0, 622, 610142, 883, 15.056281400000444
884, 8.844264496148172, 57.01197085488436, 68.61910550907187, 0.4503753999999999, 165.0, 1105, 611247, 884, 26.76819230000001
885, 6.0645653477866155, 57.081894778047015, 68.63454236482319, 0.44965585, 60.0, 494, 611741, 885, 12.061656199999561
886, 8.770112802439943, 57.305237633178415, 69.03467634066467, 0.4492485999999997, 95.0, 411, 612152, 886, 10.136237999999139
887, 6.020354494775177, 57.1415566851379, 68.66272784190572, 0.44871039999999984, 160.0, 785, 612937, 887, 19.17517140000018
888, 4.568155196553843, 57.07262651624695, 68.60551534336354, 0.4480777, 70.0, 621, 613558, 888, 15.127245399999083
889, 4.938104208693153, 57.238059516031235, 68.77055166901135, 0.4475237500000001, 105.0, 610, 614168, 889, 14.806927600000563
890, 5.914981885667571, 57.171772560187144, 68.78610741494327, 0.4469441499999999, 150.0, 678, 614846, 890, 16.674294100001134
891, 5.059535763357992, 57.07528680057849, 68.60738887894625, 0.4464001, 55.0, 531, 615377, 891, 13.11656320000111
892, 6.55160695903358, 57.08220756772965, 68.73799761212061, 0.4458776499999998, 55.0, 630, 616007, 892, 15.528657000000749
893, 5.928993345508217, 57.04806897951209, 68.63239837729412, 0.44534574999999993, 40.0, 552, 616559, 893, 13.579747399999178
894, 4.715970889073339, 57.167870976656175, 68.7521548099655, 0.44472205000000004, 165.0, 834, 617393, 894, 20.517703999999867
895, 5.212816922421171, 57.03091596776121, 68.53783305761672, 0.4441132000000001, 25.0, 519, 617912, 895, 12.897082299999965
896, 4.778725584048019, 57.087330393609854, 68.65306793656659, 0.44367849999999975, 75.0, 447, 618359, 896, 11.035552999999709
897, 5.118065817373814, 57.01399321603303, 68.59295496295388, 0.44320465, 110.0, 606, 618965, 897, 15.029753200000414
898, 3.879055763124506, 57.17398362141459, 68.71698444702616, 0.4423446999999999, 260.0, 1305, 620270, 898, 31.974611300000106
899, 5.3094235166502495, 57.553224817747285, 69.2043281150512, 0.4414095999999996, 265.0, 773, 621043, 899, 19.21607849999964
900, 8.671266269141556, 57.517694677943204, 69.26990141208583, 0.4407723999999999, 45.0, 643, 621686, 900, 15.912169799999901
901, 8.410946025613566, 57.65302377383495, 69.40882541579782, 0.4399907499999996, 380.0, 1094, 622780, 901, 27.04905080000026
902, 3.4163211852356503, 57.50292972729565, 69.06674923164834, 0.4391965000000001, 195.0, 671, 623451, 902, 16.655533000001014
903, 4.20532531263088, 57.63462510074853, 69.24579525286136, 0.43845400000000007, 305.0, 979, 624430, 903, 24.44977310000104
904, 4.144876246280193, 57.64060997354024, 69.24853247322127, 0.4377844000000001, 80.0, 509, 624939, 904, 12.71921089999887
905, 7.937900394402646, 57.63834193937496, 69.41768240978217, 0.43712244999999966, 305.0, 962, 625901, 905, 23.99047249999967
906, 4.233627890677829, 57.62526232497137, 69.22403527023201, 0.43645015000000015, 85.0, 532, 626433, 906, 13.36282940000092
907, 7.215823444197987, 57.80620857479539, 69.582017563739, 0.4357544499999996, 190.0, 1014, 627447, 907, 25.222029500000644
908, 8.966463174520623, 57.678834834041616, 69.46555090002562, 0.43488550000000004, 140.0, 917, 628364, 908, 23.061396799999784
909, 4.829720260483204, 57.6892221238878, 69.3327407249392, 0.4340638000000002, 285.0, 909, 629273, 909, 22.630824900001244
910, 7.367284351386703, 57.648571946070746, 69.35870723724365, 0.43342074999999997, 115.0, 520, 629793, 910, 12.951681700000336
911, 3.7377940139156722, 57.861169406345915, 69.57107698349725, 0.43288435, 160.0, 672, 630465, 911, 16.854695300000458
912, 4.8648287027027255, 57.97785942527551, 69.73946470598055, 0.43222330000000014, 185.0, 797, 631262, 912, 20.036696900000607
913, 5.106905483622967, 57.84372940895018, 69.52083345459982, 0.4316994999999998, 15.0, 367, 631629, 913, 9.307209300000977
914, 8.67756501055902, 58.08345576918835, 69.93388185755673, 0.4313152, 60.0, 487, 632116, 914, 12.29782989999876
915, 4.711173882360426, 57.9851115591574, 69.6893876965414, 0.4307608000000001, 160.0, 745, 632861, 915, 18.72900809999919
916, 7.983504295068802, 58.001184633462735, 69.82354143350432, 0.4301982999999999, 20.0, 505, 633366, 916, 12.75363809999908
917, 6.121228930588061, 57.953511200124765, 69.70904223775159, 0.42957550000000005, 215.0, 879, 634245, 917, 22.284585600000355
918, 4.949918039864972, 57.89006463192296, 69.60948229976819, 0.4288037499999995, 215.0, 836, 635081, 918, 21.156827599999815
919, 3.4434227020848516, 57.99567314762397, 69.67515195296114, 0.4281593499999999, 65.0, 596, 635677, 919, 15.020599600000423
920, 8.759065587379974, 57.8584769443, 69.67601653094931, 0.42768325, 35.0, 462, 636139, 920, 11.658500300000014
921, 3.920255441286347, 57.99442486922707, 69.68803849653764, 0.4270051000000003, 225.0, 1045, 637184, 921, 26.51317210000161
922, 4.411372944516571, 58.02579502924251, 69.74619759239165, 0.42609024999999967, 335.0, 988, 638172, 922, 24.88671929999873
923, 8.556108685463844, 57.98375693627833, 69.81016135733039, 0.42541749999999984, 85.0, 507, 638679, 923, 12.923443699999552
924, 5.892087286242302, 57.991500761450794, 69.76691456926548, 0.4248572499999999, 130.0, 738, 639417, 924, 18.729463300000134
925, 6.317850778990202, 57.79096624797286, 69.51631893658531, 0.42402790000000024, 215.0, 1105, 640522, 925, 28.301396200000454
926, 5.668522225839369, 57.54190165175846, 69.17344923087599, 0.42309009999999964, 220.0, 979, 641501, 926, 24.903989099999308
927, 8.340379925085864, 57.70358451353301, 69.43354601378834, 0.4224533500000001, 30.0, 436, 641937, 927, 11.240926200000104
928, 3.016362183710985, 57.48469914516278, 69.04378788373624, 0.4220262999999999, 85.0, 513, 642450, 928, 13.21080449999863
929, 3.6462167675328225, 57.61050380404343, 69.26087673606774, 0.4214435500000002, 195.0, 782, 643232, 929, 19.93802499999947
930, 5.650942580614771, 57.44435322171166, 69.0810946146647, 0.42090265000000004, 80.0, 420, 643652, 930, 10.799269600000116
931, 5.232112327259835, 57.51156786446259, 69.12179385390237, 0.4205210499999998, 50.0, 428, 644080, 931, 11.020167100001345
932, 3.847219451076427, 57.40875263837165, 69.02648411661355, 0.4199014000000002, 140.0, 949, 645029, 932, 24.49508539999988
933, 6.675861492635697, 57.66971987626684, 69.43166631863812, 0.41918859999999986, 120.0, 635, 645664, 933, 16.48036619999948
934, 8.747569720820131, 57.710442853560494, 69.4599782057678, 0.4185919000000001, 135.0, 691, 646355, 934, 17.722019000000728
935, 3.1214780791751875, 57.35996998967351, 68.88145390541021, 0.4180978, 55.0, 407, 646762, 935, 10.597065400001156
936, 3.982795361725111, 57.48303639110854, 69.08468775269847, 0.41765949999999974, 55.0, 567, 647329, 936, 14.648753899999065
937, 6.3897214813728995, 57.58846074211644, 69.27571205642522, 0.4170565, 220.0, 773, 648102, 937, 19.890734099999463
938, 4.461337332608444, 57.53469410487584, 69.18287250518799, 0.4163936499999999, 210.0, 700, 648802, 938, 18.097209100000327
939, 12.344353887395938, 57.7239068127266, 69.53154842368876, 0.4158595, 65.0, 487, 649289, 939, 12.674257399999988
940, 6.421588382107506, 57.42939044714902, 69.14196088249118, 0.41517775000000007, 320.0, 1028, 650317, 940, 26.599118199999793
941, 5.20048706369512, 57.08829877200543, 68.60065768453099, 0.4143799000000001, 90.0, 745, 651062, 941, 19.367194300000847
942, 5.394368324957911, 57.06020307919063, 68.59891057306687, 0.41342049999999986, 895.0, 1387, 652449, 942, 35.94199520000075
943, 7.665321039500742, 57.162797910734824, 68.7642933898597, 0.41254570000000024, 120.0, 557, 653006, 943, 14.416119999999864
944, 4.839327824640979, 57.00338627845576, 68.52593040129321, 0.4117856499999997, 210.0, 1132, 654138, 944, 29.33116719999998
945, 4.69687003199359, 56.97885432493171, 68.53689952320282, 0.4108811499999999, 255.0, 878, 655016, 945, 22.866596500000014
946, 9.437718252340952, 57.32405327125832, 68.97184221055772, 0.41018230000000006, 145.0, 675, 655691, 946, 17.584113900000375
947, 6.49271940582677, 56.97350567466334, 68.51020945498819, 0.40966479999999994, 85.0, 475, 656166, 947, 12.550294000000576
948, 6.43032089166886, 57.06011658893779, 68.58309235057031, 0.4090433499999996, 275.0, 906, 657072, 948, 23.690581400000156
949, 4.0672015255480485, 57.00093389589187, 68.53075876960978, 0.4082509, 195.0, 855, 657927, 949, 22.282343999999284
950, 3.1337830766093777, 56.94254299433258, 68.45355893244974, 0.4076240500000001, 80.0, 538, 658465, 950, 14.164535300000352
951, 4.728413152344936, 56.937795237588375, 68.41378817479664, 0.40691799999999995, 505.0, 1031, 659496, 951, 27.06678749999992
952, 6.099365294011082, 57.141584597559415, 68.7220171433461, 0.4062407500000001, 85.0, 474, 659970, 952, 12.548042799999166
953, 4.526537033570391, 56.309632087910494, 67.70518340825662, 0.4057398999999998, 55.0, 639, 660609, 953, 16.731185799999366
954, 5.617860649198294, 56.282074821472165, 67.6745231552124, 0.40522734999999993, 85.0, 500, 661109, 954, 13.282078700000056
955, 4.035014776482522, 56.420992173488784, 67.83019349680006, 0.4046446000000002, 195.0, 795, 661904, 955, 20.96328480000011
956, 6.27314672257468, 56.40418277614066, 67.84647932294284, 0.4040560000000001, 65.0, 513, 662417, 956, 13.562336999999388
957, 4.5223861045225435, 56.38242986548038, 67.73471893791024, 0.4033535499999998, 210.0, 1048, 663465, 957, 27.566591200000403
958, 5.222581043049513, 56.23377318784415, 67.58492749685264, 0.4026951999999999, 35.0, 415, 663880, 958, 10.948912500000006
959, 4.672512030996857, 56.353430544315955, 67.72843367368391, 0.401752, 575.0, 1681, 665561, 959, 44.26743069999975
960, 11.589781852815882, 56.39348881230878, 67.99022339396394, 0.4008398499999998, 75.0, 346, 665907, 960, 9.18242889999965
961, 5.039461431754127, 56.439103869191996, 67.78447665464853, 0.4004767, 110.0, 461, 666368, 961, 12.282909499999732
962, 4.035636962743734, 56.28004265903087, 67.62071286962274, 0.39978865, 325.0, 1068, 667436, 962, 28.36727249999967
963, 4.476564921962784, 56.329882139488774, 67.70112516308919, 0.39907135, 60.0, 526, 667962, 963, 14.136549599999853
964, 3.743055514010944, 56.31871297735917, 67.73446993777627, 0.39840714999999993, 200.0, 950, 668912, 964, 25.362906700000167
965, 5.088656258351219, 56.370111864235255, 67.77707204710529, 0.3977020000000001, 180.0, 617, 669529, 965, 16.55311839999922
966, 4.93353008453458, 56.03437234139297, 67.38262824978833, 0.39691, 240.0, 1143, 670672, 966, 30.26263470000049
967, 7.0027828855721515, 55.90933356331092, 67.25010220567513, 0.39611574999999993, 80.0, 622, 671294, 967, 16.537791000000652
968, 6.625949364681702, 56.02249965200765, 67.37324431970744, 0.39559690000000003, 60.0, 531, 671825, 968, 14.293614800000796
969, 4.339949254924101, 55.723200067560725, 66.96075249394626, 0.3951041499999998, 70.0, 564, 672389, 969, 15.234133500000098
970, 3.696652831012056, 55.724649458441114, 66.94850437513745, 0.39461454999999995, 65.0, 524, 672913, 970, 14.060455400000137
971, 2.9072761815978247, 55.8537607404068, 67.12725418674154, 0.3941550999999999, 55.0, 497, 673410, 971, 15.09807130000081
972, 5.0089973688883696, 55.899841648217034, 67.15868860435789, 0.3936483999999999, 165.0, 629, 674039, 972, 17.142670900000667
973, 7.967643326148391, 56.03850354088677, 67.4383190870285, 0.3931061499999998, 95.0, 576, 674615, 973, 15.573222499999247
974, 5.416163386006975, 55.94235547945272, 67.17602991636566, 0.3923375499999996, 295.0, 1132, 675747, 974, 30.31372249999913
975, 5.391252432387359, 55.95907116880511, 67.2484303464984, 0.39164634999999975, 35.0, 404, 676151, 975, 10.95396879999862
976, 3.847036768521728, 55.97211056413322, 67.24051675029185, 0.3910730499999998, 280.0, 870, 677021, 976, 23.527441800000815
977, 4.5481174378219, 55.730971871259925, 66.98700883145818, 0.39045610000000003, 130.0, 501, 677522, 977, 13.571723300001395
978, 3.710730644595271, 56.00014184798872, 67.27045267644311, 0.38980405, 250.0, 948, 678470, 978, 25.468655299999227
979, 5.965234995314866, 55.96969735895404, 67.31621455418245, 0.38890585000000016, 245.0, 1048, 679518, 979, 28.459028700001
980, 4.764202300091864, 56.0104765556228, 67.39732134107133, 0.3882744999999999, 30.0, 355, 679873, 980, 9.651634799998646
981, 7.547173090823205, 56.251106741365696, 67.68777220669368, 0.3876526000000003, 345.0, 1027, 680900, 981, 27.764279299999544
982, 5.162564257506229, 56.28867233065566, 67.59212698617219, 0.3867669999999998, 425.0, 941, 681841, 982, 25.75596630000109
983, 9.93150272144853, 56.413682836627814, 67.90211611472172, 0.38604609999999995, 135.0, 661, 682502, 983, 18.06155960000069
984, 5.687266371766977, 56.350441968893705, 67.74236571396453, 0.38539314999999974, 140.0, 790, 683292, 984, 21.564747300000818
985, 6.089035374879837, 56.27811025661892, 67.67970902506511, 0.3845314, 295.0, 1125, 684417, 985, 30.61445260000073
986, 6.737334315457402, 56.335352328899496, 67.7099616554589, 0.3834298000000002, 370.0, 1323, 685740, 986, 36.24954009999965
987, 8.297363761111871, 56.38686661222088, 67.83731087072572, 0.3825329499999998, 75.0, 670, 686410, 987, 25.802822200001174
988, 6.444974275802488, 56.330906180995555, 67.72486794035757, 0.3815749, 710.0, 1459, 687869, 988, 48.088929200001076
989, 5.687869718688172, 56.29459294607473, 67.59355791964272, 0.38068614999999995, 110.0, 516, 688385, 989, 16.54482790000111
990, 6.250303254028162, 56.36452152993944, 67.78999469545153, 0.3801299500000001, 150.0, 720, 689105, 990, 23.535688899999514
991, 7.578595619520522, 56.325685575190974, 67.78154152585452, 0.37940050000000014, 90.0, 901, 690006, 991, 28.68463520000114
992, 4.835146565716596, 56.05909600047945, 67.3756082282876, 0.37870885000000004, 75.0, 636, 690642, 992, 20.384121199998845
993, 6.552549598709717, 56.127452005911906, 67.43260336365124, 0.37813194999999994, 35.0, 646, 691288, 993, 20.814114300001165
994, 5.637106196482021, 56.29389200944167, 67.6407146197099, 0.37737324999999994, 225.0, 1040, 692328, 994, 34.57795020000049
995, 7.184823921589709, 56.29516300182438, 67.67295221357203, 0.37645300000000026, 470.0, 1005, 693333, 995, 32.27196999999978
996, 6.6283538735488, 56.30862094812226, 67.6716657136616, 0.37574424999999995, 90.0, 570, 693903, 996, 18.694444200000362
997, 7.74385776548638, 56.304069161057114, 67.71432471633315, 0.37488835000000026, 240.0, 1332, 695235, 997, 43.30166620000091
998, 6.175568769237509, 56.274955138453734, 67.64219617137202, 0.37380294999999997, 340.0, 1080, 696315, 998, 34.73989999999867
999, 3.7450775052433984, 56.22636040749698, 67.48372337838408, 0.37315809999999994, 85.0, 353, 696668, 999, 11.4609674000003
1000, 8.689484282953924, 56.35949480448084, 67.77895253973678, 0.37268559999999984, 145.0, 697, 697365, 1000, 22.48045270000148
1001, 5.9507668065646335, 56.26829506606652, 67.69462648018327, 0.3719467, 195.0, 945, 698310, 1001, 32.07669619999979
1002, 4.41713392607567, 56.154205573157526, 67.45992097726317, 0.3712203999999999, 75.0, 669, 698979, 1002, 21.67064190000019
1003, 9.931798713592192, 56.3926716397206, 67.87718019882838, 0.37057375, 165.0, 768, 699747, 1003, 25.991164600000047
1004, 3.667430682809001, 56.285668159598735, 67.53623826389091, 0.36995679999999986, 90.0, 603, 700350, 1004, 20.02108279999993
1005, 7.226504618382973, 56.35112261363797, 67.78515635051903, 0.3693439000000001, 120.0, 759, 701109, 1005, 24.64057270000012
1006, 7.030901871303649, 56.281267309133845, 67.67411011340572, 0.36861219999999983, 360.0, 867, 701976, 1006, 28.278744299999744
1007, 5.030463263361144, 56.335543432155575, 67.78693377070066, 0.36800785, 105.0, 476, 702452, 1007, 15.665070600000035
1008, 6.7086349807417225, 56.42251857973715, 67.84506343006174, 0.36749980000000004, 150.0, 653, 703105, 1008, 21.634235399998943
1009, 4.66985922192668, 56.26404632820381, 67.63229564861493, 0.36690624999999993, 155.0, 666, 703771, 1009, 23.55168969999977
1010, 6.508941786598112, 56.398805395312394, 67.82327482119835, 0.3660021999999999, 340.0, 1343, 705114, 1010, 46.42677399999957
1011, 5.875893076201399, 56.5818765971475, 68.01607898552261, 0.3650220999999999, 385.0, 835, 705949, 1011, 30.07542099999955
1012, 5.032280908055501, 56.43890085612258, 67.79014057873592, 0.3642521499999997, 265.0, 876, 706825, 1012, 30.525158100001136
1013, 5.627871598068037, 56.30545895081714, 67.64590365187566, 0.3636185499999999, 85.0, 532, 707357, 1013, 17.720332099999723
1014, 4.004832494207694, 56.449339429840784, 67.80915663624538, 0.36314335, 35.0, 524, 707881, 1014, 16.990719499999614
1015, 3.5639615261567648, 56.4442587498729, 67.84840977269502, 0.3627001, 140.0, 461, 708342, 1015, 15.443238399999245
1016, 5.101194816052831, 56.49982667397991, 67.8833197412979, 0.36184194999999986, 445.0, 1446, 709788, 1016, 54.12868239999989
1017, 4.050192899221465, 56.72359056018648, 68.16323810759044, 0.36090774999999997, 110.0, 630, 710418, 1017, 21.100293299999976
1018, 9.151088755954172, 57.01171587128, 68.60568846869714, 0.36040599999999995, 100.0, 485, 710903, 1018, 18.67271989999972
1019, 5.322318897307294, 57.12194676909057, 68.69070939357925, 0.35983, 125.0, 795, 711698, 1019, 26.9645232999992
1020, 5.064211466887711, 57.295231653200226, 68.85492776220194, 0.35927829999999983, 55.0, 431, 712129, 1020, 15.44431540000005
1021, 5.7517050874814615, 56.951443336226724, 68.44572622125798, 0.35860914999999965, 160.0, 1056, 713185, 1021, 35.854853300001196
1022, 5.849138193975051, 57.107153432437784, 68.58796552956676, 0.35785225, 95.0, 626, 713811, 1022, 21.33216159999938
1023, 10.020960687132348, 57.22979498367163, 68.9175983436277, 0.3573360999999999, 75.0, 521, 714332, 1023, 17.677456999999777
1024, 8.726207821402486, 57.16416070875536, 68.77010200379975, 0.35673130000000003, 100.0, 823, 715155, 1024, 28.022647400001006
1025, 7.691897216576269, 57.045241695710985, 68.57343342222016, 0.35596944999999985, 165.0, 870, 716025, 1025, 29.619149399999515
1026, 6.852967767046924, 57.096554858676775, 68.68271017747645, 0.3551635, 190.0, 921, 716946, 1026, 31.044315499999357
1027, 6.734697812819978, 57.152428829518506, 68.68717230642773, 0.35425314999999974, 380.0, 1102, 718048, 1027, 37.51445969999986
1028, 8.691983341370758, 57.29677804244192, 68.9223652608771, 0.35332975000000005, 130.0, 950, 718998, 1028, 33.16283099999964
1029, 7.606756509735869, 57.02612401683597, 68.57695966427421, 0.35266509999999995, 50.0, 527, 719525, 1029, 17.526120299999093
1030, 5.141114610959502, 57.05763768540014, 68.55647098316865, 0.3522519999999999, 55.0, 391, 719916, 1030, 12.845522700001311
1031, 5.551499495456788, 56.751733927303256, 68.19759704607443, 0.35168589999999983, 200.0, 867, 720783, 1031, 29.48897500000021
1032, 3.5689811644166016, 56.869653790496116, 68.35530324314915, 0.35114095, 5.0, 344, 721127, 1032, 11.734697200001392
1033, 4.10919846653185, 56.914069538809485, 68.32746405096792, 0.3507013000000001, 130.0, 633, 721760, 1033, 21.858687999998438
1034, 6.135197180911364, 57.09493970454722, 68.64741799163079, 0.3499524999999998, 430.0, 1031, 722791, 1034, 35.22554350000064
1035, 7.144715431335904, 57.177494218802956, 68.77393420837878, 0.34908399999999995, 210.0, 899, 723690, 1035, 30.722382500000094
1036, 5.346631933559792, 56.932310287694015, 68.34907107362962, 0.3482393500000001, 325.0, 978, 724668, 1036, 40.81260939999993
1037, 5.839912846604198, 56.96532837407165, 68.5080461964359, 0.34754860000000004, 30.0, 557, 725225, 1037, 19.864838999999847
1038, 3.9346666828869217, 56.98624526545373, 68.48227849557249, 0.3470914, 45.0, 459, 725684, 1038, 15.34727219999877
1039, 7.134646798340547, 57.063070665888425, 68.57491217006822, 0.34672419999999987, 10.0, 357, 726041, 1039, 11.826279499999146
1040, 4.535994168173973, 57.07551679151739, 68.58331456615838, 0.34618059999999995, 275.0, 851, 726892, 1040, 28.29365719999987
1041, 5.91419084135208, 57.030074878497885, 68.52511635628548, 0.34549794999999994, 115.0, 666, 727558, 1041, 22.74671760000092
1042, 4.506996455690092, 57.014922427342945, 68.49293112006069, 0.344926, 150.0, 605, 728163, 1042, 22.20268279999982
1043, 10.279551295794048, 56.9954519678081, 68.53034592448577, 0.3444318999999999, 120.0, 493, 728656, 1043, 21.059949100001177
1044, 7.6959720433161065, 56.90617167498614, 68.49339741887273, 0.34404355, 95.0, 370, 729026, 1044, 12.890568800001347
1045, 8.519780828240549, 57.13250546228318, 68.7153068270002, 0.3435746500000001, 155.0, 672, 729698, 1045, 24.241505699999834
1046, 3.7456993177744726, 56.851752507517354, 68.26816493067248, 0.3430503999999999, 45.0, 493, 730191, 1046, 17.794136900000012
1047, 5.871899008448625, 56.696102306211195, 68.13384312377056, 0.34245144999999994, 515.0, 838, 731029, 1047, 29.02895989999888
1048, 4.219001448336075, 56.50205290708129, 67.85754025560531, 0.34173099999999984, 130.0, 763, 731792, 1048, 29.669663200000286
1049, 5.544438316472399, 56.544442322405494, 68.0325105644213, 0.34112529999999985, 100.0, 583, 732375, 1049, 21.608122800000274
1050, 5.018192118756777, 56.58578045234416, 68.02103662160981, 0.3402774999999997, 420.0, 1301, 733676, 1050, 46.78211940000074
1051, 3.438688001302007, 56.649514227044094, 68.07050854408578, 0.33936355000000007, 160.0, 730, 734406, 1051, 25.308407099999386
1052, 4.798777488282039, 56.52688725789388, 67.99407261326199, 0.33873265000000014, 185.0, 672, 735078, 1052, 27.024328499999683
1053, 3.6508903024714, 56.73814614827201, 68.14533052721814, 0.3380279500000001, 375.0, 894, 735972, 1053, 29.24640619999991
1054, 8.904605946257336, 56.7006346788505, 68.23070206635107, 0.33732100000000004, 120.0, 677, 736649, 1054, 22.023192499998913
1055, 10.006120280359902, 56.68164690170514, 68.25730148338069, 0.33671304999999996, 175.0, 674, 737323, 1055, 21.941771400001016
1056, 7.096909635197774, 56.63056942598997, 68.07850649717042, 0.3360344499999999, 455.0, 834, 738157, 1056, 27.056926500001282
1057, 5.492479509141631, 56.697435240977974, 68.174541428311, 0.3353544999999999, 90.0, 677, 738834, 1057, 22.04619939999975
1058, 9.46138197624266, 56.61844449470016, 68.11837658715156, 0.3348185499999998, 35.0, 514, 739348, 1058, 16.611988399999973
1059, 5.122982118228019, 56.05802484936505, 67.34445562954208, 0.3339923500000001, 360.0, 1322, 740670, 1059, 42.73437340000055
1060, 5.7090526701941124, 55.55794287228334, 66.77356141760967, 0.3330973000000001, 70.0, 667, 741337, 1060, 23.35625649999929
1061, 6.009853268834211, 55.533409993646366, 66.74090423999002, 0.3323008, 220.0, 1103, 742440, 1061, 39.042890499998975
1062, 6.354057010897698, 55.46281936799897, 66.67866001482959, 0.3315376, 145.0, 593, 743033, 1062, 20.88425190000089
1063, 4.617226379400386, 55.520231472755256, 66.66274454131235, 0.3309134500000001, 140.0, 794, 743827, 1063, 27.864917000000787
1064, 5.553798779822796, 55.369293471416796, 66.54711349900947, 0.33025735000000006, 125.0, 664, 744491, 1064, 23.84407680000004
1065, 6.120550202236995, 55.576955369064926, 66.83994033216764, 0.32963635000000013, 135.0, 716, 745207, 1065, 25.285280300000522
1066, 5.257950460654683, 55.555584927399956, 66.73369878530502, 0.3291413499999999, 35.0, 384, 745591, 1066, 13.597063600000183
1067, 3.864119387649735, 55.49310358143386, 66.64513053396783, 0.3287268999999999, 150.0, 537, 746128, 1067, 19.171985700000732
1068, 11.643037257642726, 55.76910886238879, 66.9137009147584, 0.32802805000000007, 230.0, 1016, 747144, 1068, 35.93362049999996
1069, 8.932778106587273, 55.37487760271345, 66.51068062191918, 0.3273345999999999, 75.0, 525, 747669, 1069, 18.733609000000797
1070, 6.68814870036424, 55.5537171951712, 66.77701711001461, 0.32683555000000014, 45.0, 584, 748253, 1070, 20.716171400001258
1071, 7.254479709925589, 55.551829826057734, 66.79253791709999, 0.32639949999999995, 45.0, 385, 748638, 1071, 13.768648600000233
1072, 5.329615376881399, 55.54570621418182, 66.74367368819323, 0.3258226000000001, 425.0, 897, 749535, 1072, 31.970834900001137
1073, 6.71586332987994, 55.60577449798584, 66.82877346992493, 0.32523894999999997, 65.0, 400, 749935, 1073, 14.411859200001345
1074, 6.071608644477757, 55.480693536145345, 66.70101201534271, 0.3248573499999998, 85.0, 448, 750383, 1074, 16.05069040000126
1075, 6.1726106424790785, 55.55615966899975, 66.7855951566954, 0.3243227499999999, 145.0, 740, 751123, 1075, 26.404898500000854
1076, 7.825138469269167, 55.62147973088308, 66.93377344176318, 0.3236643999999999, 135.0, 723, 751846, 1076, 25.816679999999906
1077, 4.359592426606517, 55.48851880302664, 66.65067227812028, 0.32311990000000007, 80.0, 487, 752333, 1077, 17.34157939999932
1078, 8.912578227758408, 55.75421428426107, 66.97596005249024, 0.3227319999999999, 50.0, 375, 752708, 1078, 13.508238400001574
1079, 9.451940834867068, 55.67105035072516, 66.98766765121586, 0.32229099999999994, 100.0, 605, 753313, 1079, 21.637191699999676
1080, 5.240788444078091, 55.61530942492773, 66.82894411598127, 0.32162409999999997, 460.0, 877, 754190, 1080, 31.298545199999353
1081, 4.362079572291215, 55.61466251319425, 66.80167771854816, 0.3208788999999999, 210.0, 779, 754969, 1081, 27.966564700000163
1082, 5.494422158363618, 55.47419144479852, 66.68919698815597, 0.32035734999999993, 60.0, 380, 755349, 1082, 13.813712200000737
1083, 5.24837597381255, 55.55573926535097, 66.77134235915229, 0.319771, 210.0, 923, 756272, 1083, 33.13145500000064
1084, 5.727322020093722, 55.706306796863764, 66.9443325206546, 0.31906225000000005, 90.0, 652, 756924, 1084, 23.28659399999924
1085, 3.7698518537682264, 55.64337360212956, 66.80597190669017, 0.3185861499999998, 135.0, 406, 757330, 1085, 14.77316989999963
1086, 4.926673173992958, 55.66195617285925, 66.87540256955832, 0.31764609999999993, 800.0, 1683, 759013, 1086, 60.19584880000002
1087, 6.512257174269644, 55.709846185920696, 67.01755780606959, 0.31627539999999976, 520.0, 1363, 760376, 1087, 49.01338620000024
1088, 5.428789700976745, 55.7884464208416, 67.03699570368148, 0.3151980999999998, 250.0, 1031, 761407, 1088, 37.32468460000018
1089, 6.334616086996385, 55.670122092906325, 66.87393968918276, 0.31430259999999993, 375.0, 959, 762366, 1089, 34.52661799999987
1090, 4.9440601296080855, 55.79814809214376, 67.03758325366553, 0.31364649999999983, 60.0, 499, 762865, 1090, 18.02484700000059
1091, 6.128800916539083, 55.844509385696064, 67.09641935201473, 0.3130075, 160.0, 921, 763786, 1091, 33.51571510000031
1092, 3.502592355857494, 55.75819782303412, 66.94912522814052, 0.3123707499999999, 65.0, 494, 764280, 1092, 18.082263199999943
1093, 6.61933927078667, 55.74384890862231, 66.9539599568589, 0.3115760500000001, 525.0, 1272, 765552, 1093, 46.08947790000093
1094, 3.5614052595348533, 55.532959831307785, 66.69691568077157, 0.3107583999999998, 80.0, 545, 766097, 1094, 20.14526029999979
1095, 3.7291901022568346, 55.70131248792013, 66.92769455273947, 0.30997315000000003, 555.0, 1200, 767297, 1095, 43.78060840000035
1096, 5.217637725885619, 55.9343731620095, 67.2694996400313, 0.3090371500000001, 165.0, 880, 768177, 1096, 32.092394699999204
1097, 5.310273863077164, 55.731787251790365, 66.96199585978191, 0.3084723999999999, 55.0, 375, 768552, 1097, 13.823461199999656
1098, 6.018675561032949, 55.72597694396973, 66.96201575846166, 0.3079130499999999, 270.0, 868, 769420, 1098, 31.833693200000198
1099, 3.0049276576647834, 55.87214110743615, 67.09700834366583, 0.30729924999999986, 45.0, 496, 769916, 1099, 18.164641600000323
1100, 7.0747073220217445, 56.71809980067858, 68.16944105145633, 0.3067560999999999, 165.0, 711, 770627, 1100, 26.248583699998562
1101, 6.080462266300881, 56.81664538705671, 68.27641887922545, 0.30590335, 430.0, 1184, 771811, 1101, 43.21111259999998
1102, 7.374685568932014, 57.00133556586046, 68.51095326130206, 0.30499614999999997, 325.0, 832, 772643, 1102, 30.60804310000094
1103, 4.034753255005515, 56.85900387327754, 68.24942062931483, 0.3043364500000001, 95.0, 634, 773277, 1103, 23.191232900000614
1104, 5.074216924534565, 56.76603168120319, 68.21828817431256, 0.3038220999999998, 175.0, 509, 773786, 1104, 18.93818250000004
1105, 3.7834111318659427, 56.99464341538462, 68.48433007766951, 0.30341215, 45.0, 402, 774188, 1105, 14.86924689999978
1106, 11.563101493479575, 57.00361652234022, 68.72554880030015, 0.30298644999999996, 150.0, 544, 774732, 1106, 20.015045899999677
1107, 5.1959716640540385, 56.88296421913252, 68.29739954373608, 0.30221604999999974, 215.0, 1168, 775900, 1107, 43.75983729999825
1108, 3.9001743178662225, 56.991809901161005, 68.45728748402696, 0.30141550000000006, 155.0, 611, 776511, 1108, 22.764334299999973
1109, 6.5497391253749315, 56.981192409201704, 68.49906778715017, 0.30080124999999996, 125.0, 754, 777265, 1109, 28.10122279999996
1110, 3.6469597444156108, 57.00186479579636, 68.47631365235088, 0.30015415, 120.0, 684, 777949, 1110, 25.44404570000006
1111, 4.168355620429595, 56.82225391007622, 68.20374212236203, 0.29954844999999986, 125.0, 662, 778611, 1111, 24.841143899999224
1112, 3.642449386607287, 56.80684465472981, 68.19431432627015, 0.29882575000000006, 250.0, 944, 779555, 1112, 37.512749299999996
1113, 4.63279984729674, 57.45065724662852, 69.02368002924426, 0.29782675000000014, 330.0, 1276, 780831, 1113, 47.64425029999984
1114, 5.460790315816286, 57.82183441207187, 69.41932108553685, 0.29694789999999993, 135.0, 677, 781508, 1114, 25.476158499999656
1115, 5.407617496168159, 57.88939377010043, 69.56486703643351, 0.2964897999999999, 80.0, 341, 781849, 1115, 12.953460099999575
1116, 4.593492528823833, 57.77642384194517, 69.43679411002252, 0.2960451999999998, 165.0, 647, 782496, 1116, 24.31427099999928
1117, 6.822856128686127, 57.76140878532333, 69.4526934958941, 0.2954403999999999, 95.0, 697, 783193, 1117, 26.738084799999342
1118, 3.6148253264016983, 57.67387700119388, 69.29353592584515, 0.2948481999999999, 115.0, 619, 783812, 1118, 23.373221100000592
1119, 13.54735422320664, 57.74572945477669, 69.39364189850657, 0.29436444999999994, 25.0, 456, 784268, 1119, 17.295298600000024
1120, 8.115991899940653, 57.69414200366981, 69.22715740876207, 0.2939167, 120.0, 539, 784807, 1120, 20.341751800000566
1121, 7.596237392367788, 57.71115708598629, 69.33040634736058, 0.29315395, 595.0, 1156, 785963, 1121, 43.95335630000045
1122, 7.739231012958897, 57.63706818685255, 69.33385581537273, 0.2922769000000001, 110.0, 793, 786756, 1122, 29.941356799999994
1123, 7.255607644443618, 57.75897743763977, 69.47118394419164, 0.2913147999999999, 460.0, 1345, 788101, 1123, 51.17386709999846
1124, 6.121826507683311, 57.71548302968343, 69.40499786346678, 0.29048274999999985, 75.0, 504, 788605, 1124, 18.946306199999526
1125, 8.033333160598794, 57.694996528446396, 69.3785560178085, 0.2897766999999998, 225.0, 1065, 789670, 1125, 41.30292709999958
1126, 5.379629377929403, 57.73905209305423, 69.36027863565005, 0.28887175000000004, 310.0, 946, 790616, 1126, 35.550837599999795
1127, 6.726555783053862, 57.88869439463693, 69.53859441223527, 0.28808740000000005, 175.0, 797, 791413, 1127, 30.650663899999927
1128, 5.396951352131854, 57.77615148929563, 69.37709904307917, 0.2873656000000001, 270.0, 807, 792220, 1128, 30.922471099998802
1129, 4.04928795915889, 57.765690871111055, 69.3693262715978, 0.2867167000000001, 135.0, 635, 792855, 1129, 24.20209199999954
1130, 8.281840338159657, 57.76657308422544, 69.47201649887757, 0.2860732, 245.0, 795, 793650, 1130, 30.244886000000406
1131, 7.8383944157256655, 57.69124567269321, 69.41055935166447, 0.28549134999999987, 60.0, 498, 794148, 1131, 18.931511599999794
1132, 8.427164696675222, 57.785655186212914, 69.51284822431252, 0.2847691, 355.0, 1107, 795255, 1132, 42.26382770000055
1133, 5.845554613355029, 57.50450671473636, 69.1105979062334, 0.28398654999999995, 80.0, 632, 795887, 1133, 24.273951399998623
1134, 4.583949922039958, 57.78385370624116, 69.4373389625819, 0.2833839999999999, 145.0, 707, 796594, 1134, 27.216929700000037
1135, 8.745682195835823, 57.79904060457497, 69.47985787356515, 0.2826995499999998, 140.0, 814, 797408, 1135, 31.251475499999287
1136, 3.658334949646166, 57.85901947450906, 69.45360065624817, 0.2820933999999999, 50.0, 533, 797941, 1136, 20.588126900000134
1137, 4.592671526646292, 57.74935729224403, 69.40704805643351, 0.28155384999999994, 110.0, 666, 798607, 1137, 25.85302589999992
1138, 7.122273044529157, 57.91164333890946, 69.64273945454313, 0.28105659999999993, 40.0, 439, 799046, 1138, 16.948007699998925
1139, 5.084357505338856, 57.744038260737554, 69.36533250929435, 0.28050354999999993, 230.0, 790, 799836, 1139, 30.46087389999957
1140, 3.3081675425207586, 57.321744095507285, 68.86235214709092, 0.2797727499999999, 410.0, 834, 800670, 1140, 32.19074189999992
1141, 6.670944905263964, 57.57350362287875, 69.19725100108164, 0.27908380000000005, 150.0, 697, 801367, 1141, 26.781444199999896
1142, 5.344063723030834, 57.44332675544583, 69.02191402891287, 0.27846144999999983, 70.0, 686, 802053, 1142, 26.65651809999872
1143, 3.7537727222842134, 57.56144243273242, 69.16375127743031, 0.27773515, 380.0, 928, 802981, 1143, 36.32426060000034
1144, 5.272269822515905, 57.52990181709213, 69.12781959712306, 0.27691389999999994, 245.0, 897, 803878, 1144, 35.12371799999892
1145, 7.501787889272996, 57.358074509094806, 68.96028733179206, 0.27622135000000003, 115.0, 642, 804520, 1145, 25.143927499999336
1146, 3.375974151161565, 57.49409621198412, 69.04688110485883, 0.2756768499999998, 165.0, 568, 805088, 1146, 23.795937999999296
1147, 6.778280346764204, 57.314995922186434, 68.91604174100436, 0.27507024999999985, 95.0, 780, 805868, 1147, 31.515980499998477
1148, 9.151464323445063, 57.61305827112379, 69.29893416117847, 0.27455319999999994, 50.0, 369, 806237, 1148, 14.333295799999178
1149, 7.220376619905756, 57.433861721328825, 69.00691757982935, 0.27407935000000005, 110.0, 684, 806921, 1149, 26.765927000000374
1150, 4.275889995862061, 57.31862946631203, 68.8900548430489, 0.27348399999999995, 130.0, 639, 807560, 1150, 24.991803900000377
1151, 4.776080349483086, 57.52051916303177, 69.07288198566756, 0.2727927999999999, 315.0, 897, 808457, 1151, 39.98044219999974
1152, 3.54202191561192, 57.683656015482036, 69.24792111371015, 0.27213939999999986, 95.0, 555, 809012, 1152, 22.044512100001157
1153, 5.523149013558813, 57.410209139715136, 68.95159384932379, 0.27172, 85.0, 377, 809389, 1153, 14.74041380000017
1154, 5.229554427017286, 57.281111893144626, 68.84223698736395, 0.2713186, 140.0, 515, 809904, 1154, 20.561294000001
1155, 4.638169037082146, 57.54729883449594, 69.12219840964092, 0.27091224999999997, 55.0, 388, 810292, 1155, 16.52750659999947
1156, 5.474246470426971, 57.51538838236785, 69.14163675387043, 0.27030204999999996, 215.0, 968, 811260, 1156, 38.08288410000023
1157, 6.963152538921061, 57.48018843114632, 69.08068482967917, 0.26944704999999985, 365.0, 932, 812192, 1157, 38.43579320000026
1158, 6.827755736415846, 57.496402673554, 69.1038664223855, 0.2686172499999999, 230.0, 912, 813104, 1158, 41.49932460000127
1159, 5.745836958861453, 57.388491694313366, 68.97068038332682, 0.2678904999999999, 310.0, 703, 813807, 1159, 30.763878699999623
1160, 8.349885439854598, 57.58179783929973, 69.28387435495037, 0.26727849999999986, 120.0, 657, 814464, 1160, 24.617117199999484
1161, 5.588946990306313, 57.47847063219225, 69.04537853550266, 0.26681635, 80.0, 370, 814834, 1161, 14.117562299999918
1162, 7.140458357291256, 57.546948434294556, 69.12944974281805, 0.2663371000000001, 145.0, 695, 815529, 1162, 25.19997239999975
1163, 9.110154433597508, 57.66994141158744, 69.41127664071543, 0.26580564999999984, 120.0, 486, 816015, 1163, 17.33410250000088
1164, 5.225697736994327, 57.35204971503027, 68.88786080559835, 0.2653696, 85.0, 483, 816498, 1164, 17.27603150000141
1165, 5.85093757225262, 57.663060576051144, 69.29024470402645, 0.26474274999999997, 105.0, 910, 817408, 1165, 32.79446520000056
1166, 5.586050149916656, 57.518047241937545, 69.10951271662637, 0.26376625, 920.0, 1260, 818668, 1166, 45.10240460000023
1167, 5.200892708580941, 57.58456864833832, 69.17779462814332, 0.26283925, 95.0, 800, 819468, 1167, 29.79340829999819
1168, 10.045698020650052, 57.49933164421169, 69.2256985697253, 0.26216605, 90.0, 696, 820164, 1168, 27.929125399999975
1169, 7.750541599273448, 56.78549428913588, 68.27134199086247, 0.26139474999999995, 265.0, 1018, 821182, 1169, 37.505489999999554
1170, 5.403199906838504, 56.7889778871794, 68.1682454637579, 0.26067025, 35.0, 592, 821774, 1170, 21.518680600000152
1171, 6.995388092086338, 56.89418335692189, 68.4184981093239, 0.26012214999999994, 45.0, 626, 822400, 1171, 24.231244600001446
1172, 7.3796979736491854, 56.955817142164854, 68.42985942181814, 0.2596163499999999, 45.0, 498, 822898, 1172, 18.449796999999307
1173, 6.328210633791902, 56.71539871458264, 68.16673529207291, 0.2589390999999998, 240.0, 1007, 823905, 1173, 36.66369599999962
1174, 6.064801738806034, 56.71780995311825, 68.13681225403113, 0.2579977, 385.0, 1085, 824990, 1174, 39.19589239999914
1175, 7.310837106006391, 56.75919209250921, 68.23277618311629, 0.25686955000000017, 385.0, 1422, 826412, 1175, 52.84785290000036
1176, 8.848611077229924, 56.8316337371541, 68.33413266095788, 0.25594074999999983, 110.0, 642, 827054, 1176, 24.22183639999821
1177, 6.706813381524324, 56.85705062120163, 68.31219586587041, 0.25516405000000003, 190.0, 1084, 828138, 1177, 39.50200330000007
1178, 7.204907132447219, 56.97425511943977, 68.52533528288055, 0.25420285, 300.0, 1052, 829190, 1178, 37.6694066
1179, 8.06271545583239, 56.76196291263287, 68.25678327266986, 0.25349544999999996, 75.0, 520, 829710, 1179, 18.72406840000076
1180, 5.917261646403743, 56.30215920832345, 67.60013387014871, 0.25302790000000003, 80.0, 519, 830229, 1180, 18.775542100000166
1181, 3.6541795351067368, 55.87362283200634, 67.10449618125449, 0.2525738499999999, 25.0, 490, 830719, 1181, 17.863312600000427
1182, 6.410327809474644, 56.250981819047794, 67.61271721430505, 0.25199379999999993, 130.0, 799, 831518, 1182, 29.020475699999224
1183, 4.16494005930677, 56.19378682055505, 67.46644504397523, 0.25135884999999997, 180.0, 612, 832130, 1183, 22.67023440000048
1184, 4.961198096705037, 56.223218378170515, 67.46118233555048, 0.25085125, 110.0, 516, 832646, 1184, 18.999178799998845
1185, 5.599611626923694, 56.05117472480325, 67.36194883283142, 0.25026714999999994, 210.0, 782, 833428, 1185, 28.863480199999685
1186, 5.998508453384238, 56.131150648586654, 67.47283592726563, 0.2494711, 490.0, 987, 834415, 1186, 36.20296899999994
1187, 7.517556702621238, 56.12712083937805, 67.43216594519643, 0.24871554999999998, 180.0, 692, 835107, 1187, 25.432788500000242
1188, 7.014058115950041, 56.09690367776241, 67.46939023639978, 0.2481220000000001, 120.0, 627, 835734, 1188, 22.906969800000297
1189, 5.33440037597954, 56.23901084275937, 67.58706468631787, 0.24759774999999987, 50.0, 538, 836272, 1189, 20.239115700000184
1190, 5.7956346992551975, 56.10628997193632, 67.42632242942662, 0.246916, 305.0, 977, 837249, 1190, 35.74799460000031
1191, 7.30992890330565, 56.18311570133995, 67.59108601095689, 0.24602859999999993, 250.0, 995, 838244, 1191, 36.88830649999909
1192, 5.1821254783497315, 56.13246080220252, 67.44516226072375, 0.24510429999999997, 230.0, 1059, 839303, 1192, 39.8452484999998
1193, 4.86156294973365, 55.9287634035709, 67.13698281057886, 0.24416739999999992, 410.0, 1023, 840326, 1193, 38.53309679999984
1194, 5.361689567801509, 55.78248675098846, 66.99231955185238, 0.2433654999999998, 300.0, 759, 841085, 1194, 27.973549000000276
1195, 5.54517440978639, 56.095468340693294, 67.4161005793391, 0.24275754999999988, 170.0, 592, 841677, 1195, 22.134022500000356
1196, 13.473738662015073, 56.16986760226163, 67.65266496861877, 0.24226345000000005, 100.0, 506, 842183, 1196, 18.833312200000364
1197, 5.121519110176848, 55.82950323313354, 67.01341447946031, 0.24159115000000003, 215.0, 988, 843171, 1197, 36.90189819999978
1198, 5.713321166035409, 55.80531292160352, 67.07002417246501, 0.24097374999999988, 85.0, 384, 843555, 1198, 14.153755600000295
1199, 3.9536270296573637, 56.14677104404994, 67.33339937482562, 0.24064344999999987, 25.0, 350, 843905, 1199, 13.016224599999987
1200, 6.258581740137998, 55.99326837755489, 67.33531484108087, 0.24033879999999996, 25.0, 327, 844232, 1200, 12.134767400000783
1201, 6.3081751479118156, 55.84784874193596, 67.06947586175167, 0.23989464999999985, 115.0, 660, 844892, 1201, 24.73699889999989
1202, 9.289930951892067, 55.79221280146454, 67.04986751685708, 0.2391728499999999, 225.0, 944, 845836, 1202, 35.27558669999962
1203, 8.389683465253222, 55.875566910252424, 67.15690941748682, 0.23822829999999995, 430.0, 1155, 846991, 1203, 42.81747539999924
1204, 5.19423716430688, 55.80968035213911, 67.01550503831413, 0.23726079999999986, 230.0, 995, 847986, 1204, 40.211136399999305
1205, 5.661215045595099, 55.93349578044022, 67.16874628170575, 0.23635719999999988, 290.0, 1013, 848999, 1205, 37.94839729999876
1206, 6.7637412503646654, 56.037764181302286, 67.3479997873038, 0.23550130000000005, 330.0, 889, 849888, 1206, 34.799612899998465
1207, 6.100407112607338, 56.67221135466638, 68.15577349697587, 0.23485464999999997, 140.0, 548, 850436, 1207, 22.47020799999882
1208, 7.143225741652349, 56.81904622305811, 68.2454263917816, 0.23399785, 505.0, 1356, 851792, 1208, 53.41972739999983
1209, 5.051363123349307, 56.66243446095991, 68.01688037627504, 0.23283369999999995, 360.0, 1231, 853023, 1209, 51.901012599999376
1210, 5.857749594116061, 56.595356930776006, 67.97136177218204, 0.23199219999999995, 145.0, 639, 853662, 1210, 25.320861199998035
1211, 7.617359125720603, 56.784053056759944, 68.22755288719235, 0.23146524999999987, 80.0, 532, 854194, 1211, 21.36607390000063
1212, 6.564569208554683, 56.81836934243479, 68.23880377738706, 0.23094684999999995, 325.0, 620, 854814, 1212, 24.483143699999346
1213, 6.481067052387982, 56.797955715969074, 68.24466566302686, 0.23035914999999996, 85.0, 686, 855500, 1213, 27.128813700001047
1214, 3.46659465067074, 56.68550319634305, 68.03169255713894, 0.22982049999999996, 45.0, 511, 856011, 1214, 20.132575200001156
1215, 5.0985595311075285, 56.64958641783157, 67.96952465045054, 0.22917249999999992, 135.0, 929, 856940, 1215, 36.39836290000312
1216, 6.224437195802774, 56.75196539048632, 68.16620738282701, 0.22841379999999994, 225.0, 757, 857697, 1216, 29.96180110000205
1217, 4.142915664528318, 56.633823493601746, 67.97895384081905, 0.2276389, 290.0, 965, 858662, 1217, 39.18259670000043
1218, 4.098870517835739, 56.78763536164998, 68.19519198745776, 0.2270647, 30.0, 311, 858973, 1218, 13.921288599998661
1219, 7.018258073333265, 56.598035593326685, 67.97768683838689, 0.22644279999999994, 435.0, 1071, 860044, 1219, 41.551534999998694
1220, 4.926564340708921, 55.68269005555373, 66.85998469499441, 0.22549285000000002, 445.0, 1040, 861084, 1220, 40.82785630000217
1221, 5.851967126701255, 55.778466137088074, 67.0233033579223, 0.22467204999999998, 210.0, 784, 861868, 1221, 31.94807320000109
1222, 6.935496739336643, 55.80627331240424, 67.02540600710901, 0.2239016499999999, 230.0, 928, 862796, 1222, 37.10825139999724
1223, 5.895921862394695, 55.73008238091526, 67.01918303248394, 0.2231105499999999, 240.0, 830, 863626, 1223, 34.149565199997596
1224, 6.825831349888669, 55.681846212833484, 66.97615932634305, 0.22227174999999988, 265.0, 1034, 864660, 1224, 40.74908510000023
1225, 8.877429917409428, 55.76610566924771, 67.05115139738042, 0.2215103499999999, 155.0, 658, 865318, 1225, 27.511335099999997
1226, 5.777930188770454, 55.779619138265396, 67.00561306484786, 0.22069044999999993, 570.0, 1164, 866482, 1226, 46.90212969999993
1227, 6.257639300550136, 55.71640913518845, 66.9471455483415, 0.21976884999999996, 125.0, 884, 867366, 1227, 35.24571370000194
1228, 5.923419284618142, 55.64344782085088, 66.85222178663132, 0.21905965, 115.0, 692, 868058, 1228, 27.519959899997048
1229, 6.4650258088354455, 55.73004116383634, 66.94993203924608, 0.21828384999999992, 275.0, 1032, 869090, 1229, 41.011865399999806
1230, 4.874356441059202, 55.688188702805235, 66.84957167187576, 0.2175332499999999, 85.0, 636, 869726, 1230, 25.642386300001817
1231, 5.704734860733152, 55.49483326077461, 66.7084733247757, 0.21695904999999996, 135.0, 640, 870366, 1231, 25.378388499997527
1232, 4.587350762436497, 55.20023756417615, 66.28509667231093, 0.21644019999999994, 45.0, 513, 870879, 1232, 20.60830039999928
1233, 7.403800517477487, 55.376633804722836, 66.62048040691175, 0.21586734999999999, 150.0, 760, 871639, 1233, 30.074235600000975
1234, 6.011254293044939, 55.21609918342807, 66.35656712807479, 0.21498625, 335.0, 1198, 872837, 1234, 49.95888610000111
1235, 6.507181501476204, 55.39004707055933, 66.54010862182169, 0.2138351499999998, 425.0, 1360, 874197, 1235, 60.191871099999844
1236, 6.243240496014605, 55.319517237597175, 66.4999163259374, 0.21299589999999996, 65.0, 505, 874702, 1236, 23.356853300003422
1237, 5.755858406883662, 55.35493279037689, 66.51163583109025, 0.2124473499999999, 100.0, 714, 875416, 1237, 31.486701199999516
1238, 5.078327075150459, 55.407681615820756, 66.55204815102495, 0.21163329999999997, 335.0, 1095, 876511, 1238, 46.33364939999956
1239, 6.216943267556921, 55.40928862569758, 66.54302916242847, 0.21070225, 205.0, 974, 877485, 1239, 39.370227200000954
1240, 5.702719882157766, 55.3971544762561, 66.53764327280291, 0.21001689999999998, 110.0, 549, 878034, 1240, 21.975565200002166
1241, 7.774764681566018, 55.33154921471752, 66.52146269902721, 0.20926854999999997, 315.0, 1114, 879148, 1241, 45.56299659999786
1242, 3.652380008529098, 55.27909025789298, 66.37461338413058, 0.20860479999999995, 35.0, 361, 879509, 1242, 14.780935800001316
1243, 5.649727721385799, 55.15221888344243, 66.25157281767648, 0.20796535000000005, 360.0, 1060, 880569, 1243, 44.359563199999684
1244, 6.438567932917455, 55.39059559302994, 66.51125630590842, 0.2069906499999999, 330.0, 1106, 881675, 1244, 45.30357939999885
1245, 5.511135186800975, 55.23522389754084, 66.3647124166707, 0.20602134999999996, 355.0, 1048, 882723, 1245, 42.57643640000242
1246, 7.896918766872054, 55.23652671846709, 66.4227730092061, 0.20523520000000003, 135.0, 699, 883422, 1246, 28.811155499999586
1247, 6.944839961520363, 55.288551475754396, 66.4494626611343, 0.20418759999999986, 500.0, 1629, 885051, 1247, 65.86657170000035
1248, 6.993521772762084, 55.19141875964969, 66.2848434022019, 0.20313234999999996, 110.0, 716, 885767, 1248, 29.057189799998014
1249, 7.973829901106423, 55.41963302118544, 66.64672139193668, 0.20237905000000003, 395.0, 958, 886725, 1249, 38.743826900001295
1250, 6.570175650620595, 55.28071888945156, 66.3302071363406, 0.2017085499999999, 70.0, 532, 887257, 1250, 21.578967900000862
1251, 8.650682908520803, 55.302622283887715, 66.52942839834758, 0.20118204999999995, 95.0, 638, 887895, 1251, 26.201871799999935
1252, 6.714214863871172, 55.28761382778315, 66.37230074968461, 0.20047554999999997, 535.0, 932, 888827, 1252, 38.603730499999074
1253, 6.548184832408256, 55.354143343266756, 66.5078181001329, 0.19983789999999987, 55.0, 485, 889312, 1253, 20.69372189999922
1254, 9.315821867580375, 55.37230105246267, 66.49896362673852, 0.19934064999999998, 115.0, 620, 889932, 1254, 24.42012220000106
1255, 8.765396620859118, 55.273007523779775, 66.49482116200565, 0.19878624999999994, 120.0, 612, 890544, 1255, 24.18573340000148
1256, 6.492110363065122, 55.10753752304627, 66.25578006538186, 0.19811125, 250.0, 888, 891432, 1256, 55.806541100002505
1257, 4.413399040899984, 55.17002778981233, 66.21767024222137, 0.19724454999999994, 250.0, 1038, 892470, 1257, 50.89099100000021
1258, 8.732729191391282, 55.05897618708998, 66.33905345667303, 0.19649529999999993, 135.0, 627, 893097, 1258, 29.662860000000364
1259, 7.418472837083614, 55.27984362382155, 66.37789296257425, 0.19590894999999994, 190.0, 676, 893773, 1259, 33.12943939999968
1260, 4.191855403151524, 55.20055371932401, 66.2562890865724, 0.1954279, 120.0, 393, 894166, 1260, 17.63740930000131
1261, 8.155843685123328, 55.324315973108874, 66.49120387873745, 0.19486899999999993, 360.0, 849, 895015, 1261, 41.686827300000004
1262, 5.833737493103201, 55.285633556345566, 66.42256106208353, 0.19406619999999997, 160.0, 935, 895950, 1262, 43.21636089999811
1263, 5.364473009578555, 55.10683937585285, 66.22541098127896, 0.19341099999999992, 110.0, 521, 896471, 1263, 25.470342299999174
1264, 5.608310219487102, 55.20477612813314, 66.24780519740789, 0.19283364999999988, 175.0, 762, 897233, 1264, 38.59630539999853
1265, 4.234668006544763, 55.348308829105264, 66.45413591211492, 0.19219374999999994, 125.0, 660, 897893, 1265, 31.491776499999105
1266, 6.987529083918303, 55.28332032032502, 66.41858889848758, 0.19145799999999988, 280.0, 975, 898868, 1266, 49.44777819999945
1267, 4.931695488694614, 54.9493575923699, 65.93043944724006, 0.19085589999999997, 30.0, 363, 899231, 1267, 17.27794619999986
1268, 4.665184205170617, 55.12212182316586, 66.2201515704202, 0.19048239999999997, 100.0, 467, 899698, 1268, 23.17410100000052
1269, 4.980870309001521, 55.05005977429842, 66.0884689009817, 0.19005849999999988, 120.0, 475, 900173, 1269, 24.945133900000656
1270, 6.457913900291597, 54.77014073964712, 65.85189901815879, 0.18942849999999992, 340.0, 925, 901098, 1270, 49.21232720000262
1271, 6.276130797413502, 54.99976941103435, 66.03033077738782, 0.18852354999999996, 205.0, 1086, 902184, 1271, 53.423349799999414
1272, 4.863613867675664, 54.88195842155407, 65.88071727959556, 0.18761995000000004, 285.0, 922, 903106, 1272, 43.06076010000106
1273, 6.476354042598015, 54.89606206992577, 65.92596172875372, 0.18678744999999997, 130.0, 928, 904034, 1273, 49.373981799999456
1274, 7.769035119835923, 54.75547506578785, 65.80850202841272, 0.18587169999999986, 290.0, 1107, 905141, 1274, 56.003167900002154
1275, 5.838473436467856, 54.8282652660481, 65.86592547592608, 0.18491005000000002, 325.0, 1030, 906171, 1275, 52.893459700000676
1276, 4.974014727107715, 55.03689993917942, 66.0558293312788, 0.18421615, 85.0, 512, 906683, 1276, 25.898677700002736
1277, 7.097740949474218, 54.86267661174745, 65.92519457868038, 0.1836909999999999, 200.0, 655, 907338, 1277, 32.422986099998525
1278, 6.205120895045457, 54.821728224738386, 65.89214013651461, 0.1831271499999999, 120.0, 598, 907936, 1278, 30.5499619000002
1279, 6.695306105324406, 54.7878674984799, 65.81390980311802, 0.18233514999999995, 205.0, 1162, 909098, 1279, 55.42098090000218
1280, 4.919703558710456, 54.76869962776576, 65.76733093990931, 0.18143559999999995, 195.0, 837, 909935, 1280, 42.36847249999846
1281, 7.510504329533089, 55.00096320891407, 66.08824653325118, 0.18065889999999996, 430.0, 889, 910824, 1281, 47.12996890000068
1282, 5.071137443569896, 55.255065582827385, 66.33296239098837, 0.17991054999999992, 255.0, 774, 911598, 1282, 35.20456230000127
1283, 5.23146482317921, 55.10767079992064, 66.20207649613134, 0.17931969999999997, 70.0, 539, 912137, 1283, 21.791447799998423
1284, 5.424615474562345, 55.22812864267285, 66.29978158707848, 0.1787697999999999, 140.0, 683, 912820, 1284, 27.646009899999626
1285, 6.205323768569416, 55.229624104937855, 66.35886726479518, 0.17811954999999985, 205.0, 762, 913582, 1285, 30.842294000001857
1286, 4.79825071232674, 55.16269367361722, 66.24446928664429, 0.17725104999999994, 220.0, 1168, 914750, 1286, 47.314986500001396
1287, 7.50194300560174, 55.20479333908372, 66.32653494343359, 0.17641899999999996, 80.0, 681, 915431, 1287, 27.693630899997515
1288, 5.721477778787181, 55.14863592406561, 66.21392313639323, 0.17545239999999993, 495.0, 1467, 916898, 1288, 66.50633820000076
1289, 6.65390480258237, 55.24149681688324, 66.36880785275281, 0.17390665000000002, 715.0, 1968, 918866, 1289, 91.17354160000104
1290, 5.050905005170275, 55.10222856092504, 66.15921075942057, 0.17260299999999992, 175.0, 929, 919795, 1290, 41.95732090000092
1291, 7.18098071711268, 55.104427360488984, 66.19895373894545, 0.17173404999999983, 225.0, 1002, 920797, 1291, 40.81037369999831
1292, 5.236700255555265, 54.99709548134217, 66.02704017353568, 0.17086240000000003, 190.0, 935, 921732, 1292, 38.164943499999936
1293, 6.295873507119642, 55.06648184349685, 66.16129595175398, 0.16994169999999995, 170.0, 1111, 922843, 1293, 45.20684579999943
1294, 7.212495297509961, 55.00263285544848, 66.0749400297187, 0.1689755499999999, 230.0, 1036, 923879, 1294, 42.83838729999843
1295, 5.786007783691644, 55.07827892085346, 66.14425095457588, 0.16815519999999995, 140.0, 787, 924666, 1295, 35.8426486999997
1296, 15.720426170825023, 55.34955446012727, 66.29551643479375, 0.16751439999999992, 165.0, 637, 925303, 1296, 26.38025970000308
1297, 9.308489136459414, 55.1683545928919, 66.26830138169326, 0.16684659999999987, 125.0, 847, 926150, 1297, 35.863004699996964
1298, 5.878393123098291, 55.08079289289621, 66.13702167731066, 0.16599744999999994, 320.0, 1040, 927190, 1298, 43.169146200001705
1299, 7.322945114339956, 55.07408104388797, 66.16833704057586, 0.165106, 205.0, 941, 928131, 1299, 42.17333729999882
1300, 7.332999610930533, 55.102520912638546, 66.22807028598058, 0.16441119999999995, 135.0, 603, 928734, 1300, 25.928750499999296
1301, 6.964214625190376, 54.99060971619653, 66.04850227659703, 0.16375555, 220.0, 854, 929588, 1301, 36.48018890000094
1302, 9.072387232381434, 54.884719813606374, 65.97523067709997, 0.16283214999999993, 330.0, 1198, 930786, 1302, 50.75649550000162
1303, 6.793915802494008, 54.76645212126637, 65.80059780738942, 0.16201809999999991, 115.0, 611, 931397, 1303, 25.549429700000474
1304, 6.356687717033284, 54.67844783238002, 65.65334061668032, 0.16136514999999998, 290.0, 840, 932237, 1304, 35.76802739999766
1305, 7.885901003807168, 54.62847669837401, 65.61129872823498, 0.16063794999999995, 140.0, 776, 933013, 1305, 34.957706599998346
1306, 5.768768239109426, 54.65555919934344, 65.64271394052813, 0.15987024999999988, 315.0, 930, 933943, 1306, 42.84566339999947
1307, 4.464336305933121, 54.617897072816504, 65.55258333744148, 0.15910074999999993, 175.0, 780, 934723, 1307, 34.61314809999749
1308, 6.7393581104351625, 54.71064337865812, 65.7532485478745, 0.1583092, 380.0, 979, 935702, 1308, 42.494690399998944
1309, 5.86307753812629, 54.80074152272751, 65.76186293404453, 0.1575405999999999, 225.0, 729, 936431, 1309, 31.018420999997034
1310, 6.197386486551156, 54.677970801604076, 65.65705476767374, 0.15668515, 695.0, 1172, 937603, 1310, 52.275724200000695
1311, 5.609959653741253, 54.72094930724215, 65.73812856646605, 0.1556910999999999, 545.0, 1037, 938640, 1311, 45.320577700000285
1312, 7.023902168300466, 54.81435511771292, 65.85037065835078, 0.15498189999999995, 120.0, 539, 939179, 1312, 23.474921999997605
1313, 6.202488172739884, 54.858048688861686, 65.9214250340708, 0.15426009999999984, 290.0, 1065, 940244, 1313, 46.82936500000142
1314, 11.54301969553179, 55.317710035938326, 66.44250290199128, 0.15348879999999987, 165.0, 649, 940893, 1314, 27.995729800000845
1315, 8.317100275869851, 54.97772312069034, 66.15810137433367, 0.1527462999999999, 315.0, 1001, 941894, 1315, 42.96905289999995
1316, 5.896772397664838, 54.957525203566874, 65.98788441881801, 0.1517608, 290.0, 1189, 943083, 1316, 51.34465320000163
1317, 9.474868576926522, 55.00324545137078, 66.17070598185268, 0.15083469999999993, 315.0, 869, 943952, 1317, 37.48509579999882
1318, 9.300225257160264, 55.078908295090564, 66.17827366045933, 0.15001119999999987, 255.0, 961, 944913, 1318, 40.879620499999874
1319, 7.240950945385937, 55.14226886512196, 66.2246680071125, 0.1492601499999999, 340.0, 708, 945621, 1319, 30.07062610000139
1320, 6.293819358443638, 55.21330641429688, 66.27199971169655, 0.1484011, 325.0, 1201, 946822, 1320, 51.742650300002424
1321, 5.5725994028802335, 54.97452086742742, 66.04152039263136, 0.14739219999999997, 375.0, 1041, 947863, 1321, 45.38163480000003
1322, 12.31030053861822, 55.18691204659081, 66.26180999363835, 0.14646834999999983, 285.0, 1012, 948875, 1322, 44.230980100001034
1323, 4.500987383426648, 55.022212123418875, 66.00305339397413, 0.14582304999999993, 50.0, 422, 949297, 1323, 18.42964369999754
1324, 8.112154150389776, 54.700063644130786, 65.73793949157026, 0.14511519999999986, 305.0, 1151, 950448, 1324, 50.74834199999896
1325, 6.5700129297796055, 54.09328906192284, 64.94621602412374, 0.14402619999999994, 180.0, 1269, 951717, 1325, 54.65686820000337
1326, 7.710086747310882, 54.11068352494745, 65.11277977502316, 0.14310684999999995, 105.0, 774, 952491, 1326, 33.46991259999777
1327, 6.47077009889179, 54.061841710802206, 64.95092485268418, 0.14246784999999995, 155.0, 646, 953137, 1327, 30.437867300002836
1328, 7.0115995909096585, 54.179088526433056, 65.07723806400111, 0.1419953499999999, 70.0, 404, 953541, 1328, 20.087189800000488
1329, 5.666021329771941, 54.1705223132091, 65.03764524277608, 0.1415309499999999, 95.0, 628, 954169, 1329, 29.351488399999653
1330, 5.238468714413189, 54.47120025675133, 65.36494826261328, 0.14107824999999988, 20.0, 378, 954547, 1330, 17.460909100002027
1331, 7.182520481899381, 54.18745470428467, 65.1106974029541, 0.14045814999999992, 225.0, 1000, 955547, 1331, 44.442870399998355
1332, 6.037887880641814, 54.22196670889157, 65.10296401977538, 0.13962339999999995, 190.0, 855, 956402, 1332, 37.89119980000032
1333, 5.643498998249535, 53.9647700177492, 64.74077926412986, 0.13893039999999998, 160.0, 685, 957087, 1333, 29.76172850000148
1334, 6.950866798935365, 54.281245695541315, 65.21696011792235, 0.13830669999999995, 70.0, 701, 957788, 1334, 30.331697900001018
1335, 6.17879502971967, 53.926562134100465, 64.75227592753716, 0.13772664999999995, 140.0, 588, 958376, 1335, 26.14496650000001
1336, 5.6017496113136005, 54.166131042627896, 65.03136095179067, 0.13718259999999993, 85.0, 621, 958997, 1336, 27.41963509999914
1337, 8.029566717268796, 54.00638108294535, 64.8776179098995, 0.13653729999999992, 200.0, 813, 959810, 1337, 35.116284600000654
1338, 9.117588974101126, 53.83968924620761, 64.70606039243964, 0.13597075, 90.0, 446, 960256, 1338, 19.318815700000414
1339, 5.7800812831369495, 53.37813307552015, 64.07313867989232, 0.13550454999999995, 120.0, 590, 960846, 1339, 26.312724999999773
1340, 6.117434946255801, 53.53530719443086, 64.26036916221712, 0.13472514999999993, 395.0, 1142, 961988, 1340, 49.87740140000096
1341, 4.765607155395191, 53.45134242139867, 64.14245632635733, 0.1339079499999999, 135.0, 674, 962662, 1341, 29.98099490000095
1342, 6.9348169881614705, 53.56292462650734, 64.26644160475912, 0.13332024999999995, 120.0, 632, 963294, 1342, 27.824863999998342
1343, 6.13991209079028, 53.449490123823075, 64.16629414401493, 0.13236579999999995, 675.0, 1489, 964783, 1343, 65.44108430000051
1344, 5.211502443595677, 53.59813257083771, 64.31481341343776, 0.13141314999999995, 110.0, 628, 965411, 1344, 28.487812200000917
1345, 5.32968021468903, 53.39836313666367, 64.13948351387086, 0.13090914999999992, 10.0, 492, 965903, 1345, 22.487336800000776
1346, 6.5116619483508105, 53.44336237150314, 64.18561504438395, 0.12987999999999988, 655.0, 1795, 967698, 1346, 79.70726749999812
1347, 7.973567376719612, 53.2874968583275, 64.0070695020215, 0.1286865999999999, 215.0, 857, 968555, 1347, 38.512489699998696
1348, 4.67891084985992, 53.426183249622866, 64.13758811097557, 0.12801924999999995, 140.0, 626, 969181, 1348, 28.666379000002053
1349, 8.569947562525293, 53.55390754455033, 64.35254152036617, 0.12742884999999987, 65.0, 686, 969867, 1349, 30.277608899999905
1350, 6.434850020544616, 53.538381141386054, 64.27373543680349, 0.12669804999999992, 375.0, 938, 970805, 1350, 42.024909700001444
1351, 8.331279575733225, 53.72458269164164, 64.52702408852085, 0.12583629999999996, 255.0, 977, 971782, 1351, 43.310450600001786
1352, 6.161789547369583, 53.60577868038136, 64.37380278756042, 0.12489804999999994, 175.0, 1108, 972890, 1352, 50.125316400000884
1353, 4.580552183725268, 53.565766751241824, 64.2574584658894, 0.12409254999999993, 190.0, 682, 973572, 1353, 30.168694800002413
1354, 5.525405728734854, 53.72962251798374, 64.4685634853333, 0.12355704999999995, 135.0, 508, 974080, 1354, 22.565988999998808
1355, 8.28568130862828, 53.575206727909865, 64.38095690586897, 0.12290949999999996, 175.0, 931, 975011, 1355, 40.513545700003306
1356, 6.218412530658644, 53.75157115835401, 64.56734716133319, 0.12203109999999993, 315.0, 1021, 976032, 1356, 44.709010800001124
1357, 5.685753179063984, 53.73477214738435, 64.4970032935049, 0.12134214999999991, 85.0, 510, 976542, 1357, 22.519248900000093
1358, 9.9560033285731, 53.75612608390519, 64.39106391351434, 0.12082824999999994, 60.0, 632, 977174, 1358, 29.281183099999907
1359, 5.598580634240146, 53.77621368686903, 64.53927563532302, 0.12005109999999994, 305.0, 1095, 978269, 1359, 51.766394300000684
1360, 7.908018697180852, 53.86902311014114, 64.72023075614763, 0.11912499999999994, 165.0, 963, 979232, 1360, 44.58117409999977
1361, 7.053100525896298, 53.46569265425205, 64.2365549877286, 0.1182308499999999, 335.0, 1024, 980256, 1361, 45.805650199999945
1362, 6.717174283495057, 53.126065947107, 63.763466545148084, 0.11737179999999997, 160.0, 885, 981141, 1362, 39.83895549999943
1363, 5.3582850171925545, 53.14343087437054, 63.75511676434892, 0.11669184999999994, 100.0, 626, 981767, 1363, 27.67885910000041
1364, 6.492150886009817, 53.02696696907319, 63.661718608433404, 0.11604879999999995, 335.0, 803, 982570, 1364, 36.66057300000102
1365, 7.53281611355219, 53.05380854101225, 63.79531374461091, 0.11519919999999997, 435.0, 1085, 983655, 1365, 54.405910200002836
1366, 7.548859870096114, 53.109022041883144, 63.80497209152373, 0.11430189999999994, 100.0, 909, 984564, 1366, 46.44834970000011
1367, 6.460094529947957, 53.01823682605096, 63.65928598919754, 0.11332044999999999, 270.0, 1272, 985836, 1367, 60.50203970000075
1368, 5.551601413857234, 52.97662797651032, 63.579224807033505, 0.11246589999999994, 100.0, 627, 986463, 1368, 28.26169459999801
1369, 7.549528640385361, 53.2621458709325, 64.01377643362092, 0.11186829999999993, 115.0, 701, 987164, 1369, 31.37720890000128
1370, 6.128362474955821, 53.0596556793391, 63.72200021855098, 0.11109024999999997, 240.0, 1028, 988192, 1370, 46.1772904999998
1371, 6.634625974845421, 53.03908228010852, 63.662211808653595, 0.11030454999999993, 180.0, 718, 988910, 1371, 32.40867079999953
1372, 6.994220246861815, 53.08678229133212, 63.68717688857711, 0.10974609999999992, 45.0, 523, 989433, 1372, 23.564792599998327
1373, 6.635661991805749, 53.19299314798369, 63.860866578788475, 0.10908369999999992, 170.0, 949, 990382, 1373, 43.08669340000051
1374, 7.316877309622673, 53.042400515629694, 63.743760264470026, 0.10807164999999991, 230.0, 1300, 991682, 1374, 59.197366899999906
1375, 5.430919831423661, 53.07237980081717, 63.76154384199893, 0.1069880499999999, 250.0, 1108, 992790, 1375, 52.30429799999911
1376, 8.996686088283678, 53.387036345123704, 64.25429496937747, 0.10629054999999991, 30.0, 442, 993232, 1376, 20.487748999999894
1377, 6.848177688895142, 52.83422432458989, 63.50160953424793, 0.10579059999999994, 230.0, 669, 993901, 1377, 30.43373209999845
1378, 7.245105306009807, 53.112193082014436, 63.84348272552217, 0.10498644999999991, 240.0, 1118, 995019, 1378, 54.344901099997514
1379, 6.067978774686096, 53.08904510557247, 63.75563612826002, 0.10401939999999994, 235.0, 1031, 996050, 1379, 47.549614600000496
1380, 5.799294252801682, 53.23921245315955, 63.90379289598542, 0.10316439999999998, 495.0, 869, 996919, 1380, 41.92384700000184
1381, 4.739466139653013, 53.23499454613477, 63.8574925112682, 0.10251999999999989, 150.0, 563, 997482, 1381, 27.96573569999964
1382, 8.896180778105812, 53.30757014344378, 64.03249725481359, 0.10182384999999992, 400.0, 984, 998466, 1382, 47.48163270000077
1383, 8.518244725217778, 53.16265352487222, 63.780071931726795, 0.10106739999999993, 125.0, 697, 999163, 1383, 33.69134800000029
1384, 5.588983484223718, 53.10724924504757, 63.80902496725321, 0.10052334999999993, 155.0, 512, 999675, 1384, 23.86818940000012
