,loss,mae,mean_q,mean_eps,episode_reward,nb_episode_steps,nb_steps,episode,duration
0,0,0,0,0,210.0,677,677,0,2.3450498000000017
1, 0, 0, 0, 0, 15.0, 498, 1175, 1, 1.6948755999999996
2, 0, 0, 0, 0, 210.0, 744, 1919, 2, 2.4666958
3, 0, 0, 0, 0, 45.0, 436, 2355, 3, 1.490587099999999
4, 0, 0, 0, 0, 160.0, 771, 3126, 4, 2.552484400000001
5, 0, 0, 0, 0, 210.0, 681, 3807, 5, 2.2696898999999995
6, 0, 0, 0, 0, 225.0, 1350, 5157, 6, 4.439160699999999
7, 0, 0, 0, 0, 195.0, 870, 6027, 7, 2.918909699999997
8, 0, 0, 0, 0, 50.0, 406, 6433, 8, 1.3850501000000008
9, 0, 0, 0, 0, 155.0, 776, 7209, 9, 2.5591206
10, 0, 0, 0, 0, 45.0, 391, 7600, 10, 1.3847578999999968
11, 0, 0, 0, 0, 40.0, 561, 8161, 11, 1.8855877999999962
12, 0, 0, 0, 0, 30.0, 355, 8516, 12, 1.2359076999999985
13, 0, 0, 0, 0, 210.0, 1026, 9542, 13, 3.3646650999999963
14, 0, 0, 0, 0, 85.0, 546, 10088, 14, 1.825314200000001
15, 0, 0, 0, 0, 185.0, 784, 10872, 15, 2.5914243
16, 0, 0, 0, 0, 185.0, 696, 11568, 16, 2.3328934999999973
17, 0, 0, 0, 0, 80.0, 620, 12188, 17, 2.122961999999994
18, 0, 0, 0, 0, 150.0, 704, 12892, 18, 2.464500000000001
19, 0, 0, 0, 0, 155.0, 655, 13547, 19, 2.329460499999996
20, 0, 0, 0, 0, 410.0, 959, 14506, 20, 3.2265291000000005
21, 0, 0, 0, 0, 105.0, 672, 15178, 21, 2.2835553999999973
22, 0, 0, 0, 0, 85.0, 576, 15754, 22, 1.9408207999999973
23, 0, 0, 0, 0, 260.0, 938, 16692, 23, 2.9970286000000073
24, 0, 0, 0, 0, 75.0, 404, 17096, 24, 1.372320000000002
25, 0, 0, 0, 0, 135.0, 649, 17745, 25, 2.1003352000000035
26, 0, 0, 0, 0, 55.0, 670, 18415, 26, 2.2022693000000118
27, 0, 0, 0, 0, 100.0, 577, 18992, 27, 1.8988934000000057
28, 0, 0, 0, 0, 35.0, 514, 19506, 28, 1.664709000000002
29, 0, 0, 0, 0, 30.0, 608, 20114, 29, 2.0225168999999994
30, 0, 0, 0, 0, 360.0, 1010, 21124, 30, 3.2144261999999912
31, 0, 0, 0, 0, 110.0, 652, 21776, 31, 2.153238099999996
32, 0, 0, 0, 0, 210.0, 940, 22716, 32, 2.9708308000000017
33, 0, 0, 0, 0, 315.0, 983, 23699, 33, 3.115621300000001
34, 0, 0, 0, 0, 105.0, 647, 24346, 34, 2.0800985999999995
35, 0, 0, 0, 0, 440.0, 922, 25268, 35, 2.9299946999999946
36, 0, 0, 0, 0, 110.0, 508, 25776, 36, 1.6269817000000018
37, 0, 0, 0, 0, 130.0, 568, 26344, 37, 1.8517306000000104
38, 0, 0, 0, 0, 155.0, 766, 27110, 38, 2.540942699999988
39, 0, 0, 0, 0, 65.0, 660, 27770, 39, 2.1081880999999925
40, 0, 0, 0, 0, 255.0, 979, 28749, 40, 3.227193700000001
41, 0, 0, 0, 0, 80.0, 432, 29181, 41, 1.4183060000000012
42, 0, 0, 0, 0, 45.0, 501, 29682, 42, 1.651855900000001
43, 0, 0, 0, 0, 5.0, 432, 30114, 43, 1.4411271999999968
44, 0, 0, 0, 0, 110.0, 579, 30693, 44, 1.9685527000000036
45, 0, 0, 0, 0, 290.0, 1142, 31835, 45, 3.6612571999999943
46, 0, 0, 0, 0, 165.0, 724, 32559, 46, 2.3811000000000035
47, 0, 0, 0, 0, 155.0, 507, 33066, 47, 1.655650300000005
48, 0, 0, 0, 0, 130.0, 714, 33780, 48, 2.3189914999999957
49, 0, 0, 0, 0, 165.0, 805, 34585, 49, 2.603789000000006
50, 0, 0, 0, 0, 210.0, 689, 35274, 50, 2.268861700000002
51, 0, 0, 0, 0, 35.0, 425, 35699, 51, 1.4240180999999836
52, 0, 0, 0, 0, 210.0, 799, 36498, 52, 2.578339199999988
53, 0, 0, 0, 0, 55.0, 576, 37074, 53, 1.8776976000000047
54, 0, 0, 0, 0, 55.0, 652, 37726, 54, 2.1338361999999904
55, 0, 0, 0, 0, 80.0, 585, 38311, 55, 1.9443602000000055
56, 0, 0, 0, 0, 40.0, 578, 38889, 56, 1.8569259000000216
57, 0, 0, 0, 0, 135.0, 800, 39689, 57, 2.6342546999999854
58, 0, 0, 0, 0, 180.0, 795, 40484, 58, 2.525037200000014
59, 0, 0, 0, 0, 250.0, 858, 41342, 59, 2.7346305999999743
60, 0, 0, 0, 0, 180.0, 775, 42117, 60, 2.517685499999999
61, 0, 0, 0, 0, 110.0, 601, 42718, 61, 2.0238862999999867
62, 0, 0, 0, 0, 230.0, 705, 43423, 62, 2.284735999999981
63, 0, 0, 0, 0, 335.0, 803, 44226, 63, 2.5739169999999945
64, 0, 0, 0, 0, 105.0, 394, 44620, 64, 1.3022339000000045
65, 0, 0, 0, 0, 285.0, 1228, 45848, 65, 3.8493814999999927
66, 0, 0, 0, 0, 110.0, 624, 46472, 66, 2.022721400000023
67, 0, 0, 0, 0, 270.0, 912, 47384, 67, 2.8995285999999965
68, 0, 0, 0, 0, 50.0, 610, 47994, 68, 1.9865436000000045
69, 0, 0, 0, 0, 245.0, 897, 48891, 69, 2.8588266000000147
70, 0, 0, 0, 0, 105.0, 641, 49532, 70, 2.1144780000000196
71, 0, 0, 0, 0, 20.0, 495, 50027, 71, 1.6768596000000002
72, 0, 0, 0, 0, 105.0, 462, 50489, 72, 1.5294684000000132
73, 0, 0, 0, 0, 155.0, 707, 51196, 73, 2.2409556000000066
74, 0, 0, 0, 0, 90.0, 605, 51801, 74, 1.9666259999999909
75, 0, 0, 0, 0, 110.0, 532, 52333, 75, 1.721263399999998
76, 0, 0, 0, 0, 210.0, 814, 53147, 76, 2.6512697000000003
77, 0, 0, 0, 0, 360.0, 780, 53927, 77, 2.5297889
78, 0, 0, 0, 0, 230.0, 837, 54764, 78, 2.720390199999997
79, 0, 0, 0, 0, 125.0, 629, 55393, 79, 2.0249457000000177
80, 0, 0, 0, 0, 105.0, 648, 56041, 80, 2.133272799999986
81, 0, 0, 0, 0, 145.0, 774, 56815, 81, 2.4721579000000133
82, 0, 0, 0, 0, 155.0, 556, 57371, 82, 1.8364195999999993
83, 0, 0, 0, 0, 90.0, 408, 57779, 83, 1.3267747000000156
84, 0, 0, 0, 0, 35.0, 603, 58382, 84, 1.9499054000000058
85, 0, 0, 0, 0, 135.0, 670, 59052, 85, 2.178770300000025
86, 0, 0, 0, 0, 35.0, 509, 59561, 86, 1.6878439000000185
87, 0, 0, 0, 0, 185.0, 819, 60380, 87, 2.651796300000001
88, 0, 0, 0, 0, 155.0, 822, 61202, 88, 2.6875122999999803
89, 0, 0, 0, 0, 120.0, 753, 61955, 89, 2.424889500000006
90, 0, 0, 0, 0, 230.0, 842, 62797, 90, 2.7127209999999877
91, 0, 0, 0, 0, 440.0, 1261, 64058, 91, 3.980651999999992
92, 0, 0, 0, 0, 210.0, 929, 64987, 92, 3.0027438999999845
93, 0, 0, 0, 0, 150.0, 716, 65703, 93, 2.3261541999999906
94, 0, 0, 0, 0, 205.0, 836, 66539, 94, 2.6826414999999884
95, 0, 0, 0, 0, 155.0, 698, 67237, 95, 2.265150399999982
96, 0, 0, 0, 0, 295.0, 1053, 68290, 96, 3.3418537999999955
97, 0, 0, 0, 0, 125.0, 646, 68936, 97, 2.1018704999999898
98, 0, 0, 0, 0, 610.0, 1325, 70261, 98, 4.199709200000001
99, 0, 0, 0, 0, 155.0, 679, 70940, 99, 2.2378825999999776
100, 0, 0, 0, 0, 160.0, 853, 71793, 100, 2.7596130000000016
101, 0, 0, 0, 0, 80.0, 492, 72285, 101, 1.620303899999982
102, 0, 0, 0, 0, 105.0, 608, 72893, 102, 2.0147991000000047
103, 0, 0, 0, 0, 50.0, 551, 73444, 103, 1.8065156999999772
104, 0, 0, 0, 0, 210.0, 936, 74380, 104, 3.024466200000006
105, 0, 0, 0, 0, 225.0, 855, 75235, 105, 2.7389213000000154
106, 0, 0, 0, 0, 290.0, 959, 76194, 106, 3.045420799999988
107, 0, 0, 0, 0, 80.0, 688, 76882, 107, 2.23372999999998
108, 0, 0, 0, 0, 215.0, 825, 77707, 108, 2.6306854000000044
109, 0, 0, 0, 0, 110.0, 633, 78340, 109, 2.0374175000000037
110, 0, 0, 0, 0, 50.0, 406, 78746, 110, 1.3387324000000262
111, 0, 0, 0, 0, 515.0, 1268, 80014, 111, 4.006208399999991
112, 0, 0, 0, 0, 35.0, 550, 80564, 112, 1.8068547999999964
113, 0, 0, 0, 0, 200.0, 881, 81445, 113, 2.80526500000002
114, 0, 0, 0, 0, 65.0, 625, 82070, 114, 2.059995399999991
115, 0, 0, 0, 0, 125.0, 942, 83012, 115, 3.028304299999945
116, 0, 0, 0, 0, 390.0, 1004, 84016, 116, 3.252381000000014
117, 0, 0, 0, 0, 80.0, 681, 84697, 117, 2.174377800000002
118, 0, 0, 0, 0, 105.0, 716, 85413, 118, 2.2964608999999996
119, 0, 0, 0, 0, 45.0, 594, 86007, 119, 1.9521057999999698
120, 0, 0, 0, 0, 155.0, 780, 86787, 120, 2.5332032999999683
121, 0, 0, 0, 0, 80.0, 520, 87307, 121, 1.7055038999999965
122, 0, 0, 0, 0, 105.0, 707, 88014, 122, 2.26528380000002
123, 0, 0, 0, 0, 105.0, 615, 88629, 123, 2.0294538999999645
124, 0, 0, 0, 0, 250.0, 874, 89503, 124, 2.823859099999993
125, 0, 0, 0, 0, 140.0, 688, 90191, 125, 2.234948299999985
126, 0, 0, 0, 0, 210.0, 718, 90909, 126, 2.473780999999974
127, 0, 0, 0, 0, 125.0, 490, 91399, 127, 1.7100322999999662
128, 0, 0, 0, 0, 30.0, 373, 91772, 128, 1.2880976999999803
129, 0, 0, 0, 0, 110.0, 699, 92471, 129, 2.3880470999999943
130, 0, 0, 0, 0, 505.0, 1053, 93524, 130, 3.4799778000000288
131, 0, 0, 0, 0, 55.0, 411, 93935, 131, 1.430367599999954
132, 0, 0, 0, 0, 75.0, 630, 94565, 132, 2.1246241000000055
133, 0, 0, 0, 0, 75.0, 500, 95065, 133, 1.733841200000029
134, 0, 0, 0, 0, 110.0, 617, 95682, 134, 2.0518387999999845
135, 0, 0, 0, 0, 110.0, 763, 96445, 135, 2.538445700000011
136, 0, 0, 0, 0, 125.0, 735, 97180, 136, 2.5000287999999955
137, 0, 0, 0, 0, 155.0, 799, 97979, 137, 2.6841241000000196
138, 0, 0, 0, 0, 155.0, 714, 98693, 138, 2.3699447999999848
139, 0, 0, 0, 0, 100.0, 710, 99403, 139, 2.4222331999999938
140, 71.19791021943092, 17.493518024683, 28.355872571468353, 0.8199703, 120.0, 630, 100033, 140, 3.255136900000025
141, 11.515860393435457, 16.585673772826674, 21.369499389885007, 0.8193610000000003, 50.0, 645, 100678, 141, 9.940205800000001
142, 9.76127164838027, 16.514380194114594, 20.489649236591813, 0.8178165999999999, 315.0, 1071, 101749, 142, 16.30699519999996
143, 11.713019145926848, 16.50445089001341, 20.184668521590645, 0.8164981000000002, 55.0, 394, 102143, 143, 6.135754400000053
144, 8.75185044529775, 16.548964871347106, 20.246063933234346, 0.8151183999999999, 210.0, 1139, 103282, 144, 17.494802800000002
145, 9.435089351307035, 16.538484730645624, 20.21883772555446, 0.8134057000000003, 120.0, 764, 104046, 145, 11.718018599999994
146, 6.764121188715137, 16.534652047358435, 19.946913413906806, 0.8123554000000003, 45.0, 403, 104449, 146, 6.302448900000002
147, 7.310942173995084, 16.517369469304136, 20.045611257069524, 0.8109099999999996, 210.0, 1203, 105652, 147, 18.48828789999999
148, 9.084831587204658, 16.484273878255284, 20.11411452233642, 0.8091090999999999, 155.0, 798, 106450, 148, 12.391744399999993
149, 8.240839497743437, 16.553574461685983, 20.051038882402036, 0.8075530000000006, 240.0, 931, 107381, 149, 14.373462700000005
150, 7.472301677441633, 16.560250736418226, 19.901208754508726, 0.8061292, 105.0, 651, 108032, 150, 10.143187399999988
151, 8.352015679665195, 16.54630372142064, 19.873879156039873, 0.8049537999999999, 105.0, 655, 108687, 151, 10.151577800000041
152, 6.326802146912816, 16.50636621585167, 19.893407209774008, 0.8036461000000001, 150.0, 798, 109485, 152, 12.293588400000033
153, 8.741138802866722, 16.443358019778604, 19.91014988287615, 0.8024662000000001, 80.0, 513, 109998, 153, 7.947321499999987
154, 5.422990260753471, 16.997297215787643, 20.576298399803893, 0.8011486000000001, 240.0, 951, 110949, 154, 14.741852400000028
155, 5.7474238157665125, 17.07578426844991, 20.718360907163415, 0.7997464000000001, 105.0, 607, 111556, 155, 9.461808700000006
156, 8.11487445115358, 17.0599172983133, 20.76280282557696, 0.7987302999999997, 105.0, 522, 112078, 156, 8.128397699999937
157, 5.415599857794565, 17.01929245099344, 20.562157080256004, 0.7977664000000001, 90.0, 549, 112627, 157, 8.544821099999922
158, 4.805251483399845, 16.999529970956157, 20.57379108635548, 0.7960924000000008, 240.0, 1311, 113938, 158, 20.534928599999944
159, 5.487826472230568, 17.0152660868851, 20.580935960987823, 0.7941177999999993, 190.0, 883, 114821, 159, 13.723826000000031
160, 5.4553555520338435, 17.008724939043276, 20.634753167814925, 0.7927453000000001, 95.0, 642, 115463, 160, 10.018986499999983
161, 3.342288046424824, 16.904475391857208, 20.362040092074682, 0.7917138999999997, 185.0, 504, 115967, 161, 7.865215799999987
162, 3.180360979152462, 16.807357082956084, 20.311702268003955, 0.7907941, 110.0, 518, 116485, 162, 8.075413199999957
163, 5.689738050564792, 16.899792373930495, 20.475988101866907, 0.7884685000000006, 730.0, 2066, 118551, 163, 31.65194280000003
164, 3.226045070533399, 16.986185516545802, 20.51965104562265, 0.7862445999999998, 50.0, 405, 118956, 164, 6.410773000000063
165, 4.641687258327853, 16.895587136598145, 20.42759442929545, 0.7850935000000004, 285.0, 874, 119830, 165, 13.675316899999984
166, 5.516431371522617, 17.492632931425373, 21.081585080872358, 0.7839531999999999, 35.0, 393, 120223, 166, 6.2415095000000065
167, 5.367058361965147, 17.904802295294676, 21.633381805636667, 0.7832826999999998, 75.0, 352, 120575, 167, 5.540045199999895
168, 7.1823517807312705, 17.868624607842197, 21.59429984734747, 0.782371, 115.0, 661, 121236, 168, 10.375264400000106
169, 3.979072945167439, 17.875088334229112, 21.47797234736665, 0.7810390000000001, 160.0, 819, 122055, 169, 12.841909900000019
170, 5.832332202486948, 17.889448133336813, 21.66731580945475, 0.7792210000000006, 285.0, 1201, 123256, 170, 18.76374999999996
171, 5.926601834155016, 17.84651632016806, 21.53152760061185, 0.7773174999999994, 280.0, 914, 124170, 171, 14.253420500000061
172, 6.403631823385625, 17.883206574639143, 21.67096195841386, 0.7756372000000001, 245.0, 953, 125123, 172, 15.033005799999955
173, 6.596287217633478, 17.944280545970805, 21.63742365445003, 0.7744401999999999, 80.0, 377, 125500, 173, 6.013020099999949
174, 3.007398544066963, 17.79340256460936, 21.36491834028543, 0.7737166, 15.0, 427, 125927, 174, 6.821740900000009
175, 2.9562532357660514, 17.76736443962147, 21.34628831327351, 0.7725061000000001, 285.0, 918, 126845, 175, 14.47509930000001
176, 4.6618817089602, 17.682732178444088, 21.35006978678149, 0.7712928999999998, 110.0, 430, 127275, 176, 6.819283799999994
177, 6.818061651512124, 17.817433680611096, 21.633992984377105, 0.7702795000000001, 160.0, 696, 127971, 177, 10.951478899999984
178, 3.1359376256296385, 17.844273471976553, 21.428824668572638, 0.7690581999999997, 180.0, 661, 128632, 178, 10.463868899999966
179, 6.684970708960134, 17.90136759788308, 21.637581669030972, 0.7680951999999999, 50.0, 409, 129041, 179, 6.55417900000009
180, 3.163849467221107, 17.844194501046918, 21.495454584369224, 0.7671376000000002, 160.0, 655, 129696, 180, 10.403427599999986
181, 4.768541630867129, 17.775414012989785, 21.463330535300663, 0.7660809999999999, 110.0, 519, 130215, 181, 8.297788500000024
182, 5.230669372636854, 17.82155105175863, 21.53164018019465, 0.7651422999999999, 45.0, 524, 130739, 182, 8.334394399999951
183, 5.853819682873706, 17.76791783814789, 21.41718647044192, 0.7643359000000001, 110.0, 372, 131111, 183, 5.981954599999995
184, 4.49582065686384, 17.779613676572065, 21.434711574157653, 0.7631271999999995, 195.0, 971, 132082, 184, 15.338229500000011
185, 8.01989568114477, 17.847705858346853, 21.619113130270943, 0.7617070000000004, 185.0, 607, 132689, 185, 9.669684500000017
186, 3.8071000316296235, 17.77950438150919, 21.441856541308056, 0.7607124999999997, 65.0, 498, 133187, 186, 8.001534300000003
187, 5.400074412309396, 17.748402547279685, 21.423482088418012, 0.7595704000000003, 185.0, 771, 133958, 187, 12.293012099999942
188, 5.426090957395958, 17.787615085948598, 21.47344123840332, 0.7581339999999998, 380.0, 825, 134783, 188, 13.107563200000072
189, 3.955695094099646, 17.796170918661243, 21.459208275634143, 0.7568632000000001, 110.0, 587, 135370, 189, 9.378654499999925
190, 5.512419652969099, 17.77591362419064, 21.453279212848386, 0.7552710999999994, 360.0, 1182, 136552, 190, 18.657188800000085
191, 6.361550385897985, 17.703220399323662, 21.429473175328656, 0.753373, 300.0, 927, 137479, 191, 14.255018799999903
192, 3.533799998766949, 17.700168144215315, 21.366035111700363, 0.7519006, 130.0, 709, 138188, 192, 11.024732200000017
193, 7.365969054443014, 17.661777037011703, 21.351278544819287, 0.7506253, 90.0, 708, 138896, 193, 10.963193799999999
194, 5.314004027284682, 17.572712073723476, 21.19924055536588, 0.7496424999999999, 30.0, 384, 139280, 194, 6.048072700000034
195, 4.245298473574136, 17.667298692153967, 21.368591539984116, 0.7485031000000004, 440.0, 882, 140162, 195, 13.850351700000033
196, 4.317953020334244, 17.835242589314777, 21.561323996207015, 0.7473475000000002, 65.0, 402, 140564, 196, 6.749245599999995
197, 5.542108091960068, 17.854582979034806, 21.626177014619486, 0.7461963999999998, 155.0, 877, 141441, 197, 13.441153299999996
198, 5.556640686772086, 17.884122451146443, 21.600158208789246, 0.7448131000000003, 120.0, 660, 142101, 198, 10.304446899999903
199, 5.917620007038116, 17.917747380574543, 21.62515779622396, 0.7438815999999997, 45.0, 375, 142476, 199, 6.168414999999982
200, 4.611671433273154, 17.830529443148908, 21.518794591897706, 0.7429699, 210.0, 638, 143114, 200, 9.820015699999999
201, 5.649560608474228, 17.861180655658245, 21.65312645335992, 0.7420501000000002, 35.0, 384, 143498, 201, 5.9416795000000775
202, 4.750342467061754, 17.826557210406417, 21.590039454166245, 0.7411320999999997, 135.0, 636, 144134, 202, 10.416871700000002
203, 5.3998097303655594, 17.8527690994156, 21.64363183775148, 0.7399162, 150.0, 715, 144849, 203, 11.028010400000085
204, 8.322258282591775, 17.86808733491237, 21.650447303406086, 0.7387659999999999, 110.0, 563, 145412, 204, 9.173542100000077
205, 3.7737799562203387, 17.779911266764007, 21.422714255253474, 0.7373953000000008, 500.0, 960, 146372, 205, 14.823837799999865
206, 5.39219823813928, 17.801215495731782, 21.54633915556174, 0.7359616, 95.0, 633, 147005, 206, 10.21346440000002
207, 7.367081342566935, 17.844766295758863, 21.667741414020185, 0.735031, 20.0, 401, 147406, 207, 6.311540599999944
208, 6.545189005511304, 17.73274907890273, 21.452699997673736, 0.7340832999999997, 115.0, 652, 148058, 208, 10.30293759999995
209, 4.999273326937799, 17.79875948164198, 21.491014653665047, 0.7330105000000001, 75.0, 540, 148598, 209, 8.381400600000006
210, 4.532138046415555, 17.77915024619571, 21.41950150859149, 0.7322131000000001, 20.0, 346, 148944, 210, 5.823743700000023
211, 3.274831714794358, 17.733385952521388, 21.377908199246875, 0.7311439, 140.0, 842, 149786, 211, 13.054698899999948
212, 6.424943491490027, 17.54365833593397, 21.24451635094926, 0.7293591999999997, 260.0, 1141, 150927, 212, 18.011007400000153
213, 3.2276444588806914, 17.399527523722526, 20.987880891537113, 0.7276726000000001, 105.0, 733, 151660, 213, 11.721414699999968
214, 7.911399403465421, 17.567078407689145, 21.291848321211965, 0.7265854000000004, 135.0, 475, 152135, 214, 7.844720800000005
215, 7.053771503477596, 17.454200074839036, 21.153191331375478, 0.7257708999999998, 90.0, 430, 152565, 215, 6.687557599999991
216, 3.9799559361771824, 17.325635669157677, 20.88627378719369, 0.7250346999999999, 50.0, 388, 152953, 216, 6.058153400000037
217, 5.665847282103502, 17.34504851096315, 20.969550768534344, 0.7243561000000001, 60.0, 366, 153319, 217, 6.187702800000125
218, 4.265824151763464, 17.40484915653783, 21.041458324349872, 0.7231528000000006, 170.0, 971, 154290, 218, 15.041120000000092
219, 3.6958911242116477, 17.357165883935018, 20.943489448805362, 0.7213473999999994, 425.0, 1035, 155325, 219, 16.649363900000026
220, 9.857270380380141, 17.30565464911769, 21.121377869031917, 0.7200540999999999, 95.0, 402, 155727, 220, 6.281297199999926
221, 4.842522286727631, 17.3518399009948, 21.025996449000203, 0.7187049999999995, 315.0, 1097, 156824, 221, 17.4621345999999
222, 4.014740876406015, 17.35414740892762, 20.956627174462685, 0.7170732999999998, 95.0, 716, 157540, 222, 11.29487250000011
223, 5.302995639992969, 17.351999184309157, 20.98661789141203, 0.7155054999999992, 305.0, 1026, 158566, 223, 16.406256299999995
224, 3.716232004302217, 17.334942441936224, 20.92808955844005, 0.7137415000000003, 240.0, 934, 159500, 224, 15.194339900000159
225, 2.192023179110359, 17.37634136916564, 20.960004596601628, 0.7124266000000001, 105.0, 527, 160027, 225, 8.259364300000016
226, 3.7781890956398536, 17.434349206699924, 21.037381403772347, 0.7111036000000001, 330.0, 943, 160970, 226, 15.159382900000082
227, 3.9242983370981057, 17.413579063121336, 21.03756172062499, 0.7095547000000001, 155.0, 778, 161748, 227, 12.327591600000005
228, 5.2524838909834815, 17.51955604253325, 21.18919334171703, 0.7082821000000004, 60.0, 636, 162384, 228, 10.571582499999977
229, 6.681142963688163, 17.435993821863185, 21.158178620159944, 0.7070365, 135.0, 748, 163132, 229, 11.780604200000198
230, 2.0102883162671055, 17.37404535666867, 20.91139529026226, 0.7060275999999998, 45.0, 373, 163505, 230, 5.94314200000008
231, 2.2520313895854756, 17.366995524938748, 20.9239919378761, 0.7050808000000001, 150.0, 679, 164184, 231, 11.304958899999974
232, 2.9074734590904394, 17.423261300276973, 21.05126681041902, 0.7035391000000006, 370.0, 1034, 165218, 232, 16.099018500000057
233, 4.343355595904552, 17.36688311158875, 20.982039542845737, 0.7020252999999999, 120.0, 648, 165866, 233, 10.726278500000035
234, 2.398913797014393, 17.482922062277794, 21.051965042948723, 0.7008661, 180.0, 640, 166506, 234, 10.064709699999867
235, 5.548533449732812, 17.45616898878341, 21.148695535748917, 0.6997123000000003, 125.0, 642, 167148, 235, 10.580782
236, 2.3520210676918776, 17.455990124053468, 21.03422883067268, 0.6985711000000001, 60.0, 626, 167774, 236, 9.864134800000102
237, 3.329490998831295, 17.459317328303964, 21.054088482814553, 0.6973974999999999, 110.0, 678, 168452, 237, 10.676205299999992
238, 4.197465247291624, 17.490504262034843, 21.05765291253143, 0.6964804, 30.0, 341, 168793, 238, 5.416816899999958
239, 5.242816872490208, 17.406644380146563, 21.080429698547086, 0.6951790000000005, 345.0, 1105, 169898, 239, 17.98477079999998
240, 5.1667148854702765, 17.611054615336847, 21.298884415132626, 0.6932286999999994, 395.0, 1062, 170960, 240, 16.82218490000014
241, 4.1943616137901945, 17.65158316294352, 21.373295995076496, 0.6915978999999999, 155.0, 750, 171710, 241, 12.399925000000167
242, 2.309686800572504, 17.608246706577248, 21.18617865968606, 0.6903459999999999, 95.0, 641, 172351, 242, 10.115821399999959
243, 3.48421961625035, 17.536055616232066, 21.18441781264085, 0.6893010999999999, 20.0, 520, 172871, 243, 8.225562200000013
244, 5.2610525650517, 17.625009703186322, 21.306943241155373, 0.6884515, 95.0, 424, 173295, 244, 6.722403200000144
245, 2.9143132089938915, 17.55900969415763, 21.15317354963419, 0.6873030999999997, 340.0, 852, 174147, 245, 14.017734699999892
246, 4.334515910655232, 17.663559484795815, 21.38303481646562, 0.6855796000000001, 230.0, 1063, 175210, 246, 17.00108880000016
247, 4.654069774356243, 17.619774230428643, 21.25328283052187, 0.6835573000000004, 210.0, 1184, 176394, 247, 19.294748199999958
248, 2.2939101933221506, 17.660045112051616, 21.241136538497802, 0.6819381999999996, 135.0, 615, 177009, 248, 9.966348800000105
249, 9.30838446966468, 17.746871365190117, 21.6051857904612, 0.680815, 210.0, 633, 177642, 249, 10.659923299999946
250, 4.569106937010589, 17.687288768761533, 21.370617177092583, 0.6797386, 105.0, 563, 178205, 250, 9.00246960000004
251, 2.10913301288009, 17.6599327126628, 21.235695493251928, 0.6788818, 10.0, 389, 178594, 251, 6.62331549999999
252, 2.1924410794255804, 17.629248930181113, 21.217316225662973, 0.6780681999999999, 65.0, 515, 179109, 252, 8.349572200000011
253, 3.8154245899527663, 17.527784191788708, 21.16165164546412, 0.6772024000000002, 60.0, 447, 179556, 253, 7.084676499999887
254, 2.2873764661364486, 17.62171515987639, 21.249063268579253, 0.6763617999999997, 30.0, 487, 180043, 254, 7.9492963000000145
255, 1.8959389053813116, 17.63935702616774, 21.184139031437752, 0.6755806000000002, 50.0, 381, 180424, 255, 6.4492301000000225
256, 2.2578255252190593, 17.735013059344585, 21.377834029782534, 0.6742324000000001, 260.0, 1117, 181541, 256, 18.199712800000043
257, 5.530147397506092, 17.68793918825837, 21.43184572031945, 0.6725601999999998, 170.0, 741, 182282, 257, 12.04269179999983
258, 5.3518647856054065, 17.803320672776962, 21.552334663054953, 0.6709536999999995, 255.0, 1044, 183326, 258, 17.2285260000001
259, 3.1594079623902203, 17.70426004569489, 21.32246331129029, 0.6694443999999997, 130.0, 633, 183959, 259, 10.11403630000018
260, 4.881919645150503, 17.749303521474204, 21.490911707560223, 0.6681996999999997, 180.0, 750, 184709, 260, 12.481581700000106
261, 7.0552241914267615, 17.797973970728595, 21.554895556192072, 0.6671817999999999, 45.0, 381, 185090, 261, 6.13235880000002
262, 5.570211208801343, 17.6750280777409, 21.389658925465877, 0.6664888, 60.0, 389, 185479, 262, 6.904779999999846
263, 2.148897003606742, 17.673383156042448, 21.25136224137551, 0.6657949, 75.0, 382, 185861, 263, 7.183786099999907
264, 3.6911523142663385, 17.708714904919475, 21.371757256592943, 0.6646842999999998, 195.0, 852, 186713, 264, 14.48837750000007
265, 5.880257684506496, 17.72909659645307, 21.44429787278497, 0.6632497000000002, 105.0, 742, 187455, 265, 12.328356499999927
266, 2.234332055026262, 17.745715013484364, 21.36776007327837, 0.6622327000000001, 70.0, 388, 187843, 266, 6.493590299999823
267, 5.547443272885532, 17.715934779762563, 21.500019131444436, 0.6615577, 30.0, 362, 188205, 267, 6.057028700000046
268, 4.1952037232410575, 17.718739313549467, 21.410216850704618, 0.6609078999999998, 20.0, 360, 188565, 268, 6.014679500000057
269, 2.0570033684737616, 17.57702996347334, 21.14045726002513, 0.6600691, 135.0, 572, 189137, 269, 9.551289900000029
270, 2.0027952206879855, 17.592919645309447, 21.18425320148468, 0.6588343000000002, 160.0, 800, 189937, 270, 13.893515999999863
271, 5.532606653704659, 17.75762240669944, 21.468545651126217, 0.6574213000000001, 155.0, 770, 190707, 271, 12.804428299999927
272, 2.301878527078141, 17.717513944588454, 21.334309227994176, 0.656407, 75.0, 357, 191064, 272, 6.551720800000112
273, 3.235118286034056, 17.65109503876929, 21.25840514313941, 0.6556266999999999, 0.0, 510, 191574, 273, 8.55129739999984
274, 2.9584639356628077, 17.70296365112446, 21.385800627954865, 0.654391, 495.0, 863, 192437, 274, 14.436866999999893
275, 8.01668535694207, 17.736144032670463, 21.533512768727956, 0.6531229000000001, 50.0, 546, 192983, 275, 9.730404399999998
276, 3.6000030850898472, 17.66951761126518, 21.332811093330385, 0.6519115000000003, 230.0, 800, 193783, 276, 13.36849929999994
277, 3.7442002438223896, 17.736751100835527, 21.448127341082717, 0.6508486000000001, 65.0, 381, 194164, 277, 6.479062199999817
278, 4.038664131631192, 17.836440023623016, 21.537671811957107, 0.6501637000000001, 60.0, 380, 194544, 278, 6.961842100000013
279, 2.97927711760916, 17.69450929520674, 21.329222634971448, 0.6492970000000003, 20.0, 583, 195127, 279, 9.804869499999995
280, 6.557666870816977, 17.698363134534297, 21.50417648738049, 0.6481548999999998, 180.0, 686, 195813, 280, 12.042901799999981
281, 4.891409058918948, 17.713221144770444, 21.431763219267953, 0.6470820999999998, 105.0, 506, 196319, 281, 8.557018900000003
282, 4.159243031171323, 17.64299796225582, 21.355733290557364, 0.6460741, 125.0, 614, 196933, 282, 10.321147399999973
283, 3.1293898935001048, 17.626306595310332, 21.263737506336636, 0.6446143000000005, 350.0, 1008, 197941, 283, 17.4117968999999
284, 3.6914771017310453, 17.791587473353523, 21.490703541944928, 0.6432445, 105.0, 514, 198455, 284, 8.791881299999886
285, 4.05006568215224, 17.601248124066522, 21.213927960863302, 0.6424606, 130.0, 357, 198812, 285, 6.087910299999976
286, 3.7553291814575283, 17.643913151420314, 21.281639850552143, 0.641125, 440.0, 1127, 199939, 286, 19.565826799999968
287, 2.278200988097241, 17.742238575711404, 21.353156551046652, 0.639532, 125.0, 643, 200582, 287, 11.479826000000003
288, 3.154787529014918, 17.76277667555399, 21.405960784191628, 0.6384195999999995, 110.0, 593, 201175, 288, 10.071042299999817
289, 4.3751557101232414, 17.70288850634338, 21.39139846501831, 0.6371532999999998, 230.0, 814, 201989, 289, 13.908490400000119
290, 5.32510794961463, 17.787340137461648, 21.535686813595, 0.6359067999999999, 150.0, 571, 202560, 290, 9.978075699999863
291, 6.859933062841303, 17.762615980789008, 21.430234168947432, 0.6349267, 60.0, 518, 203078, 291, 8.793127200000072
292, 6.018584250172658, 17.75153758654907, 21.51270225720528, 0.6341445999999998, 105.0, 351, 203429, 292, 6.574388400000089
293, 3.7513417732819474, 17.81729740112141, 21.448563854432297, 0.633493, 20.0, 373, 203802, 293, 6.421244199999819
294, 4.111131224625221, 17.72647706163941, 21.377995514587994, 0.6323194000000002, 195.0, 931, 204733, 294, 16.13371169999982
295, 3.345320015508399, 17.69032409119648, 21.36520190466018, 0.6304609000000005, 370.0, 1134, 205867, 295, 19.217137700000194
296, 4.725939984889639, 17.66020564691599, 21.352123738401954, 0.6290380000000001, 80.0, 447, 206314, 296, 8.187671500000306
297, 2.8627338125321717, 17.67055295508004, 21.26390113032274, 0.6280336000000001, 140.0, 669, 206983, 297, 11.366069400000015
298, 3.627908108946416, 17.626027786082638, 21.33118064343375, 0.6267538000000004, 315.0, 753, 207736, 298, 13.352303199999824
299, 4.149906001554595, 17.65033649303295, 21.32824375293873, 0.6254686, 135.0, 675, 208411, 299, 11.524577099999988
300, 4.190580650571395, 17.664758622646332, 21.315181152387098, 0.6245442999999998, 60.0, 352, 208763, 300, 6.046436900000117
301, 4.840185899987463, 17.637825440639553, 21.30487175482138, 0.6233941, 245.0, 926, 209689, 301, 16.295783799999754
302, 3.1416101211407144, 17.738145561549334, 21.39833327452495, 0.6216273999999999, 495.0, 1037, 210726, 302, 18.145949199999905
303, 1.9981915003847524, 17.592398854287975, 21.232670024117045, 0.6201891999999998, 80.0, 561, 211287, 303, 9.585170399999697
304, 2.0616662053217376, 17.66970108310291, 21.263852299753246, 0.6192892, 35.0, 439, 211726, 304, 8.057017900000119
305, 3.92833251643832, 17.757156259873334, 21.49136151653044, 0.6185728000000001, 65.0, 357, 212083, 305, 6.200416799999857
306, 3.918889259881866, 17.70887674773648, 21.38287788082615, 0.6176728, 230.0, 643, 212726, 306, 10.96867659999998
307, 5.648249330889269, 17.709873381388714, 21.469349953065436, 0.6166459, 80.0, 498, 213224, 307, 9.160388599999806
308, 3.4222489647529164, 17.68465944202355, 21.321603628680528, 0.6154939000000001, 150.0, 782, 214006, 308, 13.377383200000168
309, 3.5201184943548056, 17.7161923906477, 21.38448095964788, 0.6143230000000001, 70.0, 519, 214525, 309, 9.557142999999996
310, 3.9581207542516275, 17.71396376685432, 21.467038064215124, 0.6133905999999999, 95.0, 517, 215042, 310, 8.917037499999878
311, 3.367216442665085, 17.711701120932897, 21.36968976457914, 0.6120612999999998, 335.0, 960, 216002, 311, 17.077097800000047
312, 5.987648258652302, 17.75528977009904, 21.51290746115468, 0.6103171000000001, 245.0, 978, 216980, 312, 17.46103600000015
313, 4.336711216071875, 17.716537273238067, 21.38413141926276, 0.6084613, 350.0, 1084, 218064, 313, 18.614544200000182
314, 3.7799965585667663, 17.657266979568575, 21.304649118996835, 0.6068989000000002, 110.0, 652, 218716, 314, 11.793364699999984
315, 5.704989446876215, 17.73285422666066, 21.484944535049006, 0.6053932000000004, 170.0, 1021, 219737, 315, 18.06659800000034
316, 3.771622975852365, 17.522358467999627, 21.141953394771402, 0.6037857999999999, 210.0, 765, 220502, 316, 13.087516700000378
317, 4.029856638072577, 17.452415613815685, 21.056189429491088, 0.6022593999999999, 265.0, 931, 221433, 317, 16.03060930000038
318, 6.365259548400117, 17.43715079440627, 21.142859364664833, 0.6008022999999999, 170.0, 688, 222121, 318, 11.802329099999952
319, 4.4786314378085335, 17.40545235464583, 21.04019499444342, 0.5997672999999999, 60.0, 462, 222583, 319, 8.324222300000201
320, 3.5856310890697354, 17.478059767478676, 21.073207021358623, 0.5986351000000002, 200.0, 796, 223379, 320, 13.311965500000042
321, 3.1291881418537977, 17.389755866551162, 20.949032605992684, 0.5970097000000003, 270.0, 1010, 224389, 321, 17.356164300000273
322, 2.7322377590786124, 17.404156934711295, 20.97331698422141, 0.5951421999999996, 445.0, 1065, 225454, 322, 18.14161779999995
323, 3.991031876723132, 17.431044989247475, 21.09257148004347, 0.5936256999999997, 45.0, 620, 226074, 323, 10.399986400000216
324, 1.9747535532262606, 17.385059246559987, 20.956343908567685, 0.5923350999999999, 195.0, 814, 226888, 324, 14.112622000000101
325, 2.739760810682413, 17.33049096016216, 20.92312181343153, 0.5909535999999999, 210.0, 721, 227609, 325, 12.053175399999873
326, 3.740909938086438, 17.365900351450993, 20.944779293877737, 0.5896494999999999, 220.0, 728, 228337, 326, 12.9136696999999
327, 3.1512471319172635, 17.284950480850753, 20.876770090036356, 0.5885317, 95.0, 514, 228851, 327, 8.69117660000029
328, 2.104907904547345, 17.390454701014928, 20.93397574933242, 0.5876217999999999, 80.0, 497, 229348, 328, 8.36960289999979
329, 7.510944750329147, 17.507455577942483, 21.218735767677785, 0.5862429999999995, 470.0, 1035, 230383, 329, 17.8691888999997
330, 4.818777842875657, 17.655131879546833, 21.4022280196069, 0.5849281, 60.0, 426, 230809, 330, 7.199408500000118
331, 1.9751719649051542, 17.637730724671307, 21.239666465951615, 0.5836878999999998, 340.0, 952, 231761, 331, 16.728815899999972
332, 3.162151185502397, 17.57797389131911, 21.18726212115998, 0.5819850999999999, 195.0, 940, 232701, 332, 16.399644899999657
333, 4.102798140285393, 17.713665873576435, 21.414174211330902, 0.5805774999999999, 355.0, 624, 233325, 333, 10.497808799999802
334, 5.095717403400838, 17.619706739028107, 21.232697703520085, 0.5796315999999999, 60.0, 427, 233752, 334, 7.9420515000001615
335, 3.3543438412685456, 17.58000622292144, 21.230256097177104, 0.5784174999999998, 210.0, 922, 234674, 335, 15.617982899999788
336, 4.340052774935887, 17.585744863718897, 21.219572994839492, 0.5768640999999998, 140.0, 804, 235478, 336, 14.155227400000058
337, 3.4173154481480608, 17.580421211445227, 21.225307219851334, 0.5753268999999998, 295.0, 904, 236382, 337, 15.603195199999845
338, 5.010338233809592, 17.604419941177017, 21.291823382751183, 0.5739273999999998, 180.0, 651, 237033, 338, 11.21238859999994
339, 3.118485135564291, 17.563962938301117, 21.19539099385539, 0.5728897000000001, 100.0, 502, 237535, 339, 8.4707856
340, 4.641844765044222, 17.63966606217201, 21.370707140065203, 0.5719924000000002, 130.0, 495, 238030, 340, 8.918591599999672
341, 4.659162522059255, 17.638435661398024, 21.289593210283495, 0.5704596999999999, 225.0, 1208, 239238, 341, 20.749531500000103
342, 6.406401897627011, 17.707048391041003, 21.419351246482446, 0.5688595, 10.0, 570, 239808, 342, 10.145975200000066
343, 2.8033869669964986, 17.441391755360126, 21.00185913263365, 0.5670693999999997, 395.0, 1419, 241227, 343, 25.623539400000027
344, 3.834304107750607, 17.4010703985284, 21.024352428389758, 0.5652018999999998, 85.0, 656, 241883, 344, 11.359649099999842
345, 3.484951473974952, 17.44052257002915, 21.04191847457685, 0.5635845999999998, 345.0, 1141, 243024, 345, 20.014161899999635
346, 3.223085216151656, 17.42034761680747, 20.998337684487396, 0.5620807000000001, 110.0, 530, 243554, 346, 9.23207820000016
347, 4.480233598610489, 17.408135409430255, 20.9888716457397, 0.5606892999999997, 325.0, 1016, 244570, 347, 17.58080229999996
348, 2.75879949346268, 17.350939113467764, 20.93117120199363, 0.5589694000000001, 275.0, 895, 245465, 348, 15.82591179999963
349, 4.440144246081088, 17.355470304286225, 20.961473012071973, 0.5571064000000001, 500.0, 1175, 246640, 349, 20.754154700000072
350, 3.713485275737632, 17.445758321595637, 21.068803129619113, 0.5554197999999998, 135.0, 699, 247339, 350, 12.529000099999848
351, 5.677549427840859, 17.446269289139778, 21.103941282918377, 0.5543442999999999, 50.0, 496, 247835, 351, 9.406736099999762
352, 3.845393347803662, 17.413114373247726, 20.99575898880349, 0.5535387999999999, 30.0, 399, 248234, 352, 7.224505600000157
353, 3.5624498549452346, 17.40941866637325, 21.013325220676712, 0.5521564000000003, 205.0, 1137, 249371, 353, 20.6441405999999
354, 4.312348077755149, 17.399757957458498, 20.998106035372107, 0.5503950999999999, 125.0, 820, 250191, 354, 14.755947500000275
355, 3.6058071565972205, 17.63262143943468, 21.25841914230834, 0.5489244999999998, 330.0, 814, 251005, 355, 15.140946699999859
356, 5.3535334412059274, 17.587504228389232, 21.298300698927378, 0.5478615999999997, 40.0, 367, 251372, 356, 6.626082199999928
357, 3.9383084225337863, 17.644223571629915, 21.27682714600494, 0.5465998000000003, 585.0, 1035, 252407, 357, 19.057167500000105
358, 2.9106242060420975, 17.618200925088697, 21.249114024254585, 0.5451103000000002, 95.0, 620, 253027, 358, 11.125107800000023
359, 2.7706499536547775, 17.581761489695463, 21.20027550495417, 0.5438764000000001, 70.0, 751, 253778, 359, 14.09972179999977
360, 5.409221130233826, 17.622665298187126, 21.27289448148113, 0.5423509000000001, 130.0, 944, 254722, 360, 17.531948699999703
361, 4.971631424111682, 17.623901168813386, 21.348337023141156, 0.5408047000000001, 160.0, 774, 255496, 361, 13.96625240000003
362, 3.563805900776139, 17.58541540845866, 21.198757900860635, 0.53911, 425.0, 1109, 256605, 362, 20.4237677000001
363, 4.392281802719284, 17.53166848981267, 21.190410537478034, 0.5372596, 315.0, 947, 257552, 363, 17.59211379999988
364, 5.476144406278298, 17.54856496235681, 21.180225975803598, 0.5355568, 370.0, 945, 258497, 364, 16.92789279999988
365, 5.524077322519287, 17.647830056880718, 21.361193974812824, 0.5342176000000001, 95.0, 543, 259040, 365, 10.37743619999992
366, 3.4325018570353003, 17.55072671778062, 21.11663496129653, 0.5333464, 75.0, 425, 259465, 366, 7.743576100000155
367, 3.5802985493232873, 17.836055480361185, 21.499950133681498, 0.5319037000000001, 345.0, 1178, 260643, 367, 21.82813269999997
368, 4.919812418281577, 18.091595140122276, 21.838992609504526, 0.5302539999999998, 140.0, 655, 261298, 368, 12.464801399999942
369, 2.13570411986896, 18.082579168200816, 21.75472155625258, 0.5293324, 90.0, 369, 261667, 369, 6.790846200000033
370, 8.57688147108834, 18.108127712559057, 21.87962785325609, 0.5285008000000002, 60.0, 555, 262222, 370, 10.140666299999793
371, 4.211640213581952, 18.10946073251612, 21.857598043539944, 0.5270220999999997, 390.0, 1088, 263310, 371, 20.111181899999792
372, 3.905811775061819, 18.017774896815723, 21.728431692705467, 0.5254678000000002, 120.0, 639, 263949, 372, 12.129306299999826
373, 4.139026452371172, 18.130975240190452, 21.854736663247937, 0.5244112, 165.0, 535, 264484, 373, 9.74451450000015
374, 2.7355788542920836, 18.06031940365088, 21.758252584402328, 0.5232438999999997, 400.0, 762, 265246, 374, 14.339762500000234
375, 4.71651336109737, 17.988137581262244, 21.737942253250672, 0.5219604999999997, 130.0, 664, 265910, 375, 12.114319799999976
376, 2.220606135201376, 18.09698449841078, 21.807588815297596, 0.5208148, 125.0, 609, 266519, 376, 11.713675399999829
377, 5.890428486042635, 18.098148574416385, 21.947747892353227, 0.5196843999999999, 170.0, 647, 267166, 377, 11.802509600000121
378, 4.276444390872303, 18.025009813467957, 21.765086568574073, 0.518617, 125.0, 539, 267705, 378, 10.492206899999928
379, 2.1608804421078776, 18.126350324739594, 21.847486278259428, 0.5177692, 5.0, 403, 268108, 379, 7.418574199999966
380, 4.103574152502072, 18.136316441908114, 21.86713519328978, 0.5171113, 50.0, 328, 268436, 380, 6.057315099999869
381, 4.400062386700529, 18.068843054150292, 21.76116584441466, 0.516367, 135.0, 499, 268935, 381, 9.777010100000098
382, 3.3357633105422075, 17.977947920859858, 21.689971723949895, 0.5151105999999999, 185.0, 897, 269832, 382, 16.460445199999867
383, 5.937798724096632, 18.272508135415556, 22.128935466135356, 0.5138245, 60.0, 532, 270364, 383, 10.323573199999828
384, 3.1082399362480664, 18.434237325278513, 22.195945416053718, 0.5128525, 110.0, 548, 270912, 384, 10.111883900000066
385, 4.156247841856894, 18.521643657310335, 22.370686929099033, 0.5120379999999999, 80.0, 357, 271269, 385, 6.869538400000238
386, 5.479061643905146, 18.339173148048673, 22.198095576314902, 0.5113863999999999, 60.0, 367, 271636, 386, 7.1410415000000285
387, 3.586430208939735, 18.409195399802663, 22.22038937651593, 0.5107248999999999, 25.0, 368, 272004, 387, 6.814140200000111
388, 6.961264810120722, 18.44190729789014, 22.354505802850305, 0.5098213, 105.0, 636, 272640, 388, 12.17290580000008
389, 3.6289514693908576, 18.295195561437424, 22.072738724995435, 0.5089168, 50.0, 369, 273009, 389, 6.934114600000157
390, 4.686493611587825, 18.378215371491667, 22.16788927809207, 0.5079835, 135.0, 668, 273677, 390, 12.303195999999843
391, 3.061469021825546, 18.362135765064192, 22.167595357779998, 0.5067847, 150.0, 664, 274341, 391, 12.748570200000358
392, 5.4528567745807495, 18.33529261155562, 22.21551472577182, 0.5051970999999997, 220.0, 1100, 275441, 392, 20.730150500000036
393, 3.7934188364367736, 18.3562274759973, 22.148275361423604, 0.5035914999999997, 160.0, 684, 276125, 393, 12.575808399999914
394, 3.8307366993268537, 18.39209501799342, 22.12930503028491, 0.5026312000000001, 65.0, 383, 276508, 394, 7.13911969999981
395, 6.684741029857068, 18.385906023306173, 22.263332558823777, 0.5016871000000002, 80.0, 666, 277174, 395, 12.854147300000022
396, 1.842368899587923, 18.24187761216652, 21.91860403601579, 0.5006305, 55.0, 508, 277682, 396, 9.449944899999991
397, 2.023850282524782, 18.220655881249264, 21.93640520688278, 0.49948659999999995, 175.0, 763, 278445, 397, 14.701434699999936
398, 4.068543533614492, 18.286354681404916, 22.044934994608, 0.49847410000000003, 105.0, 362, 278807, 398, 6.715886599999976
399, 3.62313681361063, 18.272601986276932, 22.045594631761745, 0.49715470000000006, 350.0, 1104, 279911, 399, 20.304827899999964
400, 4.539809122478923, 18.483743467118657, 22.32649628622711, 0.49506939999999994, 585.0, 1213, 281124, 400, 21.951773099999627
401, 2.705618869256799, 18.585170557905187, 22.37137906112277, 0.49293190000000037, 485.0, 1162, 282286, 401, 21.086155399999825
402, 5.488334118209983, 18.61626972564279, 22.50733622786117, 0.4913605, 20.0, 584, 282870, 402, 10.476152700000057
403, 2.9939177726887785, 18.616349325058568, 22.455220641603894, 0.4902696999999999, 60.0, 628, 283498, 403, 11.806324600000153
404, 3.1504492118539944, 18.537361289626578, 22.32886384865144, 0.4887667000000001, 265.0, 1042, 284540, 404, 18.571786399999837
405, 3.906095172547124, 18.526982022209403, 22.306383925712915, 0.48724209999999996, 130.0, 652, 285192, 405, 12.21024529999977
406, 4.4945737935193355, 18.618712979517166, 22.515572241157482, 0.48552489999999976, 520.0, 1256, 286448, 406, 22.334222899999986
407, 2.8038830785335946, 18.547699177101865, 22.36371595565587, 0.4838688999999997, 95.0, 584, 287032, 407, 10.779846700000235
408, 3.88150091919114, 18.533013430383775, 22.322182265070055, 0.48271869999999995, 155.0, 694, 287726, 408, 12.42066990000012
409, 3.0578380329496397, 18.507395186716195, 22.293650559016637, 0.48121209999999975, 135.0, 980, 288706, 409, 18.308049100000062
410, 3.074658192752669, 18.509333161394487, 22.300776659787356, 0.4797567999999998, 150.0, 637, 289343, 410, 11.440326699999787
411, 3.0222745493099272, 18.53027331398194, 22.32370409046311, 0.4785858999999999, 140.0, 664, 290007, 411, 12.715391700000055
412, 2.620754776789724, 18.706695686460165, 22.506202072622887, 0.47712879999999985, 510.0, 955, 290962, 412, 17.618485899999996
413, 1.8452620307929115, 18.68509089816889, 22.46125547870312, 0.4758562000000001, 45.0, 459, 291421, 413, 8.26293970000006
414, 4.42483281317256, 18.749003758612027, 22.627187220551935, 0.47428479999999973, 305.0, 1287, 292708, 414, 23.58846999999969
415, 3.6167121587528124, 18.82252234083845, 22.69963860553829, 0.4721059000000001, 330.0, 1134, 293842, 415, 20.22770010000022
416, 5.338906998995514, 18.765516286287575, 22.670728430649092, 0.4700871999999998, 420.0, 1109, 294951, 416, 20.545737500000087
417, 1.9946198608448256, 18.69554749104514, 22.47146341124577, 0.4687876, 30.0, 335, 295286, 417, 6.844092499999988
418, 2.6393351679280364, 18.67966029399021, 22.507948368713073, 0.4677679000000002, 165.0, 798, 296084, 418, 15.100016400000186
419, 4.621070662769445, 18.799384390117982, 22.698275822928622, 0.4665718000000001, 60.0, 531, 296615, 419, 10.633857700000135
420, 1.9193128894536924, 18.688387429000986, 22.49547636896117, 0.46556739999999985, 50.0, 585, 297200, 420, 11.101200399999925
421, 3.2527951046114185, 18.694170245864512, 22.52592825425738, 0.46411569999999996, 315.0, 1028, 298228, 421, 19.802951199999825
422, 4.485398408326697, 18.644171877110256, 22.48674591551436, 0.46276749999999994, 50.0, 470, 298698, 422, 8.916941499999666
423, 1.8429319983105636, 18.656387213899308, 22.46468105436373, 0.4614876999999999, 380.0, 952, 299650, 423, 18.813401299999896
424, 2.872795039879871, 18.68669174777137, 22.539383161215135, 0.46004769999999984, 110.0, 648, 300298, 424, 12.808467499999551
425, 4.860297033115995, 18.837730255532772, 22.768778960393192, 0.45887229999999996, 115.0, 658, 300956, 425, 12.621854600000006
426, 3.2520542947379187, 18.869908898772586, 22.745103430321393, 0.4573746999999998, 265.0, 1006, 301962, 426, 19.574089100000037
427, 3.6878537974195145, 18.906759003029784, 22.786735418751753, 0.45549189999999995, 195.0, 1086, 303048, 427, 21.085241100000076
428, 3.645476004189359, 18.839467017098542, 22.73926679596646, 0.4541608, 35.0, 393, 303441, 428, 7.474078899999768
429, 6.393753710894141, 18.919684448788445, 22.940009274175456, 0.45305289999999976, 395.0, 838, 304279, 429, 16.561505500000294
430, 3.9474015383049847, 18.90757275763012, 22.78555714743478, 0.4515426999999997, 330.0, 840, 305119, 430, 16.516032400000313
431, 4.492519689470015, 18.891601295251537, 22.8266221886633, 0.4503177999999999, 195.0, 521, 305640, 431, 9.955014500000289
432, 3.1577452492288183, 18.889504034859794, 22.77898185548328, 0.4489038999999997, 315.0, 1050, 306690, 432, 20.47751980000021
433, 3.2213252935754624, 18.821250216756688, 22.68325905853996, 0.4470868, 580.0, 969, 307659, 433, 19.063233200000013
434, 5.051718128937305, 18.922097031432802, 22.779725433576225, 0.4456692999999999, 110.0, 606, 308265, 434, 11.708340200000293
435, 5.101385565307381, 18.857514416599624, 22.770501393673605, 0.44439219999999985, 210.0, 813, 309078, 435, 16.107042099999944
436, 5.159838353042249, 18.899850577216355, 22.82101205382684, 0.44312589999999985, 105.0, 594, 309672, 436, 11.390626800000064
437, 6.907787151176611, 19.048790747175165, 23.023466950083726, 0.4415959, 290.0, 1106, 310778, 437, 21.766491700000188
438, 4.57098878276201, 19.10340727307669, 23.06771834887595, 0.4397257000000002, 180.0, 972, 311750, 438, 18.641620500000045
439, 3.522187133514457, 19.103396766171628, 23.020324637585027, 0.43778799999999973, 505.0, 1181, 312931, 439, 23.04978250000022
440, 8.016363053969465, 19.111317229270934, 23.16270166177016, 0.4362570999999999, 110.0, 520, 313451, 440, 10.766380499999741
441, 3.36517821637669, 19.052533068801417, 22.944957902696398, 0.43534359999999994, 35.0, 495, 313946, 441, 9.552647699999852
442, 5.650297773166977, 19.149085691605492, 23.109853382768303, 0.4345848999999999, 60.0, 348, 314294, 442, 7.3742034000001695
443, 4.1266606086103605, 19.237954753000032, 23.186915718534458, 0.43369929999999995, 120.0, 636, 314930, 443, 12.315417299999808
444, 6.43735106592796, 19.140816392094255, 23.072930039555192, 0.43275339999999984, 80.0, 415, 315345, 444, 8.095572600000196
445, 2.871853197357116, 19.094749466317598, 22.999445186109018, 0.43117210000000034, 210.0, 1342, 316687, 445, 26.837267000000338
446, 5.3417825216695025, 19.04793645148497, 23.016294798591645, 0.4293189999999999, 145.0, 717, 317404, 446, 13.853436399999737
447, 5.2269387766718864, 19.095631242047272, 23.049171881785224, 0.42781149999999973, 205.0, 958, 318362, 447, 19.07521779999979
448, 3.754509333300136, 19.103995445757935, 22.991202807022354, 0.42631209999999975, 135.0, 708, 319070, 448, 13.893495899999834
449, 1.7555801228435013, 19.07781494689846, 22.922148947797844, 0.4250997999999999, 190.0, 639, 319709, 449, 12.681329600000026
450, 4.500220916741619, 19.127849354463464, 23.184892433764887, 0.42406569999999993, 20.0, 510, 320219, 450, 9.98005270000067
451, 3.9970454868164036, 19.268957882154943, 23.22410599417743, 0.42307839999999997, 75.0, 587, 320806, 451, 11.878226299999369
452, 5.362303029299612, 19.316258124986398, 23.366264677977494, 0.42222699999999996, 30.0, 359, 321165, 452, 7.0163766000005126
453, 1.9022612824603236, 19.240627546033423, 23.1436226318486, 0.42125319999999994, 25.0, 723, 321888, 453, 14.536730799999532
454, 4.556381025750351, 19.305918133574718, 23.308167943063307, 0.4199572, 185.0, 717, 322605, 454, 13.888907800000197
455, 4.517372273086083, 19.276138971722315, 23.244516717063057, 0.41885830000000007, 95.0, 504, 323109, 455, 10.363313400000152
456, 3.9051473406514368, 19.2711210261404, 23.17903171176404, 0.41759109999999994, 155.0, 904, 324013, 456, 17.566286299999774
457, 4.38903842409314, 19.27401012771051, 23.207307362680417, 0.4162581999999999, 75.0, 577, 324590, 457, 11.82807430000048
458, 5.8152802040368, 19.3435149851265, 23.31407623406788, 0.4151457999999998, 195.0, 659, 325249, 458, 12.854468599999564
459, 6.44424772921519, 19.27028448258213, 23.302992847097578, 0.4138362999999999, 180.0, 796, 326045, 459, 16.03503030000047
460, 3.351480445373573, 19.217823139845002, 23.154052224710078, 0.4123485999999999, 230.0, 857, 326902, 460, 16.504234799999722
461, 1.8063242955400551, 19.292323271773867, 23.187979087584534, 0.4107366999999999, 160.0, 934, 327836, 461, 17.845484999999826
462, 4.237985819443926, 19.291636546882422, 23.283060137430827, 0.4088971, 515.0, 1110, 328946, 462, 20.707394700000805
463, 2.070073581053767, 19.314692248854527, 23.246592492835465, 0.4071240999999999, 315.0, 860, 329806, 463, 16.204940000000533
464, 2.4253814864081393, 19.268662901836596, 23.192103178827118, 0.4053429999999998, 305.0, 1119, 330925, 464, 21.522317099999782
465, 3.2860683067716323, 19.301707712278873, 23.245950147929108, 0.40347279999999996, 205.0, 959, 331884, 465, 18.05552489999991
466, 4.766097696147045, 19.243753872285307, 23.238736591706694, 0.40176910000000016, 290.0, 934, 332818, 466, 18.15638880000006
467, 6.985186782119603, 19.258461168265846, 23.25624759364314, 0.40011939999999996, 335.0, 899, 333717, 467, 17.51636529999996
468, 3.4560569259131846, 19.252169291178387, 23.173338187602294, 0.39853809999999995, 275.0, 858, 334575, 468, 16.272859499999868
469, 4.732789626394965, 19.367358107419356, 23.40398620920083, 0.39732939999999994, 95.0, 485, 335060, 469, 9.577977799999644
470, 5.066068984444355, 19.252694258262153, 23.200508605602177, 0.3963511, 50.0, 602, 335662, 470, 11.376196499999423
471, 3.1315393659003665, 19.31156938102808, 23.244030285953137, 0.39540879999999995, 5.0, 445, 336107, 471, 8.473804199999904
472, 6.035206242325319, 19.246284015333973, 23.247071863590985, 0.39406869999999977, 300.0, 1044, 337151, 472, 20.286351099999592
473, 4.906245188250585, 19.2977570480216, 23.27883628569366, 0.39218320000000007, 195.0, 1051, 338202, 473, 20.564833100000214
474, 3.7804296648076603, 19.202591863359725, 23.148367167881556, 0.39092229999999994, 15.0, 350, 338552, 474, 6.694948000000295
475, 2.039912441257134, 19.24729749068473, 23.13646629018691, 0.39023650000000004, 90.0, 412, 338964, 475, 7.892905400000018
476, 1.925127535939467, 19.238387628763665, 23.137162960276886, 0.3893302, 115.0, 595, 339559, 476, 11.875914999999623
477, 3.0080886597689576, 19.207801140297136, 23.133179499272995, 0.3881458000000001, 140.0, 721, 340280, 477, 13.711345800000345
478, 7.758603782816366, 19.304125011142048, 23.299161899823947, 0.38719, 55.0, 341, 340621, 478, 7.2143261000001075
479, 2.8304770700970656, 19.160074344767345, 23.06415976010836, 0.38568969999999997, 375.0, 1326, 341947, 479, 26.342510700000275
480, 4.08828109636195, 19.247037376468857, 23.185554704189883, 0.3837574000000001, 195.0, 821, 342768, 480, 16.295589199999995
481, 5.152611729321771, 19.227740964712023, 23.213710843003945, 0.3819547, 300.0, 1182, 343950, 481, 24.073763000000326
482, 6.562023303984009, 19.266315142783892, 23.224081885885205, 0.38028249999999997, 220.0, 676, 344626, 482, 14.12806289999935
483, 5.790323923112595, 19.213978284830088, 23.154657764835758, 0.37847529999999996, 570.0, 1332, 345958, 483, 27.079067399999985
484, 3.0771687814393585, 19.18163633059306, 23.12593316744609, 0.3766789, 105.0, 664, 346622, 484, 13.302245400000174
485, 3.9602354609574864, 19.244612680602184, 23.207284411710162, 0.3754953999999999, 145.0, 651, 347273, 485, 13.617162200000166
486, 7.928141667972522, 19.270234469143624, 23.336037583567542, 0.3743344, 185.0, 639, 347912, 486, 12.747228000000177
487, 7.5825714218625615, 19.23509662622332, 23.334793090820312, 0.3731716, 125.0, 653, 348565, 487, 13.686005300000033
488, 1.8336135155413553, 19.138615294097086, 22.98262990051632, 0.3722806000000001, 35.0, 337, 348902, 488, 6.767134400000032
489, 4.477641011428067, 19.254951372489135, 23.155076212603564, 0.3715011999999998, 45.0, 529, 349431, 489, 11.224959899999703
490, 5.627199299916949, 19.37718152999878, 23.33520129970882, 0.3703627, 200.0, 736, 350167, 490, 14.728810099999464
491, 2.0342728350825663, 19.711634790637593, 23.70005710361656, 0.3689568999999999, 475.0, 826, 350993, 491, 17.194418600000063
492, 6.249470891617967, 19.71063151850694, 23.805223870308488, 0.36752319999999994, 140.0, 767, 351760, 492, 15.90308079999977
493, 3.3891374154891336, 19.658862754316083, 23.652328994157333, 0.36620830000000004, 115.0, 694, 352454, 493, 13.974649799999497
494, 1.9947585282778297, 19.700629653123322, 23.680027184662997, 0.36524349999999994, 35.0, 378, 352832, 494, 7.9016129999999976
495, 2.6435298734814583, 19.64301752969389, 23.665885479846345, 0.36432909999999996, 215.0, 638, 353470, 495, 13.166923599999791
496, 5.46461058810468, 19.74987039681446, 23.88757010523898, 0.3629367999999999, 160.0, 909, 354379, 496, 18.888885100000152
497, 6.427970544986537, 19.71431230253774, 23.805382442004575, 0.3612052, 455.0, 1015, 355394, 497, 20.959527400000297
498, 3.2058822075640294, 19.685590321856335, 23.7273871629758, 0.35933409999999993, 205.0, 1064, 356458, 498, 21.752998099999786
499, 4.580550341594386, 19.72639192090993, 23.80058560844596, 0.35766909999999985, 155.0, 786, 357244, 499, 16.19559229999959
500, 3.9346869435591545, 19.736696957175013, 23.748486524327284, 0.3558628, 290.0, 1221, 358465, 500, 25.355307599999833
501, 4.032404774637079, 19.695728675803945, 23.745867350592686, 0.35386839999999997, 360.0, 995, 359460, 501, 20.799236400000154
502, 4.244977922990405, 19.726138973093533, 23.766456948980267, 0.3523708, 140.0, 669, 360129, 502, 14.157283300000017
503, 5.360965833912805, 19.960601529386853, 24.0646075160233, 0.35089570000000003, 370.0, 970, 361099, 503, 20.18846620000022
504, 3.154474900261714, 19.871971365121695, 23.910772345616266, 0.3495547, 120.0, 520, 361619, 504, 10.70672409999952
505, 2.54394605605261, 19.797734910913224, 23.81008873485426, 0.34812459999999995, 290.0, 1069, 362688, 505, 22.29097460000048
506, 4.4305615356123, 19.84641567689401, 23.945595880790993, 0.3461904999999998, 265.0, 1080, 363768, 506, 22.506377200000315
507, 5.376228233568568, 19.905227494028818, 24.01932172015705, 0.3442015, 545.0, 1130, 364898, 507, 23.504665499999646
508, 3.9859338889707994, 19.92110403479403, 23.96682080337267, 0.34233129999999995, 280.0, 948, 365846, 508, 20.286186700000144
509, 5.87164616954993, 19.899894019338163, 24.02359091322368, 0.3406086999999999, 310.0, 966, 366812, 509, 20.18485369999962
510, 2.6881539083455404, 19.87778790135029, 23.911313852988, 0.3388681000000001, 170.0, 968, 367780, 510, 20.45254120000027
511, 3.402657093943619, 19.800873114423055, 23.833273324733828, 0.3376278999999999, 85.0, 410, 368190, 511, 8.904714100000092
512, 3.750511012805423, 19.932514797342886, 24.03432557370403, 0.33653169999999993, 255.0, 808, 368998, 512, 17.642922300000464
513, 3.8809882974696106, 19.881784829982493, 23.898696594460066, 0.3351853, 125.0, 688, 369686, 513, 14.707883399999446
514, 2.7642407286136974, 20.27005294096081, 24.413647092769867, 0.33376599999999995, 175.0, 889, 370575, 514, 18.264683200000036
515, 4.275969627362913, 20.574189598038352, 24.736189294848923, 0.3326616999999999, 35.0, 338, 370913, 515, 6.764595099999497
516, 3.4412586621991874, 20.47477705831881, 24.726428460191798, 0.33196869999999995, 80.0, 432, 371345, 516, 9.024372200000471
517, 3.706826658911086, 20.529037508146246, 24.752554315119742, 0.33057820000000004, 415.0, 1113, 372458, 517, 21.771557900000516
518, 6.399824488716754, 20.605278704617476, 24.86519468410595, 0.3289105, 135.0, 740, 373198, 518, 14.551340100000743
519, 4.681862252617668, 20.566177822002643, 24.77955315887353, 0.3274048000000001, 220.0, 933, 374131, 519, 19.73409679999986
520, 5.003653173570757, 20.545992157242082, 24.75093022672025, 0.325666, 290.0, 999, 375130, 520, 21.160248000000138
521, 3.945078391609206, 20.571945653923834, 24.786813238759105, 0.3241558, 105.0, 679, 375809, 521, 14.854849700000159
522, 3.653402609596123, 20.468527965281964, 24.663487636548584, 0.32315409999999994, 120.0, 434, 376243, 522, 9.045430699999997
523, 6.244896294894187, 20.61249976911043, 24.91104328356291, 0.32190850000000004, 260.0, 950, 377193, 523, 20.291072899999563
524, 5.63499032359377, 20.4716948137644, 24.721067430266395, 0.3200302, 445.0, 1137, 378330, 524, 24.131353499999932
525, 4.517931155267611, 20.515550227104864, 24.733114308086485, 0.3185092, 45.0, 553, 378883, 525, 11.603396200000134
526, 3.68989638577808, 20.42425817124387, 24.598985541028256, 0.31708089999999983, 245.0, 1034, 379917, 526, 21.922659399999247
527, 4.6068717221551605, 20.39025990918921, 24.532694203652884, 0.315712, 110.0, 487, 380404, 527, 10.08889679999993
528, 3.985157153881437, 20.402669381179695, 24.604194724225223, 0.3140550999999998, 350.0, 1354, 381758, 528, 28.619333599999663
529, 3.2275456188854688, 20.42502203610345, 24.577552488661304, 0.31152699999999983, 455.0, 1455, 383213, 529, 30.49412459999985
530, 4.914199123572035, 20.363330866956062, 24.48095798060905, 0.3098197, 105.0, 442, 383655, 530, 9.918623300000036
531, 4.081821679055375, 20.419573733326402, 24.70120261161993, 0.30891249999999987, 40.0, 566, 384221, 531, 11.820406800000455
532, 2.9929762539149727, 20.338607483692087, 24.49861747942767, 0.30778839999999996, 390.0, 683, 384904, 532, 14.810932599999433
533, 4.746302329793572, 20.357566389083864, 24.534016582489013, 0.3062737000000001, 310.0, 1000, 385904, 533, 20.961298299999726
534, 5.090380593270063, 20.380180454254152, 24.60297513885498, 0.30424869999999987, 245.0, 1250, 387154, 534, 26.793757200000073
535, 5.859126376775567, 20.38502412784599, 24.589063409131445, 0.30237219999999987, 240.0, 835, 387989, 535, 18.120297100000244
536, 2.1459049809307635, 20.45481808298762, 24.568035870562287, 0.30103299999999994, 160.0, 653, 388642, 536, 13.827751499999977
537, 3.8673206197344956, 20.461914429188486, 24.631519488179737, 0.29984139999999987, 185.0, 671, 389313, 537, 14.651360900000327
538, 2.7650112109868314, 20.34182817061379, 24.479928096498348, 0.2986462, 140.0, 657, 389970, 538, 14.07651949999945
539, 6.484966169597395, 20.508395343893188, 24.809346852255604, 0.29741500000000004, 40.0, 711, 390681, 539, 15.317005799999606
540, 5.88388779014733, 20.524498233598532, 24.723837128865352, 0.29590209999999995, 340.0, 970, 391651, 540, 20.90975669999989
541, 5.258319414147225, 20.553789932476846, 24.805230868490117, 0.2944818999999999, 130.0, 608, 392259, 541, 13.40714349999962
542, 3.9832445373063656, 20.476458205038043, 24.707271402273605, 0.29333170000000003, 100.0, 670, 392929, 542, 14.064574699999866
543, 4.415494773687761, 20.551857848840257, 24.73701897837633, 0.29199519999999995, 230.0, 815, 393744, 543, 17.773408000000018
544, 3.756682998610763, 20.514265395837818, 24.711891159297913, 0.2909187999999999, 105.0, 381, 394125, 544, 8.75025580000056
545, 3.700487550768483, 20.506577148837994, 24.72890672658685, 0.29023299999999996, 35.0, 381, 394506, 545, 8.15416229999937
546, 1.8115610620707914, 20.40272808587679, 24.504708351627475, 0.2895552999999999, 85.0, 372, 394878, 546, 7.935541499999999
547, 5.287956194887901, 20.538363034276177, 24.768492731554755, 0.28888119999999995, 60.0, 377, 395255, 547, 7.97254889999931
548, 5.793360458343462, 20.507612165482506, 24.722571194261267, 0.28794159999999985, 150.0, 667, 395922, 548, 14.776362900000095
549, 5.2702694612851975, 20.534868986771144, 24.769719786230862, 0.2861154999999998, 550.0, 1362, 397284, 549, 29.288132899999255
550, 2.844553295994367, 20.49037681087371, 24.65366642528373, 0.2841642999999999, 235.0, 806, 398090, 550, 17.613387700000203
551, 3.9529275140841738, 20.47871301331085, 24.67847027545775, 0.2825910999999999, 260.0, 942, 399032, 551, 20.541570800000045
552, 5.030487169228434, 20.580154983396454, 24.78993915774958, 0.2811898, 125.0, 615, 399647, 552, 13.109229300000152
553, 3.7883808838782866, 20.647240922042016, 24.846774818175675, 0.27999099999999993, 145.0, 717, 400364, 553, 15.952838399999564
554, 2.0042679269093178, 20.751632690429688, 24.960003131002352, 0.27901989999999993, 50.0, 362, 400726, 554, 7.77265879999959
555, 8.148278930375463, 20.79170801092304, 25.151208580592662, 0.27813339999999986, 220.0, 623, 401349, 555, 13.85070160000032
556, 4.037365227752233, 20.668747869990927, 24.893126758690045, 0.2765242, 445.0, 1165, 402514, 556, 25.013147099999514
557, 4.998474413353418, 20.787174186706544, 25.037026743207658, 0.27484569999999997, 120.0, 700, 403214, 557, 14.475079200000437
558, 5.849199124597586, 20.766149497398963, 25.07111927325909, 0.27363069999999995, 155.0, 650, 403864, 558, 13.788643900000352
559, 3.2138743640189724, 20.62767913000924, 24.79762739113399, 0.27254169999999994, 110.0, 560, 404424, 559, 12.03770379999969
560, 2.9346689735495923, 20.72945294008139, 24.96715018095591, 0.27078039999999987, 675.0, 1397, 405821, 560, 28.87298760000067
561, 3.3174271224278864, 20.733567033712855, 24.9570521881786, 0.268678, 520.0, 939, 406760, 561, 19.65699029999996
562, 7.7545485240837415, 20.69779298200186, 24.99872986092625, 0.2669364999999999, 145.0, 996, 407756, 562, 20.34442880000006
563, 4.666139338625527, 20.73166205525881, 24.983405779247825, 0.26515089999999997, 290.0, 988, 408744, 563, 20.862656600000264
564, 5.03906800225977, 20.7179708281193, 24.941351674029217, 0.26370279999999996, 170.0, 621, 409365, 564, 13.413193599999431
565, 3.497508619688839, 20.679799122114975, 24.90988263984521, 0.26245270000000004, 140.0, 768, 410133, 565, 15.838096999999834
566, 4.241158166403254, 20.744018691275127, 25.04153148719417, 0.2607057999999998, 415.0, 1173, 411306, 566, 24.38269120000041
567, 5.838465562218092, 20.720623711944086, 24.977185200064017, 0.25848279999999996, 315.0, 1297, 412603, 567, 27.19026980000035
568, 4.913008270280886, 20.769664307650533, 25.018549435979335, 0.2565676, 230.0, 831, 413434, 568, 17.7073163999994
569, 4.404739643066701, 20.720330407202123, 24.97177694884824, 0.25492509999999996, 390.0, 994, 414428, 569, 21.08103630000005
570, 4.879338795806493, 20.726208768438884, 25.004568832136307, 0.25366239999999995, 30.0, 409, 414837, 570, 9.14819929999976
571, 5.468228830311161, 20.8266464976164, 25.222256513742302, 0.2529199, 50.0, 416, 415253, 571, 8.599206800000502
572, 7.71124850901684, 20.65085298633803, 24.924141444568132, 0.2521683999999999, 90.0, 419, 415672, 572, 8.751887299999908
573, 3.998738190462162, 20.799806039017366, 25.03334731653512, 0.25119369999999996, 220.0, 664, 416336, 573, 14.355463599999894
574, 2.6814056108202413, 20.723680516229972, 24.921389678843, 0.24973839999999994, 260.0, 953, 417289, 574, 20.304677199999787
575, 3.684860123471485, 20.745560503683947, 24.977248053980098, 0.24812109999999993, 140.0, 844, 418133, 575, 18.081556299999647
576, 3.7907659028607763, 20.753345692206008, 25.026388226250404, 0.24647229999999998, 410.0, 988, 419121, 576, 21.100651699999617
577, 7.782786136771242, 20.7554779586792, 25.138840995788573, 0.24490809999999996, 410.0, 750, 419871, 577, 15.456913399999394
578, 5.178493037412409, 21.43867216176457, 25.85098183486197, 0.24319629999999995, 310.0, 1152, 421023, 578, 24.60217669999929
579, 1.8207037088378017, 21.502788681118222, 25.865245192470056, 0.2418471999999999, 60.0, 347, 421370, 579, 8.233990400000039
580, 5.209457372617566, 21.526072805507344, 25.941324576273633, 0.2409831999999999, 195.0, 613, 421983, 580, 13.432500599999912
581, 3.9336934528852763, 21.406621298184707, 25.76494320848778, 0.23985009999999998, 175.0, 646, 422629, 581, 14.704189999999471
582, 4.430365238828318, 21.50866368248349, 25.908999201456705, 0.23879619999999996, 120.0, 525, 423154, 582, 11.533309699999336
583, 4.846094796898308, 21.46374460741564, 25.923558292446195, 0.23772430000000003, 100.0, 666, 423820, 583, 15.17807189999985
584, 3.4531546089113974, 21.53068412469358, 25.923725334478885, 0.2366838999999999, 30.0, 490, 424310, 584, 10.72835269999996
585, 4.47668415243693, 21.557851397801958, 25.966741189124093, 0.23533569999999995, 550.0, 1008, 425318, 585, 22.633276999999907
586, 4.095894268167944, 21.413880592496525, 25.81694360319617, 0.2336976999999999, 140.0, 812, 426130, 586, 18.333086200000253
587, 6.766748476377688, 21.494062048196792, 25.964790123701096, 0.23239089999999996, 110.0, 640, 426770, 587, 14.725194999999985
588, 3.794028029027017, 21.468948972547377, 25.88776096653294, 0.23148189999999985, 50.0, 370, 427140, 588, 8.140253000000484
589, 3.5875176526878665, 21.48220368129451, 25.91057370116071, 0.23041089999999992, 395.0, 820, 427960, 589, 18.513529599999856
590, 2.6273709456375496, 21.477355865018453, 25.870952236233045, 0.22877739999999994, 440.0, 995, 428955, 590, 22.44628069999999
591, 4.0461809228717405, 21.54541838984536, 25.966815297689035, 0.22677670000000005, 195.0, 1228, 430183, 591, 27.711915199999567
592, 3.5946860633305544, 22.004955215002656, 26.51890455392691, 0.22491099999999994, 245.0, 845, 431028, 592, 19.35907809999935
593, 1.8710854718293048, 21.878986661797327, 26.321024652611605, 0.22333509999999993, 135.0, 906, 431934, 593, 19.99167850000049
594, 5.81479768460716, 22.060599383871065, 26.605412004194186, 0.22193019999999988, 155.0, 655, 432589, 594, 15.12342869999975
595, 2.073440512469077, 21.931500932523377, 26.436129213510473, 0.2208663999999999, 35.0, 527, 433116, 595, 12.251726999999846
596, 1.6810699881880917, 21.947284074635032, 26.368683894262237, 0.22005639999999999, 80.0, 373, 433489, 596, 8.222389499999736
597, 6.583140454628735, 22.024147005933735, 26.57696895837288, 0.21885489999999994, 225.0, 962, 434451, 597, 21.83924139999999
598, 3.3826762614229686, 21.970175455486963, 26.436240115493693, 0.21764889999999998, 105.0, 378, 434829, 598, 8.349300400000175
599, 4.333940643362189, 22.011035256713402, 26.55676519233762, 0.2166013, 270.0, 786, 435615, 599, 18.079644200000075
600, 6.195440177979812, 21.956235541549383, 26.451910654703777, 0.2152053999999999, 275.0, 765, 436380, 600, 17.552361699999892
601, 4.019716303022558, 21.996633815975905, 26.524847582212875, 0.21370149999999996, 190.0, 906, 437286, 601, 20.2312965000001
602, 4.550435475938222, 21.98315984587132, 26.47818902720245, 0.2119834, 165.0, 1003, 438289, 602, 22.530152799999996
603, 3.6227728242383286, 22.009483922298067, 26.5367994023381, 0.21014739999999998, 410.0, 1037, 439326, 603, 23.819607399999768
604, 3.9266652810429834, 21.917812011729985, 26.40378173777562, 0.20799189999999992, 500.0, 1358, 440684, 604, 31.102647400000023
605, 6.641606882982224, 21.8994021727168, 26.429148864395156, 0.20579139999999993, 420.0, 1087, 441771, 605, 24.8279407
606, 4.735638976447448, 21.900185944767458, 26.391379433116693, 0.20395180000000002, 210.0, 957, 442728, 606, 21.386494299999868
607, 5.013742052521666, 21.93526148189537, 26.46838657356755, 0.20217069999999998, 280.0, 1022, 443750, 607, 23.265767899999446
608, 7.835882346649196, 21.97851213780395, 26.532892118774562, 0.20050659999999995, 205.0, 827, 444577, 608, 19.09775290000016
609, 5.665733983470995, 21.937133082377937, 26.413070864827862, 0.19853559999999995, 415.0, 1363, 445940, 609, 31.595406299999922
610, 3.6211662920928704, 21.933687331928375, 26.392475744430204, 0.1965762999999999, 170.0, 814, 446754, 610, 18.32340000000022
611, 4.476589977462194, 21.83850379115187, 26.41354800877946, 0.19536309999999996, 85.0, 534, 447288, 611, 12.63327769999978
612, 5.403686041877569, 21.833656978086044, 26.2709074802086, 0.19455309999999998, 55.0, 366, 447654, 612, 8.297171799999887
613, 3.7125224389959968, 21.841299786874174, 26.293921624598482, 0.19301949999999998, 290.0, 1338, 448992, 613, 29.145034199999827
614, 3.115197242783164, 21.872683889585883, 26.30037343035389, 0.19055079999999985, 530.0, 1405, 450397, 614, 30.771533399999498
615, 6.385549448358799, 21.864994857137436, 26.437369080324448, 0.18863199999999994, 200.0, 727, 451124, 615, 16.204177000000527
616, 7.641783266218436, 21.785835296358652, 26.33471736964669, 0.18706959999999992, 350.0, 1009, 452133, 616, 21.81753740000022
617, 3.1030140590938653, 21.79262908010772, 26.24272157784664, 0.18556749999999997, 80.0, 660, 452793, 617, 14.530520499999511
618, 6.284566757755532, 21.768705975007517, 26.20739288438143, 0.18402039999999992, 370.0, 1059, 453852, 618, 23.205892699999822
619, 4.260503335744143, 21.801390831687232, 26.287100070606577, 0.18207729999999991, 305.0, 1100, 454952, 619, 24.301476499999808
620, 5.7302584463306765, 21.806593997284068, 26.243417262348835, 0.18045819999999996, 160.0, 699, 455651, 620, 15.712568699999792
621, 3.8485209035010137, 21.761751894581362, 26.21131357143726, 0.17885349999999992, 240.0, 1084, 456735, 621, 23.930683700000372
622, 3.9006340595830102, 21.839943255289263, 26.281530533047672, 0.17690049999999996, 240.0, 1086, 457821, 622, 24.21501619999981
623, 4.51987756446688, 21.75923742267662, 26.197197143189207, 0.17547219999999994, 60.0, 501, 458322, 623, 10.821597100000872
624, 2.8405844868857018, 21.749735822955383, 26.169624657306855, 0.17427969999999993, 230.0, 824, 459146, 624, 17.734954900000048
625, 2.048602321677595, 21.704365724804756, 26.073252562818855, 0.17322490000000001, 60.0, 348, 459494, 625, 8.21165689999998
626, 2.9873574459204457, 21.826659908235627, 26.2655716237638, 0.17233029999999996, 135.0, 646, 460140, 626, 14.024523500000214
627, 3.516684416480812, 21.983657919127367, 26.446968347861848, 0.1709136999999999, 200.0, 928, 461068, 627, 20.606224199999815
628, 5.7837810646266785, 22.00805252638197, 26.50161510564972, 0.16912719999999998, 340.0, 1057, 462125, 628, 23.626184899999316
629, 5.871084786440839, 22.046952932550994, 26.610908222125854, 0.1669941999999999, 350.0, 1313, 463438, 629, 28.933091100000638
630, 3.5203412555303695, 22.016824459127164, 26.475784567249562, 0.16507539999999993, 245.0, 819, 464257, 630, 17.844132499999432
631, 4.0428494694165, 22.055561672467643, 26.581364436964915, 0.16346979999999997, 295.0, 965, 465222, 631, 21.53201589999935
632, 2.6679274593574194, 22.009422663252362, 26.47157335281372, 0.16171209999999991, 130.0, 988, 466210, 632, 22.208406700000523
633, 4.2830880290107025, 22.071883237914534, 26.61753109906683, 0.1597356999999999, 235.0, 1208, 467418, 633, 28.295641599999726
634, 5.870716232212638, 22.047328415490632, 26.586683763776506, 0.1580499999999999, 115.0, 665, 468083, 634, 15.896921900000052
635, 2.644993685000802, 22.014756938389368, 26.446824593869795, 0.15672699999999992, 120.0, 805, 468888, 635, 18.773549499999717
636, 3.70904906782402, 21.997875189418114, 26.476893337850036, 0.1556478999999999, 65.0, 394, 469282, 636, 9.310617699999966
637, 4.298519649746595, 22.032509265467525, 26.542026791721582, 0.15437169999999995, 270.0, 1024, 470306, 637, 25.473850700000185
638, 4.874998378770378, 22.334219162280743, 26.895102354196403, 0.1528884999999999, 120.0, 624, 470930, 638, 14.986156199999641
639, 3.2167630723025993, 22.29879787640694, 26.82212325854179, 0.15183549999999993, 90.0, 546, 471476, 639, 12.44887910000034
640, 5.125764697540173, 22.37518549098773, 26.925481643392345, 0.15037839999999994, 225.0, 1073, 472549, 640, 25.221563599999172
641, 3.001823620900182, 22.316801059095166, 26.853999484943436, 0.14884389999999992, 190.0, 632, 473181, 641, 15.259529999999359
642, 3.7253018075866358, 22.301739948514907, 26.842405199626135, 0.14714109999999994, 485.0, 1260, 474441, 642, 29.457198699999935
643, 4.4589367459370255, 22.29669814613586, 26.889920009734883, 0.14527449999999992, 240.0, 814, 475255, 643, 19.416938700000173
644, 4.9444840155470935, 22.29720918927874, 26.85960967290969, 0.1435968999999999, 210.0, 1050, 476305, 644, 24.79900330000055
645, 4.7011556858083, 22.2915930444862, 26.81367868549375, 0.14117949999999993, 985.0, 1636, 477941, 645, 38.40751700000055
646, 2.0433203384710636, 22.32086865610073, 26.798938231750235, 0.13905279999999987, 130.0, 727, 478668, 646, 17.591243200000463
647, 4.5360212129820985, 22.331079497525756, 26.872963864752588, 0.13780629999999988, 65.0, 658, 479326, 647, 15.936882999999398
648, 2.3714816863853603, 22.370375135409756, 26.859147122820968, 0.13664169999999992, 105.0, 636, 479962, 648, 14.836273800000527
649, 5.253570336795363, 22.4094742413746, 27.020242573153197, 0.1355014, 80.0, 631, 480593, 649, 15.336687600000005
650, 4.842553511387385, 22.28476276500929, 26.817589011453247, 0.13343679999999988, 445.0, 1663, 482256, 650, 39.279847799999516
651, 2.103400854138683, 22.344183373124633, 26.858494650827694, 0.1314144999999999, 115.0, 584, 482840, 651, 13.752953899999738
652, 7.685929963054757, 22.408669040316628, 26.999320030212402, 0.1302840999999999, 110.0, 672, 483512, 652, 16.417519700000412
653, 4.2288552311088345, 22.34190640396996, 26.885786976341517, 0.12894399999999992, 230.0, 817, 484329, 653, 19.73113639999974
654, 3.232389326446723, 22.227500944155466, 26.774724155161216, 0.12772899999999995, 30.0, 533, 484862, 654, 12.642088300000069
655, 2.6571053450580195, 22.235840834142266, 26.73886868162284, 0.1263843999999999, 485.0, 961, 485823, 655, 23.101769500000046
656, 4.7205365662091445, 22.282485693435802, 26.85350986342356, 0.1244772999999999, 270.0, 1158, 486981, 656, 27.652960299999904
657, 6.368820705380377, 22.279003772798543, 26.965835823084262, 0.12288969999999994, 50.0, 606, 487587, 657, 14.807530200000656
658, 3.9093022594666658, 22.257932152467614, 26.7501195935642, 0.1217323, 180.0, 680, 488267, 658, 16.461601699999846
659, 5.882320925979963, 22.341135231953746, 26.943503930883587, 0.12035709999999995, 180.0, 848, 489115, 659, 19.9419269
660, 4.3878741292908545, 22.284694466149702, 26.82505291647482, 0.11888379999999994, 240.0, 789, 489904, 660, 19.12558319999971
661, 3.7068879583398364, 21.939452568966892, 26.350790014942625, 0.11739879999999987, 255.0, 861, 490765, 661, 20.838068300000486
662, 4.1569738539795935, 21.836755217111783, 26.3276883312238, 0.11608209999999995, 160.0, 602, 491367, 662, 14.898878299999524
663, 3.062202850707825, 21.864990071719596, 26.343354437466797, 0.11453769999999991, 525.0, 1114, 492481, 663, 25.967881699999452
664, 2.885851363277262, 21.80629711491721, 26.229211017489433, 0.11272869999999993, 250.0, 896, 493377, 664, 20.585843400000158
665, 6.306748673393503, 21.861925391312482, 26.374625927013355, 0.11110329999999996, 210.0, 910, 494287, 665, 21.347878300000048
666, 4.702531526199259, 21.841277189876724, 26.306872319484103, 0.10929069999999994, 315.0, 1104, 495391, 666, 25.95309670000006
667, 4.94533867404816, 21.800474010339986, 26.287659326222894, 0.10770489999999991, 125.0, 658, 496049, 667, 16.303275200000826
668, 5.137654186486017, 21.75912327684531, 26.218418028112133, 0.10643139999999993, 160.0, 757, 496806, 668, 18.545403899999656
669, 4.636323152977469, 21.84284641453587, 26.31036515897942, 0.10472589999999991, 250.0, 1138, 497944, 669, 27.567014399999607
670, 3.855773397579995, 21.849065834660415, 26.35660768507526, 0.10246239999999994, 625.0, 1377, 499321, 670, 33.194481200000155
671, 3.3242104823015772, 21.880080608151992, 26.378362421719533, 0.10074609999999996, 85.0, 530, 499851, 671, 12.847705500000302
672, 2.9199515060949106, 21.974051845593053, 26.41804886443999, 0.10002037993920841, 335.0, 987, 500838, 672, 23.99641149999934
673, 4.680976611945853, 21.99210397605128, 26.53246338351461, 0.10000000000000006, 140.0, 745, 501583, 673, 18.372730000000047
674, 3.5050373710196325, 22.0741857076167, 26.58834830831794, 0.09999999999999906, 275.0, 902, 502485, 674, 22.299285099999906
675, 6.010872495354337, 22.04898735292915, 26.60948499205972, 0.09999999999999795, 365.0, 1176, 503661, 675, 28.607961099999557
676, 1.9203352045368698, 21.910652376466377, 26.33170556929863, 0.09999999999999845, 305.0, 1034, 504695, 676, 25.462221600000703
677, 2.8934825239723803, 21.982202423707413, 26.462575988939452, 0.09999999999999908, 290.0, 898, 505593, 677, 22.16777759999968
678, 6.857687531103906, 22.030595424900884, 26.594824550462807, 0.09999999999999896, 220.0, 920, 506513, 678, 22.91069620000053
679, 2.7511533947306215, 21.970759961416725, 26.433337920892676, 0.09999999999999844, 150.0, 1038, 507551, 679, 25.69729550000011
680, 4.648436119442894, 22.050695935203915, 26.53011442638579, 0.10000000000000091, 105.0, 525, 508076, 680, 12.72190369999953
681, 3.775532923752715, 22.018188432827117, 26.533238820361483, 0.09999999999999977, 125.0, 785, 508861, 681, 19.026129100000617
682, 5.350880416395884, 21.967162037821648, 26.526311502178896, 0.09999999999999847, 325.0, 1030, 509891, 682, 25.25800639999943
683, 5.5215850212755475, 22.191925639555524, 26.84680557751593, 0.10000000000000071, 55.0, 381, 510272, 683, 9.879597099999955
684, 4.94222846649544, 22.08924907357633, 26.609683625711906, 0.09999999999999708, 630.0, 1553, 511825, 684, 37.673073699999804
685, 5.633070132019179, 22.221172790373526, 26.743469715118408, 0.10000000000000088, 15.0, 496, 512321, 685, 12.636377699998775
686, 3.1221694223272993, 22.1027530664502, 26.612159469876364, 0.09999999999999751, 505.0, 1347, 513668, 686, 33.056543099999544
687, 6.7912764078257295, 22.242994043264495, 26.81263816490602, 0.10000000000000032, 145.0, 712, 514380, 687, 17.83678190000137
688, 3.239094628919182, 22.14075302055904, 26.62467932360513, 0.09999999999999813, 500.0, 1120, 515500, 688, 27.62340889999905
689, 5.526078496462501, 22.166543472514434, 26.702320250342876, 0.1000000000000006, 145.0, 680, 516180, 689, 17.072450800000297
690, 3.3255299656425863, 22.16604127606142, 26.681157139898502, 0.1000000000000009, 10.0, 515, 516695, 690, 12.566772600001059
691, 4.74335970731163, 22.080475997521987, 26.58769367060918, 0.09999999999999883, 265.0, 947, 517642, 691, 23.425096399998438
692, 6.95427835297108, 22.180226864112207, 26.784338338248034, 0.100000000000001, 190.0, 638, 518280, 692, 16.10288010000113
693, 1.9915767628278604, 22.102329553183864, 26.531752473216947, 0.10000000000000035, 195.0, 708, 518988, 693, 16.879850799999986
694, 5.792814648952413, 22.12606245685519, 26.697001994402253, 0.10000000000000027, 225.0, 719, 519707, 694, 17.41128899999967
695, 4.2311329305527385, 22.75228208198143, 27.425181058607336, 0.10000000000000095, 160.0, 566, 520273, 695, 13.829462100000455
696, 4.843099167033365, 23.238734252564406, 28.046966060850124, 0.09999999999999896, 120.0, 919, 521192, 696, 21.869271600000502
697, 4.40320819404797, 23.214069588709688, 27.990882569113694, 0.09999999999999734, 380.0, 1416, 522608, 697, 33.063101099998676
698, 3.7168909567327777, 23.264549071700486, 27.99848486582438, 0.0999999999999996, 245.0, 810, 523418, 698, 19.547293400000854
699, 4.176891634877808, 23.26211390666154, 28.008145208079185, 0.10000000000000098, 110.0, 614, 524032, 699, 14.913114199998745
700, 4.045960515888168, 23.297733013218334, 28.012053342851843, 0.10000000000000096, 170.0, 643, 524675, 700, 15.197782299999744
701, 4.669426540999215, 23.250997093266015, 27.96630397691373, 0.09999999999999838, 360.0, 1051, 525726, 701, 24.880054699999164
702, 5.272435161088802, 23.255299678506262, 27.993982018835005, 0.10000000000000099, 55.0, 631, 526357, 702, 15.406990699999369
703, 4.749252645677487, 23.241737964951284, 27.996869147925405, 0.10000000000000087, 195.0, 487, 526844, 703, 11.400003700000525
704, 8.073008565948559, 23.230411641581075, 27.996600061696725, 0.1000000000000003, 165.0, 715, 527559, 704, 17.355313600000954
705, 4.622598679786212, 23.280163088977567, 28.02015179601209, 0.09999999999999841, 315.0, 1044, 528603, 705, 24.950890199999776
706, 4.572000087781267, 23.241837876183645, 27.996012216085916, 0.10000000000000019, 235.0, 728, 529331, 706, 16.998564699999406
707, 5.3886804335745815, 23.34118536222784, 28.118619454339377, 0.10000000000000073, 20.0, 386, 529717, 707, 9.764378599998963
708, 4.487611822034947, 23.26486240366779, 28.04120424310997, 0.09999999999999998, 500.0, 756, 530473, 708, 17.888754499999777
709, 4.900490248785508, 23.2410974018358, 27.978169199120394, 0.09999999999999903, 165.0, 906, 531379, 709, 21.77797869999995
710, 4.308659091716011, 23.299549749162463, 28.043245121284766, 0.10000000000000092, 65.0, 540, 531919, 710, 13.451196100000743
711, 5.256476896638289, 23.30658701546172, 28.064125664213783, 0.09999999999999797, 305.0, 1170, 533089, 711, 28.786407500001587
712, 4.524820093749168, 23.31338523121809, 28.09953944602709, 0.10000000000000092, 105.0, 534, 533623, 712, 15.052102300000115
713, 5.987627941200085, 23.322476822033263, 28.078419262066223, 0.09999999999999806, 430.0, 1140, 534763, 713, 28.929279199999655
714, 5.727794477711357, 23.280149177208884, 28.06398918868928, 0.09999999999999794, 770.0, 1181, 535944, 714, 29.58873019999919
715, 5.720740314403236, 23.29672117858191, 28.07248672800526, 0.10000000000000041, 185.0, 702, 536646, 715, 17.96171030000005
716, 3.6637722987745582, 23.28347151473868, 28.006241315424187, 0.09999999999999891, 250.0, 932, 537578, 716, 23.501422100000127
717, 5.296606538885584, 23.32306077162425, 28.1204495938619, 0.09999999999999788, 350.0, 1200, 538778, 717, 30.24202560000049
718, 2.1988680673970116, 23.342683627870347, 28.0478434615665, 0.10000000000000067, 20.0, 360, 539138, 718, 8.995059400000173
719, 4.820041908102435, 23.420206216538713, 28.214197982366425, 0.09999999999999801, 610.0, 1158, 540296, 719, 30.047089299998333
720, 5.148752401201901, 23.582208041711286, 28.41451680551876, 0.09999999999999676, 565.0, 1760, 542056, 720, 44.67847470000015
721, 7.679027978557877, 23.72029804853191, 28.60064266659216, 0.10000000000000024, 80.0, 722, 542778, 721, 18.00307480000083
722, 5.219773864289445, 23.523687116561398, 28.34216425188126, 0.10000000000000099, 125.0, 620, 543398, 722, 16.07496910000009
723, 7.738032721658109, 23.667467568329027, 28.571287673612986, 0.09999999999999905, 165.0, 905, 544303, 723, 23.20175829999971
724, 2.778023224290667, 23.540111231249433, 28.249932816288766, 0.09999999999999815, 215.0, 1118, 545421, 724, 28.44433240000035
725, 5.980488146527046, 23.644840439581476, 28.502439747058677, 0.09999999999999756, 225.0, 1322, 546743, 725, 34.099677000000156
726, 3.7864959445428594, 23.65697638117897, 28.445207538923388, 0.09999999999999942, 170.0, 838, 547581, 726, 21.70497350000005
727, 4.293824725376091, 23.61971267188395, 28.415845579364557, 0.09999999999999766, 485.0, 1282, 548863, 727, 32.53325919999952
728, 3.202387036297184, 23.627875085977408, 28.406245026221644, 0.10000000000000091, 50.0, 520, 549383, 728, 13.17072189999999
729, 4.232935153578051, 23.69828195239774, 28.54134415868503, 0.10000000000000075, 20.0, 402, 549785, 729, 10.8833551000007
730, 2.224573712154801, 23.146150331351752, 27.804196226830577, 0.09999999999999898, 180.0, 918, 550703, 730, 23.63673580000068
731, 4.167838095721674, 23.11001411694508, 27.82342656936149, 0.09999999999999895, 165.0, 922, 551625, 731, 23.641421100001025
732, 3.037599564611743, 23.132033429132306, 27.792053527940098, 0.10000000000000038, 115.0, 706, 552331, 732, 18.10032460000002
733, 4.107049272108659, 23.156740128619116, 27.86280257147063, 0.10000000000000099, 130.0, 636, 552967, 733, 16.683412399999725
734, 4.79187788985521, 23.220666663218896, 27.964938176766523, 0.0999999999999988, 415.0, 953, 553920, 734, 24.610141199998907
735, 4.5095240719194, 23.106877739955777, 27.80065484041184, 0.09999999999999948, 140.0, 829, 554749, 735, 21.020161200000075
736, 6.170073333159717, 23.075206330652986, 27.826260182294952, 0.09999999999999733, 360.0, 1424, 556173, 736, 37.06395639999937
737, 5.006292900339988, 23.118896328428256, 27.75876197974887, 0.10000000000000085, 85.0, 477, 556650, 737, 12.224264000000403
738, 3.131952363935, 23.09270823988306, 27.70284539820603, 0.10000000000000031, 70.0, 713, 557363, 738, 18.434337400000004
739, 4.909942739714358, 23.137558272125524, 27.890623862590264, 0.10000000000000085, 160.0, 654, 558017, 739, 17.16032500000074
740, 4.294791105576718, 23.065891969039143, 27.731572731299334, 0.09999999999999924, 190.0, 868, 558885, 740, 22.539868700001534
741, 3.0333624242541157, 23.06288764104678, 27.731810084657173, 0.10000000000000049, 155.0, 692, 559577, 741, 18.517060299998775
742, 5.404349164127795, 22.762607023405877, 27.46039570318356, 0.09999999999999888, 415.0, 938, 560515, 742, 24.48588380000001
743, 4.185867592730349, 22.58851302143995, 27.221525567508742, 0.09999999999999867, 235.0, 981, 561496, 743, 25.51973679999901
744, 3.800524992140604, 22.48442462524633, 27.076778261464984, 0.09999999999999942, 305.0, 837, 562333, 744, 21.88899929999934
745, 7.665275826210492, 22.547085281278267, 27.19037977202994, 0.0999999999999987, 390.0, 976, 563309, 745, 25.36924480000016
746, 8.176122334530188, 22.726538139165832, 27.56305633367494, 0.1000000000000008, 80.0, 430, 563739, 746, 11.05917220000083
747, 9.438503750106037, 22.52751008308295, 27.154151533589218, 0.10000000000000091, 50.0, 528, 564267, 747, 14.084648500000185
748, 5.551813711791853, 22.53112556360945, 27.10869970200937, 0.10000000000000074, 65.0, 395, 564662, 748, 10.243646800001443
749, 2.078414537650469, 22.42487455720771, 26.895275125764822, 0.10000000000000096, 125.0, 584, 565246, 749, 15.469129799999791
750, 5.216294046021937, 22.518331134222386, 27.082929366972387, 0.09999999999999866, 220.0, 984, 566230, 750, 25.79818019999948
751, 5.92601209817403, 22.463770705990108, 27.09417697778171, 0.10000000000000085, 120.0, 654, 566884, 751, 16.87574919999861
752, 7.161729383249493, 22.461458809235516, 27.10995831489563, 0.1000000000000006, 195.0, 680, 567564, 752, 17.96827839999969
753, 6.199129849874679, 22.47959972899637, 27.06866818651741, 0.0999999999999996, 210.0, 810, 568374, 753, 21.213215199999468
754, 5.102570235426507, 22.47542852749206, 27.0655580973094, 0.09999999999999992, 165.0, 763, 569137, 754, 18.678315200000725
755, 3.8310938870445606, 22.416246575653236, 26.98356928648772, 0.10000000000000071, 40.0, 378, 569515, 755, 9.84908759999962
756, 5.140323571163157, 22.603176773254283, 27.26549503812051, 0.09999999999999826, 195.0, 1084, 570599, 756, 27.013635799999975
757, 7.481806678227756, 22.870007506660794, 27.58812594206437, 0.10000000000000064, 30.0, 345, 570944, 757, 8.693142899999657
758, 6.162840011535215, 22.849265257708307, 27.54287261321765, 0.09999999999999945, 250.0, 833, 571777, 758, 20.707212899998922
759, 6.762861184217035, 22.903505861057955, 27.657861204708325, 0.1000000000000006, 115.0, 680, 572457, 759, 16.64817099999891
760, 3.5781148180541433, 22.8441574686075, 27.45974460487202, 0.09999999999999891, 115.0, 932, 573389, 760, 23.31286369999907
761, 2.9037157312054567, 22.84904758054383, 27.46347349030631, 0.09999999999999977, 350.0, 784, 574173, 761, 19.73924260000058
762, 4.367482016375964, 22.816615558654036, 27.449295439449042, 0.09999999999999909, 200.0, 897, 575070, 762, 21.989072400001533
763, 5.670371043604415, 22.831264475962563, 27.482303293960353, 0.09999999999999837, 315.0, 1055, 576125, 763, 27.197494500000175
764, 1.8494258284476803, 22.77589053872191, 27.315368727695795, 0.10000000000000075, 80.0, 405, 576530, 764, 11.18385809999927
765, 4.060854766868689, 22.738460423878667, 27.354959738806937, 0.10000000000000071, 145.0, 669, 577199, 765, 17.965324599999803
766, 6.596744790320412, 22.843434810163018, 27.546776698332128, 0.09999999999999858, 220.0, 1003, 578202, 766, 26.071685799999614
767, 3.462354572542874, 22.892955023604507, 27.539048547762846, 0.09999999999999837, 345.0, 1054, 579256, 767, 28.222027199999502
768, 5.1244248528348395, 22.76470003934188, 27.386375381615743, 0.10000000000000099, 100.0, 627, 579883, 768, 16.291699899999003
769, 4.758381915389636, 23.12813693447469, 27.819203966488285, 0.10000000000000045, 85.0, 697, 580580, 769, 18.71783950000099
770, 2.928305831197161, 23.02138684126322, 27.62756075126848, 0.09999999999999833, 565.0, 1068, 581648, 770, 28.23091000000022
771, 5.074545430594035, 23.189008235407975, 27.934000553336286, 0.099999999999999, 150.0, 911, 582559, 771, 24.454556999999113
772, 3.6657312223382417, 23.11104809065334, 27.781054150862772, 0.0999999999999987, 250.0, 976, 583535, 772, 26.10512479999852
773, 2.9844482206937037, 23.075796253237375, 27.718307061628863, 0.09999999999999895, 240.0, 924, 584459, 773, 24.775469500000327
774, 4.947386997379939, 23.094729652837827, 27.799074121796064, 0.09999999999999873, 165.0, 969, 585428, 774, 25.952152600000773
775, 5.324090851727744, 23.163533249120604, 27.843584323751514, 0.10000000000000046, 110.0, 696, 586124, 775, 18.80753630000072
776, 5.293181972231205, 23.174984959995044, 27.930838804618986, 0.10000000000000075, 60.0, 408, 586532, 776, 11.246559799999886
777, 5.603463103320518, 23.15828881234479, 27.887001366703057, 0.0999999999999976, 560.0, 1304, 587836, 777, 34.6919498999996
778, 7.899029645278598, 23.120872236089443, 27.88790657131531, 0.10000000000000049, 125.0, 693, 588529, 778, 18.705626900000425
779, 3.956735030619138, 23.145245347787583, 27.8423568604188, 0.09999999999999955, 235.0, 817, 589346, 779, 21.733035899998868
780, 5.263460866308248, 23.155823137616622, 27.84624925689025, 0.1000000000000006, 60.0, 681, 590027, 780, 18.75180249999903
781, 6.223039820303493, 23.23812058539305, 28.036153996663046, 0.09999999999999727, 195.0, 1454, 591481, 781, 39.22828949999894
782, 3.9167504375395565, 23.38045398970157, 28.118141671885613, 0.10000000000000077, 15.0, 414, 591895, 782, 10.860812099999748
783, 4.965709435785846, 23.257349088174667, 27.980712564266717, 0.09999999999999777, 260.0, 1239, 593134, 783, 34.022655900000245
784, 6.9835226181268055, 23.239736459996486, 28.052443076392684, 0.09999999999999783, 385.0, 1219, 594353, 784, 32.509652599999754
785, 4.528697791930339, 23.249527058298533, 27.947214827294072, 0.09999999999999964, 205.0, 803, 595156, 785, 21.678041900000608
786, 4.280273678320781, 23.273121129955992, 27.967685319914924, 0.10000000000000074, 25.0, 397, 595553, 786, 10.655684100000144
787, 2.6202589532024927, 23.23288411087131, 27.876420009210243, 0.10000000000000096, 135.0, 644, 596197, 787, 17.429222000000664
788, 3.885419640358518, 23.11578355160059, 27.795886863588663, 0.10000000000000071, 50.0, 382, 596579, 788, 10.143424199999572
789, 5.592131228868253, 23.228054185853388, 27.958111728194858, 0.10000000000000077, 55.0, 411, 596990, 789, 11.604211699999723
790, 7.410597535059788, 23.31455458700657, 28.069537872076033, 0.100000000000001, 175.0, 640, 597630, 790, 16.938415800001167
791, 3.3944724835802496, 23.169794648330406, 27.87210284108701, 0.10000000000000096, 130.0, 644, 598274, 791, 17.83493140000064
792, 5.063572716536012, 23.099303593041594, 27.804579227434186, 0.0999999999999993, 150.0, 859, 599133, 792, 22.70019350000075
793, 4.18166982432361, 23.20395348935995, 27.920261569935278, 0.10000000000000096, 30.0, 643, 599776, 793, 16.7408716000009
794, 6.704415978865742, 23.328638166585744, 28.12885158894128, 0.09999999999999869, 185.0, 977, 600753, 794, 25.204331799999636
795, 5.702059420838394, 23.423675612883724, 28.230770048299522, 0.09999999999999917, 250.0, 881, 601634, 795, 22.50941690000036
796, 6.090468543259509, 23.35651089410362, 28.109497691100497, 0.10000000000000099, 145.0, 636, 602270, 796, 16.068712199999936
797, 4.319215711753124, 23.372442118679057, 28.11731691968078, 0.10000000000000067, 100.0, 361, 602631, 797, 9.730324699999983
798, 8.171709532096582, 23.348143431418702, 28.12358892375025, 0.10000000000000091, 95.0, 522, 603153, 798, 13.0640499000001
799, 5.937267452621267, 23.34182012327301, 28.09863362270119, 0.10000000000000063, 170.0, 678, 603831, 799, 17.67055569999866
800, 2.350728254363525, 23.224496925578396, 27.904983861773623, 0.10000000000000075, 50.0, 408, 604239, 800, 10.241143299999749
801, 6.991540279494801, 23.346926990457867, 28.12306340298603, 0.09999999999999751, 500.0, 1342, 605581, 801, 34.2699618000006
802, 2.998312070467538, 23.343068500823037, 28.056072593174097, 0.09999999999999956, 195.0, 815, 606396, 802, 21.58170919999975
803, 5.3357376787085204, 23.309127036880398, 28.07507365904514, 0.10000000000000099, 65.0, 636, 607032, 803, 16.765843299999688
804, 4.829048172935626, 23.34621172090609, 28.10473731346181, 0.09999999999999999, 160.0, 753, 607785, 804, 19.756222800000614
805, 6.0902821906430775, 23.27273113635159, 28.037156875373782, 0.10000000000000095, 105.0, 645, 608430, 805, 16.37673050000012
806, 2.7581439063853503, 23.260489991192557, 27.97509263223446, 0.09999999999999722, 290.0, 1481, 609911, 806, 39.25000809999983
807, 2.8990990481247043, 23.926289716786666, 28.764257241890565, 0.09999999999999942, 225.0, 837, 610748, 807, 22.510085099998832
808, 5.242795393342857, 23.99339129956993, 28.87691596230945, 0.09999999999999792, 495.0, 1184, 611932, 808, 32.95893799999976
809, 5.384736861720795, 23.83813504226335, 28.818182406534675, 0.10000000000000091, 15.0, 524, 612456, 809, 14.228804800000944
810, 4.567317325094656, 23.99344889834613, 28.911849600768264, 0.09999999999999719, 335.0, 1491, 613947, 810, 41.238250599999446
811, 3.3594141067467005, 23.95472881994515, 28.803828594172113, 0.10000000000000092, 90.0, 535, 614482, 811, 14.467857999999978
812, 5.216429441479728, 24.04249492427647, 29.023181758470983, 0.10000000000000096, 80.0, 596, 615078, 812, 16.803047999999762
813, 4.337094170362221, 23.98882661938097, 28.915984190251837, 0.09999999999999944, 275.0, 836, 615914, 813, 23.242026500000065
814, 5.758319717424887, 23.954054027133516, 28.90312518013848, 0.10000000000000092, 120.0, 540, 616454, 814, 15.229548400000567
815, 4.757741374667011, 23.967785334231248, 28.891060362289203, 0.1000000000000007, 135.0, 670, 617124, 815, 18.22252920000028
816, 4.875862360313032, 24.030097220741627, 28.92972100291778, 0.09999999999999822, 310.0, 1097, 618221, 816, 30.64684710000074
817, 4.4715197789332555, 23.938226640111356, 28.888667343689775, 0.09999999999999837, 185.0, 1054, 619275, 817, 29.334612299999208
818, 4.669877378353528, 23.896615483843046, 28.755078583750233, 0.09999999999999801, 280.0, 1160, 620435, 818, 31.896017900000516
819, 3.36770571495897, 23.927599929139607, 28.79532432385243, 0.09999999999999815, 275.0, 1116, 621551, 819, 30.70987310000055
820, 3.6610097113441915, 23.97110148977726, 28.864679433944378, 0.09999999999999795, 625.0, 1175, 622726, 820, 32.228974700001345
821, 6.137180889009531, 24.040111041990347, 28.998949121013215, 0.09999999999999835, 300.0, 1061, 623787, 821, 30.043180600001506
822, 3.4570275989529318, 23.948413103162455, 28.781964281056947, 0.09999999999999902, 265.0, 908, 624695, 822, 25.193632500000604
823, 2.892212820348055, 23.93037115136328, 28.72785073941578, 0.09999999999999921, 405.0, 874, 625569, 823, 24.29725640000106
824, 6.53777677092518, 23.89996998687911, 28.83227381940748, 0.10000000000000016, 160.0, 732, 626301, 824, 20.784463699999833
825, 3.059722603039836, 23.886839642851793, 28.710764726576823, 0.10000000000000094, 170.0, 554, 626855, 825, 15.182573500000217
826, 4.274291545692754, 23.941389914573264, 28.845491647295347, 0.09999999999999687, 440.0, 1683, 628538, 826, 46.64228659999935
827, 6.625527495376691, 23.897048233229256, 28.830607993017825, 0.10000000000000045, 95.0, 697, 629235, 827, 19.77546540000003
828, 5.079776511653777, 23.9543274400421, 28.847666857319492, 0.09999999999999826, 175.0, 1085, 630320, 828, 30.08759210000062
829, 4.648079721189822, 23.923606694412708, 28.781841494226516, 0.09999999999999964, 600.0, 803, 631123, 829, 22.525432800001
830, 4.767071266501847, 23.97155683212604, 28.852845665420467, 0.10000000000000037, 225.0, 707, 631830, 830, 18.873173300000417
831, 4.516951614172572, 23.943981392661083, 28.811990408485613, 0.09999999999999967, 125.0, 799, 632629, 831, 21.346938299999238
832, 8.501492962306624, 24.004141172238707, 28.978536379634026, 0.10000000000000057, 130.0, 683, 633312, 832, 17.769814599998426
833, 3.5944381258354383, 23.877371617171196, 28.746735122382447, 0.09999999999999896, 250.0, 921, 634233, 833, 24.43676509999932
834, 5.095353492679855, 23.954634637217367, 28.840814542770385, 0.09999999999999777, 320.0, 1240, 635473, 834, 33.39910610000152
835, 4.824103643780339, 23.919246609715383, 28.823112148128143, 0.10000000000000082, 140.0, 657, 636130, 835, 17.57153169999947
836, 4.226245840433232, 23.966977720514823, 28.826291910041945, 0.099999999999998, 295.0, 1163, 637293, 836, 30.98106750000079
837, 8.578091693644572, 23.94342602171549, 28.961554669752353, 0.09999999999999759, 255.0, 1312, 638605, 837, 34.675625100000616
838, 4.056783928017385, 23.994650956508668, 28.863096284992146, 0.09999999999999715, 495.0, 1516, 640121, 838, 40.280982700000095
839, 3.3974155355570983, 24.42320850187669, 29.3559032561973, 0.09999999999999871, 165.0, 971, 641092, 839, 26.015405400001328
840, 3.6780075743921956, 24.523661513200306, 29.46758118701739, 0.09999999999999955, 180.0, 818, 641910, 840, 22.369645000000673
841, 2.172255047682732, 24.454216954064748, 29.37221233125717, 0.10000000000000099, 105.0, 630, 642540, 841, 17.02881200000047
842, 4.943866610031834, 24.446115649358745, 29.453417645480336, 0.10000000000000078, 110.0, 662, 643202, 842, 18.611686299998837
843, 5.0080158470508955, 24.545341738065083, 29.555309560563828, 0.10000000000000026, 155.0, 720, 643922, 843, 20.496373699999822
844, 3.4250633065285307, 24.480816232488397, 29.477415659186544, 0.09999999999999912, 215.0, 890, 644812, 844, 25.294230499999685
845, 6.887224262693113, 24.469490556993225, 29.504929488117597, 0.09999999999999808, 390.0, 1139, 645951, 845, 32.87597939999978
846, 4.796242820575185, 24.4973558624931, 29.51619910198709, 0.09999999999999803, 270.0, 1150, 647101, 846, 32.524038100000325
847, 6.85759048976884, 24.57236633528865, 29.603581954545504, 0.10000000000000071, 135.0, 669, 647770, 847, 19.371309800000745
848, 6.192571897294364, 24.537725016312873, 29.554793335060378, 0.09999999999999742, 640.0, 1381, 649151, 848, 39.20047549999981
849, 8.32734956940473, 24.673810405115926, 29.787891017017277, 0.09999999999999826, 285.0, 1085, 650236, 849, 30.799327800001265
850, 5.837759577512339, 25.087810105148478, 30.250451676310888, 0.09999999999999844, 260.0, 1039, 651275, 850, 30.467816699998366
851, 4.797011479780897, 24.96237499213753, 30.004319231767518, 0.10000000000000087, 95.0, 491, 651766, 851, 13.901508000000831
852, 7.724782597382459, 24.99518127150578, 30.15909599439919, 0.09999999999999976, 245.0, 787, 652553, 852, 22.672959900000933
853, 7.575244951314912, 25.01142357340574, 30.160610029969035, 0.09999999999999848, 220.0, 1027, 653580, 853, 29.92941040000005
854, 4.559082640664092, 25.051284701152913, 30.121689405719053, 0.1000000000000009, 80.0, 515, 654095, 854, 14.58515400000033
855, 4.533312997200297, 25.05510604070996, 30.148534050446475, 0.0999999999999986, 225.0, 998, 655093, 855, 28.72428620000028
856, 3.690854913876898, 24.98632875612513, 30.031332984803214, 0.09999999999999953, 240.0, 819, 655912, 856, 24.06106700000055
857, 7.298583202673474, 25.140771290124288, 30.33492188739337, 0.09999999999999924, 285.0, 868, 656780, 857, 25.483011899999838
858, 4.466389327815601, 25.036000449770974, 30.219685011364163, 0.10000000000000091, 135.0, 525, 657305, 858, 14.841081799999301
859, 4.212320665850082, 25.09389315823684, 30.175370921133503, 0.10000000000000081, 25.0, 659, 657964, 859, 19.293152299998837
860, 3.4385890237513026, 25.07168505670196, 30.13187498369575, 0.10000000000000098, 155.0, 613, 658577, 860, 18.286638500001573
861, 3.61696429434074, 25.063695717290415, 30.16996381720718, 0.09999999999999916, 120.0, 882, 659459, 861, 25.59229890000097
862, 2.5283713622650663, 25.136084986584528, 30.15109590973173, 0.10000000000000082, 65.0, 448, 659907, 862, 12.751159600000392
863, 4.808564655822166, 24.903077750299087, 29.980731047673753, 0.09999999999999895, 350.0, 922, 660829, 863, 26.776846800001294
864, 3.878231614615236, 24.794964092799596, 29.859201431274414, 0.10000000000000064, 50.0, 350, 661179, 864, 10.309189900001002
865, 5.203679179932189, 24.865274258862097, 29.960262714863273, 0.09999999999999834, 395.0, 1063, 662242, 865, 30.79148239999995
866, 4.023814892373476, 24.931292314470912, 30.000767877496823, 0.10000000000000088, 230.0, 652, 662894, 866, 18.734252000000197
867, 5.105846192371355, 24.884157921081265, 29.942216408089415, 0.09999999999999822, 420.0, 1095, 663989, 867, 30.939364700001533
868, 4.267339084851051, 24.937271616220674, 30.002093783553963, 0.09999999999999791, 270.0, 1191, 665180, 868, 32.32899349999934
869, 5.0249721084183925, 24.901085988015332, 30.018274933231034, 0.09999999999999902, 260.0, 908, 666088, 869, 25.03642800000125
870, 5.680495041473345, 24.955525828274812, 30.050602798461913, 0.0999999999999982, 190.0, 1100, 667188, 870, 30.150995500000136
871, 5.1931032614481305, 25.01322947290843, 30.055510072651025, 0.10000000000000071, 80.0, 668, 667856, 871, 18.68116050000026
872, 3.3546915508350548, 24.92404067889363, 30.023145994848136, 0.09999999999999723, 445.0, 1470, 669326, 872, 43.476708600001075
873, 3.622054374791802, 24.800716034827694, 29.817820529783926, 0.10000000000000088, 75.0, 496, 669822, 873, 14.307739699999729
874, 3.7255700580143682, 24.598514958947973, 29.575080332228946, 0.10000000000000073, 50.0, 389, 670211, 874, 11.866983600000822
875, 3.509897961148194, 24.42259472670871, 29.392619166224677, 0.09999999999999803, 390.0, 1148, 671359, 875, 33.41726649999873
876, 5.305721384255936, 24.393184250536056, 29.438195301701846, 0.10000000000000099, 105.0, 626, 671985, 876, 18.805441300000894
877, 5.813059783630233, 24.412560449594878, 29.39988862900507, 0.09999999999999831, 310.0, 1071, 673056, 877, 31.435526400000526
878, 3.482309148346228, 24.32015474011579, 29.255641680064162, 0.09999999999999852, 280.0, 1016, 674072, 878, 30.38756889999968
879, 4.158270731714729, 24.3413714060739, 29.32271331937015, 0.09999999999999874, 280.0, 967, 675039, 879, 30.169670600000245
880, 4.37838031558849, 24.397421595651352, 29.4487456978527, 0.1000000000000009, 45.0, 514, 675553, 880, 14.236013100000491
881, 6.244342620252794, 24.35096471186535, 29.37317241301559, 0.09999999999999934, 155.0, 852, 676405, 881, 23.71449179999945
882, 2.1496768482542876, 24.35380573185078, 29.240945851090856, 0.10000000000000087, 120.0, 653, 677058, 882, 18.10446530000081
883, 3.369557610151705, 24.421483608302225, 29.336787215986078, 0.10000000000000098, 45.0, 609, 677667, 883, 16.88763040000049
884, 4.6281592109137115, 24.36294038776175, 29.333314486142605, 0.09999999999999834, 365.0, 1062, 678729, 884, 29.4810862000013
885, 3.7404100123438555, 24.251108860908253, 29.20927625817934, 0.10000000000000073, 30.0, 389, 679118, 885, 10.864000300000043
886, 4.7188035710368395, 24.410359579669542, 29.36689733867803, 0.09999999999999873, 245.0, 968, 680086, 886, 27.076904499999728
887, 5.1043133022868705, 25.04241729715502, 30.162300967215625, 0.0999999999999982, 235.0, 1099, 681185, 887, 30.760091199999806
888, 3.7260742271031653, 25.05766396004813, 30.18415584237235, 0.0999999999999992, 250.0, 875, 682060, 888, 24.435386400000425
889, 5.332399521046839, 25.044323247842513, 30.205030742925576, 0.10000000000000099, 125.0, 626, 682686, 889, 17.58096840000144
890, 3.091257600276857, 25.057708074208854, 30.124428898579364, 0.09999999999999894, 295.0, 925, 683611, 890, 25.73313820000112
891, 3.187053189642383, 25.032662760602296, 30.088436432998545, 0.09999999999999952, 135.0, 822, 684433, 891, 23.07113919999938
892, 6.1999249672931365, 25.13514176529881, 30.40685126560313, 0.09999999999999976, 130.0, 787, 685220, 892, 22.063448099999732
893, 3.8637389464048133, 25.063920533143826, 30.149201691392765, 0.09999999999999779, 335.0, 1231, 686451, 893, 34.46771509999962
894, 4.437170318504137, 25.08299963788822, 30.162399255522807, 0.09999999999999841, 245.0, 1046, 687497, 894, 31.463353299999653
895, 5.038900138292579, 25.04018005054113, 30.237944777852142, 0.10000000000000045, 155.0, 698, 688195, 895, 20.956927799999903
896, 2.84130444695328, 25.00589358042085, 30.084887427558808, 0.0999999999999994, 190.0, 842, 689037, 896, 24.8052461999996
897, 2.3269619454166603, 25.036358744720292, 30.056767885802223, 0.10000000000000069, 95.0, 366, 689403, 897, 10.974757800000589
898, 5.1637095340896, 25.008738562281653, 30.118621437203974, 0.10000000000000075, 45.0, 407, 689810, 898, 12.145935000000463
899, 2.227903967549917, 25.106409619442644, 30.187629223574213, 0.10000000000000063, 150.0, 677, 690487, 899, 20.09321640000053
900, 5.499417019128799, 25.2593443552653, 30.49022401936849, 0.1000000000000007, 70.0, 375, 690862, 900, 11.215405300001294
901, 5.4014784311697746, 25.28702070151165, 30.55809661962424, 0.09999999999999977, 150.0, 785, 691647, 901, 23.227503900001466
902, 4.733773503853724, 25.20620308655959, 30.366108515323738, 0.0999999999999998, 210.0, 780, 692427, 902, 22.088663599999563
903, 7.546807064634837, 25.439310964578056, 30.699846314911795, 0.10000000000000098, 180.0, 606, 693033, 903, 17.039872400000604
904, 2.8732491411176158, 25.270567797232367, 30.405582992680078, 0.09999999999999874, 180.0, 966, 693999, 904, 28.475530899999285
905, 4.663346631581487, 25.34613949146146, 30.487240837446226, 0.09999999999999991, 335.0, 765, 694764, 905, 22.694699499999842
906, 4.309693846876494, 25.249458455083023, 30.359417779625545, 0.0999999999999984, 265.0, 1047, 695811, 906, 29.637745400001222
907, 4.3019282828102225, 25.268831584210787, 30.41016389690775, 0.09999999999999788, 630.0, 1198, 697009, 907, 34.1242371999997
908, 5.020765764507136, 25.325789627993018, 30.516242734292398, 0.10000000000000074, 135.0, 665, 697674, 908, 19.03110580000066
909, 10.915451324464872, 25.428202224900517, 30.842930711867737, 0.10000000000000067, 75.0, 361, 698035, 909, 10.347626700000546
910, 4.250134850751626, 25.210603008807546, 30.320591510181696, 0.09999999999999934, 155.0, 852, 698887, 910, 24.110381899999993
911, 3.753134999732823, 25.307054798983962, 30.453790805748934, 0.10000000000000064, 115.0, 676, 699563, 911, 19.475910200000726
912, 3.992811259643365, 25.673164919713066, 30.899965605855414, 0.09999999999999815, 315.0, 1116, 700679, 912, 33.54953270000078
913, 4.057724056454017, 25.764363788279827, 30.990195509011063, 0.10000000000000099, 225.0, 634, 701313, 913, 19.329718499999217
914, 2.34613901849012, 25.752594302573456, 30.966813234277407, 0.09999999999999985, 255.0, 773, 702086, 914, 23.19411140000011
915, 5.918551990193993, 25.71581205788696, 30.958350397668937, 0.10000000000000078, 125.0, 662, 702748, 915, 19.88677269999971
916, 6.194268517880273, 25.80670354963466, 31.108035234716965, 0.099999999999997, 650.0, 1601, 704349, 916, 48.19014430000061
917, 5.466664186687477, 25.821164756121405, 31.0677640519275, 0.09999999999999873, 110.0, 969, 705318, 917, 29.251815499999793
918, 4.819049974414871, 25.786103366487588, 30.98412461975711, 0.09999999999999862, 315.0, 995, 706313, 918, 30.04152190000059
919, 5.069323302462425, 25.834591781220784, 31.151418845827987, 0.10000000000000084, 225.0, 656, 706969, 919, 19.858074300000226
920, 7.351923799761186, 25.84915717566813, 31.146390578676126, 0.10000000000000099, 115.0, 641, 707610, 920, 19.48708169999918
921, 6.536827677667879, 25.85343583854469, 31.167898214615143, 0.09999999999999913, 260.0, 888, 708498, 921, 27.00993980000021
922, 6.244313993406296, 25.84384905090332, 31.10444373474121, 0.10000000000000099, 100.0, 625, 709123, 922, 19.677561999998943
923, 4.524912769018624, 25.894936107134036, 31.163328832303975, 0.09999999999999683, 605.0, 1704, 710827, 923, 51.76743299999907
924, 4.25932855955764, 25.83997498095875, 31.041919970693208, 0.09999999999999895, 415.0, 923, 711750, 924, 28.335100199999943
925, 5.497291930185793, 25.85540854037029, 31.17540632642988, 0.09999999999999751, 480.0, 1347, 713097, 925, 41.549757800001316
926, 3.299471514969528, 25.860691784097135, 31.102310139498265, 0.10000000000000094, 105.0, 556, 713653, 926, 17.439467300000615
927, 4.301472800631223, 25.89914823790728, 31.15620623604726, 0.10000000000000035, 100.0, 708, 714361, 927, 22.036884900000587
928, 4.927760683118469, 25.851707441449285, 31.093307021594686, 0.09999999999999856, 245.0, 1007, 715368, 928, 30.96147689999998
929, 5.972550848666175, 25.80901926589824, 31.121918211780464, 0.10000000000000094, 40.0, 646, 716014, 929, 20.190630500001134
930, 2.8351751090875643, 25.74822570263926, 30.95396428821817, 0.09999999999999855, 180.0, 1009, 717023, 930, 31.03463080000074
931, 3.496376362785697, 25.752984661102296, 30.979622314453124, 0.10000000000000088, 60.0, 500, 717523, 931, 15.835627399999794
932, 4.472078145622914, 25.82980539289753, 31.094050234623168, 0.09999999999999733, 430.0, 1424, 718947, 932, 44.66771150000022
933, 6.266781507734192, 25.93492612148302, 31.276643463928774, 0.09999999999999916, 155.0, 884, 719831, 933, 26.066216499999427
934, 2.946749148505066, 25.952739097756886, 31.23488357112819, 0.09999999999999863, 220.0, 991, 720822, 934, 28.796417600000495
935, 7.001201590849845, 26.104247108721605, 31.434587426901295, 0.10000000000000094, 40.0, 553, 721375, 935, 15.703897699999288
936, 5.9372362821204625, 26.048777388018582, 31.42218493284444, 0.1000000000000009, 85.0, 506, 721881, 936, 14.499233999998978
937, 3.3947921573442477, 26.04594240195721, 31.321540207182675, 0.09999999999999752, 520.0, 1339, 723220, 937, 38.99304159999883
938, 3.8500992894703447, 26.040645949129694, 31.350828019798904, 0.09999999999999996, 265.0, 758, 723978, 938, 22.506811400000515
939, 5.349697124081217, 26.04989877621077, 31.4290386089558, 0.10000000000000099, 140.0, 622, 724600, 939, 18.39932509999926
940, 5.827737560126349, 26.055257032692182, 31.371178284979067, 0.10000000000000034, 110.0, 711, 725311, 940, 20.829619500000263
941, 4.088656779216348, 25.97779938590972, 31.266255928767666, 0.09999999999999876, 175.0, 964, 726275, 941, 27.9854538999989
942, 4.619700757465486, 26.018072338475996, 31.343043435996083, 0.09999999999999754, 225.0, 1334, 727609, 942, 39.33691799999906
943, 3.9122836094568756, 25.960433720607384, 31.28581575630537, 0.09999999999999991, 205.0, 765, 728374, 943, 22.38041510000039
944, 5.1443954921108315, 26.08678750262625, 31.48483469961644, 0.10000000000000073, 110.0, 667, 729041, 944, 19.104063999999198
945, 3.114401103092883, 25.969305334947048, 31.215388991893867, 0.10000000000000099, 70.0, 624, 729665, 945, 18.61821670000063
946, 5.12322278573521, 26.269747584332546, 31.615656216138557, 0.09999999999999791, 440.0, 1191, 730856, 946, 35.241543699999966
947, 3.987968780022124, 26.161400231789415, 31.472845327822867, 0.10000000000000071, 5.0, 381, 731237, 947, 11.014377900000909
948, 6.193018398929441, 26.372231777014726, 31.767848089361113, 0.10000000000000099, 115.0, 627, 731864, 948, 18.872064799999862
949, 8.473973115326828, 26.402463319769318, 31.805818571428365, 0.10000000000000077, 105.0, 418, 732282, 949, 12.004612400000042
950, 3.6527696352069277, 26.24524102933773, 31.55393483073641, 0.09999999999999867, 255.0, 983, 733265, 950, 29.015014799999335
951, 4.075352851813592, 26.27413425914803, 31.627064615186146, 0.09999999999999742, 410.0, 1382, 734647, 951, 41.026101699999344
952, 5.728982843449089, 26.32912943819215, 31.670591089936675, 0.09999999999999981, 200.0, 779, 735426, 952, 24.872184200001357
953, 3.769643853286079, 26.264933597867994, 31.583786619470473, 0.0999999999999991, 330.0, 893, 736319, 953, 28.156825299998673
954, 5.622639871355196, 26.255494437621305, 31.60284186455897, 0.09999999999999878, 180.0, 957, 737276, 954, 29.835215699999026
955, 4.480897043952316, 26.27440937756172, 31.65621899449548, 0.09999999999999905, 475.0, 903, 738179, 955, 28.37864179999997
956, 2.58297073582008, 26.222996672384866, 31.48218166148967, 0.1000000000000009, 100.0, 509, 738688, 956, 16.49957429999995
957, 4.864460293912083, 26.43569753681955, 31.84447486737023, 0.09999999999999956, 315.0, 815, 739503, 957, 25.699637800000346
958, 3.137002992704206, 26.43130683118292, 31.792491627910454, 0.09999999999999724, 465.0, 1466, 740969, 958, 45.19985679999991
959, 7.746681724409634, 26.59511168165006, 32.06202354252478, 0.09999999999999766, 555.0, 1281, 742250, 959, 40.905399500001295
960, 5.593756595083369, 26.532210071967437, 31.926653855820195, 0.09999999999999894, 295.0, 926, 743176, 960, 29.5473779999993
961, 4.830568550889207, 26.517789654929473, 31.903766161220627, 0.09999999999999844, 285.0, 1037, 744213, 961, 32.594429700000546
962, 5.834554288347777, 26.468940963673614, 31.927891753606968, 0.09999999999999833, 300.0, 1067, 745280, 962, 34.7388987000013
963, 2.7640197870254664, 26.54919254356529, 31.87090388454749, 0.09999999999999785, 560.0, 1211, 746491, 963, 38.13541599999917
964, 4.149067724311771, 26.486975210477457, 31.890508151857254, 0.10000000000000057, 145.0, 683, 747174, 964, 21.915161400000216
965, 5.881740680574078, 26.58920413288027, 31.94865172939749, 0.10000000000000094, 60.0, 553, 747727, 965, 17.94277409999995
966, 8.196931456175736, 26.68852458419972, 32.16240421751552, 0.09999999999999915, 235.0, 886, 748613, 966, 28.443997799999124
967, 5.370058510611463, 26.56804233044964, 31.99662053335351, 0.09999999999999765, 220.0, 1289, 749902, 967, 41.654374600000665
968, 4.783179530141477, 27.06371833321577, 32.59772787836497, 0.09999999999999859, 280.0, 1002, 750904, 968, 32.14801230000012
969, 7.564326655234442, 27.10109986644499, 32.68676373137146, 0.09999999999999733, 715.0, 1428, 752332, 969, 45.998900599999615
970, 5.8323443555589645, 27.14089150752901, 32.694146544597494, 0.09999999999999733, 135.0, 1427, 753759, 970, 45.65935050000007
971, 4.398192833955326, 27.121926986855804, 32.66118196961741, 0.09999999999999884, 225.0, 945, 754704, 971, 28.342399099999966
972, 5.864019053173512, 27.072435208348352, 32.633195269027816, 0.0999999999999991, 125.0, 894, 755598, 972, 26.796705600001587
973, 5.5084491994883935, 27.12819211623248, 32.661150528541405, 0.09999999999999744, 310.0, 1377, 756975, 973, 41.17366270000093
974, 3.1578958420172434, 27.13433861677925, 32.608466851083854, 0.09999999999999921, 225.0, 874, 757849, 974, 26.149439300001177
975, 4.096725582420736, 27.06952750302953, 32.55532898562812, 0.10000000000000081, 105.0, 659, 758508, 975, 20.0866146999997
976, 4.630619074244584, 27.012715424810136, 32.53041109868458, 0.09999999999999813, 410.0, 1120, 759628, 976, 33.857312599999204
977, 3.08111697335976, 27.746283531188965, 33.34422839728377, 0.09999999999999964, 175.0, 802, 760430, 977, 26.064274599999408
978, 5.215649368840236, 28.32904113204391, 34.13488847520616, 0.10000000000000066, 115.0, 675, 761105, 978, 22.158970200000113
979, 6.397456768422555, 28.47941877087976, 34.3465951055543, 0.09999999999999797, 470.0, 1170, 762275, 979, 37.48033050000049
980, 3.8963435549464527, 28.357501154794743, 34.11316973501475, 0.0999999999999988, 195.0, 955, 763230, 980, 30.926610399999845
981, 6.408807461196557, 28.327587562799454, 34.23581796884537, 0.100000000000001, 230.0, 640, 763870, 981, 20.885267499999827
982, 6.788651995172229, 28.43230500077319, 34.23590147135437, 0.09999999999999848, 435.0, 1027, 764897, 982, 33.03481120000106
983, 6.8399861022213795, 28.42831712259087, 34.26044248757805, 0.09999999999999967, 225.0, 798, 765695, 983, 26.19766410000011
984, 5.2550481542139, 28.379416718388235, 34.11972411157806, 0.09999999999999903, 480.0, 906, 766601, 984, 29.239290899999105
985, 3.3003906690239906, 28.261679946899413, 33.98722922363281, 0.10000000000000099, 185.0, 625, 767226, 985, 20.588324000000284
986, 5.027117445693164, 28.388568800128624, 34.175761845297444, 0.09999999999999859, 365.0, 1002, 768228, 986, 33.10856409999906
987, 5.411866067881374, 28.414679305548056, 34.183157014523886, 0.10000000000000081, 105.0, 443, 768671, 987, 14.32927700000073
988, 5.171785637658076, 28.31547849069816, 34.114786277156725, 0.09999999999999931, 270.0, 857, 769528, 988, 28.090949999999793
989, 5.164736966734115, 28.557328109988116, 34.369949620647084, 0.09999999999999892, 190.0, 927, 770455, 989, 30.383767700001044
990, 4.282334030017875, 28.67607660337527, 34.52715520375335, 0.1000000000000008, 30.0, 434, 770889, 990, 14.606696499999089
991, 4.373686779827223, 28.746716186017743, 34.625456227349275, 0.10000000000000048, 305.0, 694, 771583, 991, 22.838615700000446
992, 4.914667340238697, 28.615902402634436, 34.42217244875537, 0.0999999999999975, 350.0, 1348, 772931, 992, 44.338555300000735
993, 3.347890553925371, 28.688792763460714, 34.53658011263151, 0.09999999999999848, 525.0, 1029, 773960, 993, 33.547105399999054
994, 4.631964389135934, 28.674101954471215, 34.49879054643621, 0.09999999999999787, 530.0, 1206, 775166, 994, 39.9692830999993
995, 3.8695397390074313, 28.69462588067543, 34.50099059873297, 0.09999999999999883, 480.0, 947, 776113, 995, 31.075979699999152
996, 7.412737783093187, 28.6856415297213, 34.60933765624059, 0.0999999999999994, 190.0, 843, 776956, 996, 27.96993769999972
997, 4.668372263701452, 28.66636374557869, 34.53011340709032, 0.09999999999999887, 205.0, 939, 777895, 997, 30.949188099999446
998, 5.752340003217583, 28.67361464564399, 34.527681104662, 0.09999999999999873, 390.0, 969, 778864, 998, 30.856697199998962
999, 4.81477595904625, 28.60195983748838, 34.44783591649618, 0.0999999999999986, 420.0, 996, 779860, 999, 30.280574199998227
1000, 4.073228789753307, 28.49301968427739, 34.282922119841075, 0.09999999999999816, 530.0, 1111, 780971, 1000, 34.46409669999957
1001, 7.336162188286271, 28.448401683371006, 34.23923120463466, 0.10000000000000092, 50.0, 542, 781513, 1001, 16.373405399999683
1002, 4.625746716109533, 28.455509378128692, 34.25965433984466, 0.09999999999999831, 270.0, 1071, 782584, 1002, 33.166896099999576
1003, 5.4327326081116505, 28.52530600485787, 34.422120764528636, 0.10000000000000094, 130.0, 646, 783230, 1003, 19.655041199999687
1004, 3.501966733052287, 28.43853226743003, 34.174809446014486, 0.09999999999999984, 250.0, 774, 784004, 1004, 24.03526039999997
1005, 4.677621382048704, 28.41536291264836, 34.18171582387449, 0.09999999999999881, 225.0, 951, 784955, 1005, 29.33891219999896
1006, 4.206631742602717, 28.475833341501055, 34.245501438892674, 0.10000000000000056, 205.0, 685, 785640, 1006, 21.247329899999386
1007, 5.773361046748674, 28.45248924178426, 34.27984267561079, 0.09999999999999765, 310.0, 1289, 786929, 1007, 39.360969499999555
1008, 9.132106495310193, 28.60969053278315, 34.50379699746562, 0.10000000000000095, 215.0, 579, 787508, 1008, 18.17005919999974
1009, 3.8281160055828267, 28.47936983474648, 34.229716006319094, 0.10000000000000092, 85.0, 547, 788055, 1009, 18.362669399999504
1010, 5.440044883127306, 28.485568401860256, 34.29028398275016, 0.10000000000000077, 225.0, 663, 788718, 1010, 23.097990800000844
1011, 5.166487911807016, 28.54069528352389, 34.390768746106495, 0.09999999999999917, 180.0, 881, 789599, 1011, 29.33839219999936
1012, 4.072152169096382, 28.326580380339003, 34.0341701554432, 0.10000000000000075, 75.0, 407, 790006, 1012, 13.892821600000389
1013, 4.634216005791728, 28.532951474537306, 34.34044870760281, 0.10000000000000055, 160.0, 686, 790692, 1013, 22.25144569999975
1014, 5.099021777539999, 28.547690345698026, 34.34520250234762, 0.09999999999999769, 490.0, 1269, 791961, 1014, 42.64685780000036
1015, 8.97006173452298, 28.50084652633576, 34.36875607941801, 0.09999999999999941, 220.0, 839, 792800, 1015, 28.046282299999802
1016, 4.348969233788404, 28.46663348347533, 34.25101178066403, 0.09999999999999956, 215.0, 816, 793616, 1016, 27.52919539999857
1017, 3.913861312185015, 28.486176245553153, 34.285395567757746, 0.10000000000000078, 75.0, 420, 794036, 1017, 13.957533100001456
1018, 3.7739645451615984, 28.45536816411997, 34.207988940165315, 0.09999999999999834, 335.0, 1062, 795098, 1018, 36.54212949999783
1019, 5.177112022952105, 28.434167748231154, 34.2660353403825, 0.10000000000000091, 65.0, 520, 795618, 1019, 17.847879299999477
1020, 3.3989959670083096, 28.393325805664062, 34.13228722607217, 0.10000000000000084, 170.0, 656, 796274, 1020, 22.30606070000067
1021, 5.091283382740633, 28.5976278245137, 34.42566439743442, 0.09999999999999991, 385.0, 764, 797038, 1021, 25.813485200000287
1022, 6.664227602147186, 28.568685905270936, 34.40493802499222, 0.0999999999999998, 220.0, 781, 797819, 1022, 26.379693299997598
1023, 5.765080469825836, 28.43413028538784, 34.265043619637176, 0.1000000000000008, 75.0, 428, 798247, 1023, 14.12519919999977
1024, 6.437964863780784, 28.502702050175227, 34.2952823503643, 0.09999999999999865, 190.0, 987, 799234, 1024, 33.11775769999804
1025, 4.823937977059475, 28.554286724018258, 34.340779333882985, 0.09999999999999938, 420.0, 844, 800078, 1025, 28.65707620000103
1026, 3.942310813784976, 28.618689716333083, 34.371782339014715, 0.10000000000000099, 150.0, 633, 800711, 1026, 21.616050799999357
1027, 6.488530593266888, 28.72859832707088, 34.612106896154074, 0.0999999999999996, 250.0, 809, 801520, 1027, 27.507664800003113
1028, 3.87586352347614, 28.600690676707554, 34.427862948566954, 0.09999999999999738, 325.0, 1399, 802919, 1028, 47.38191899999947
1029, 5.859747166592836, 28.598963267081963, 34.4200784319398, 0.09999999999999844, 335.0, 1038, 803957, 1029, 35.747422199998255
1030, 4.784092528326736, 28.601125690615408, 34.38178498229327, 0.0999999999999989, 210.0, 934, 804891, 1030, 31.67981630000213
1031, 5.8561915397748985, 28.676207085730326, 34.4929753773649, 0.10000000000000034, 120.0, 710, 805601, 1031, 24.441370300002745
1032, 3.8035918923465957, 28.53173549585693, 34.29643306141896, 0.09999999999999845, 495.0, 1034, 806635, 1032, 32.37179389999801
1033, 3.718199869219433, 28.686369050020552, 34.48380891462792, 0.09999999999999777, 385.0, 1239, 807874, 1033, 39.334330699999555
1034, 5.226609775956615, 28.660044531458354, 34.50132054248488, 0.09999999999999776, 350.0, 1245, 809119, 1034, 39.48907739999777
1035, 4.825770139490718, 28.629181066168563, 34.444004818416374, 0.09999999999999809, 265.0, 1135, 810254, 1035, 35.53866320000088
1036, 5.802490503162725, 28.607000070412283, 34.43391718666934, 0.09999999999999794, 525.0, 1183, 811437, 1036, 37.13201769999796
1037, 6.221555525280172, 28.582560256101534, 34.419725096912465, 0.10000000000000063, 145.0, 677, 812114, 1037, 21.664672099999734
1038, 2.5456086707429804, 28.54001442078621, 34.292494701150574, 0.10000000000000059, 160.0, 682, 812796, 1038, 21.567645399998582
1039, 2.6423061337897624, 28.559200097798605, 34.298190002886265, 0.10000000000000055, 250.0, 686, 813482, 1039, 21.384363299999677
1040, 4.423218718325542, 28.59902363140897, 34.444001623433586, 0.09999999999999756, 515.0, 1322, 814804, 1040, 41.89012829999774
1041, 4.39887466169324, 28.53177217176511, 34.307199614289374, 0.09999999999999744, 535.0, 1373, 816177, 1041, 43.330614099999366
1042, 7.745249166275774, 28.654198782784597, 34.58000796181815, 0.10000000000000064, 55.0, 350, 816527, 1042, 11.024166600000171
1043, 5.413916768118457, 28.59932582971831, 34.46836829983685, 0.10000000000000055, 130.0, 687, 817214, 1043, 22.053493100000196
1044, 6.2592061559639465, 28.625074895043635, 34.47626554814649, 0.10000000000000035, 90.0, 709, 817923, 1044, 22.760691799998312
1045, 6.306555533249464, 28.567403972922982, 34.402400905435734, 0.10000000000000098, 135.0, 616, 818539, 1045, 20.54066910000256
1046, 6.451447034379659, 28.677878162864772, 34.55376885721609, 0.09999999999999781, 450.0, 1222, 819761, 1046, 41.59024249999857
1047, 4.99005122949022, 28.88743196414323, 34.71279044865731, 0.09999999999999731, 250.0, 1435, 821196, 1047, 49.94187679999959
1048, 4.138363364794027, 28.89925574143109, 34.741483558476666, 0.1000000000000009, 100.0, 514, 821710, 1048, 17.91395249999914
1049, 3.5491903164081324, 29.011608666275748, 34.86356917353301, 0.09999999999999915, 345.0, 886, 822596, 1049, 30.69249910000144
1050, 5.155559227705361, 28.90370853378112, 34.78406287963132, 0.09999999999999946, 170.0, 830, 823426, 1050, 28.834475499999826
1051, 3.8444879837811348, 28.877667216130753, 34.73848283932211, 0.09999999999999797, 545.0, 1171, 824597, 1051, 41.13405360000252
1052, 5.5981236925380635, 28.93024395578739, 34.881821453615835, 0.09999999999999752, 245.0, 1339, 825936, 1052, 46.073078800000076
1053, 5.274063993069711, 28.92841701657458, 34.83283287977657, 0.09999999999999852, 145.0, 1018, 826954, 1053, 35.21661429999949
1054, 5.444157312288812, 28.99691946504327, 34.9402556528041, 0.09999999999999822, 390.0, 1097, 828051, 1054, 38.54284400000324
1055, 4.591625162664755, 28.91547252660916, 34.814847450197476, 0.09999999999999763, 190.0, 1296, 829347, 1055, 45.655779199998506
1056, 3.2253174233115587, 28.98953849486338, 34.8672689580867, 0.09999999999999883, 270.0, 947, 830294, 1056, 33.08084520000193
1057, 4.835105267768001, 29.370787689457963, 35.31143273395814, 0.0999999999999993, 205.0, 858, 831152, 1057, 30.041694799998368
1058, 6.391189704359066, 29.403823915075083, 35.37673662082931, 0.09999999999999933, 230.0, 854, 832006, 1058, 30.54110800000126
1059, 6.6651800347272685, 29.467416855147043, 35.47165461316359, 0.099999999999998, 230.0, 1163, 833169, 1059, 40.2105507999986
1060, 6.856075932721634, 29.394317333131795, 35.46007401389179, 0.0999999999999999, 250.0, 766, 833935, 1060, 27.74611129999903
1061, 8.07823927127795, 29.383937154120026, 35.393352204742854, 0.10000000000000024, 180.0, 722, 834657, 1061, 25.474970700000995
1062, 5.007762142649818, 29.348384792615644, 35.3051436201055, 0.09999999999999845, 280.0, 1034, 835691, 1062, 35.94819239999924
1063, 6.035517673295886, 29.33640655736342, 35.32253788637004, 0.0999999999999974, 325.0, 1395, 837086, 1063, 45.208852599997044
1064, 5.616620298890162, 29.41117290877177, 35.36587667045705, 0.10000000000000059, 110.0, 682, 837768, 1064, 22.691129399998317
1065, 5.291380779842804, 29.343289415577136, 35.32477436768291, 0.09999999999999816, 275.0, 1113, 838881, 1065, 40.044890499997564
1066, 2.768521746993065, 29.374186647285537, 35.29014786655463, 0.1000000000000009, 75.0, 515, 839396, 1066, 18.591012699998828
1067, 5.0969235644480975, 29.4469393572761, 35.42170846977806, 0.09999999999999809, 395.0, 1133, 840529, 1067, 40.53773680000086
1068, 5.209347983608722, 29.380652665149555, 35.355177257371984, 0.1000000000000009, 50.0, 506, 841035, 1068, 18.005410100002337
1069, 4.639134140991269, 29.44641107908437, 35.37846695985033, 0.100000000000001, 135.0, 639, 841674, 1069, 22.847563999999693
1070, 4.964928975443191, 29.450719695261704, 35.45402189092173, 0.09999999999999824, 175.0, 1091, 842765, 1070, 38.780803499998
1071, 5.91982895924118, 29.446451163015578, 35.449337701023694, 0.09999999999999883, 145.0, 949, 843714, 1071, 34.077252600000065
1072, 4.128644357600207, 29.381270689238246, 35.30886542355573, 0.09999999999999871, 455.0, 972, 844686, 1072, 34.382291499998246
1073, 4.423731592317511, 29.318010432379587, 35.23044315406254, 0.10000000000000069, 190.0, 672, 845358, 1073, 23.768029499999102
1074, 6.710237918108675, 29.492640761780716, 35.505693320851016, 0.09999999999999816, 215.0, 1113, 846471, 1074, 40.45765469999969
1075, 6.8642482805512675, 29.45492783790212, 35.42714733072461, 0.10000000000000081, 155.0, 446, 846917, 1075, 16.085747599998285
1076, 5.32842774938654, 29.45416990209509, 35.51689830921315, 0.10000000000000066, 165.0, 675, 847592, 1076, 24.29864599999928
1077, 3.3989279370033305, 29.36545575925817, 35.285332808569464, 0.0999999999999988, 135.0, 955, 848547, 1077, 34.57422370000131
1078, 4.169886546189498, 29.464249391215187, 35.40339276790619, 0.09999999999999813, 165.0, 1120, 849667, 1078, 39.74363480000102
1079, 6.302744449998115, 30.067110026966443, 36.19569411644569, 0.1000000000000003, 135.0, 715, 850382, 1079, 25.748529199998302
1080, 4.201920111466757, 30.313644110165413, 36.49444166441711, 0.10000000000000078, 65.0, 421, 850803, 1080, 15.662965799998346
1081, 4.304858969784099, 30.43037999367544, 36.624162311107675, 0.09999999999999867, 215.0, 983, 851786, 1081, 35.02285180000035
1082, 7.069247123868591, 30.534141240605102, 36.76811162001795, 0.09999999999999871, 270.0, 973, 852759, 1082, 34.92293740000241
1083, 2.845287730879932, 30.46014937435288, 36.55749864463346, 0.10000000000000088, 95.0, 498, 853257, 1083, 18.126383500002703
1084, 4.573488663754515, 30.515510945093062, 36.72591623805818, 0.10000000000000069, 125.0, 672, 853929, 1084, 24.30090030000065
1085, 6.168651784526704, 30.544178441923613, 36.76970715896463, 0.09999999999999701, 420.0, 1595, 855524, 1085, 54.39302709999902
1086, 5.232802837672307, 30.597801582100466, 36.87747813745872, 0.10000000000000087, 165.0, 485, 856009, 1086, 15.539767400001438
1087, 5.261262905534179, 30.44849454043065, 36.62923356649038, 0.09999999999999876, 340.0, 962, 856971, 1087, 31.354515699997137
1088, 3.6519182776992625, 30.499075930169287, 36.62599266742138, 0.09999999999999887, 235.0, 940, 857911, 1088, 31.781613600000128
1089, 7.11935120494295, 30.617692494702926, 36.88720949893405, 0.1000000000000005, 105.0, 691, 858602, 1089, 22.248712500000693
1090, 5.67512878880352, 30.52709655400136, 36.78111963739139, 0.10000000000000099, 135.0, 633, 859235, 1090, 21.25914719999855
1091, 3.7298850164065938, 30.74505954656677, 36.961936952066736, 0.09999999999999742, 340.0, 1379, 860614, 1091, 45.71863410000151
1092, 2.925703271194387, 31.170985715384862, 37.410694101238775, 0.10000000000000092, 120.0, 543, 861157, 1092, 18.08801239999957
1093, 4.008137906894429, 31.064567931995786, 37.34454368582988, 0.09999999999999898, 525.0, 917, 862074, 1093, 29.45894910000061
1094, 3.1444875971037805, 31.239691430629964, 37.539235283764604, 0.10000000000000092, 85.0, 537, 862611, 1094, 18.206071699998574
1095, 6.265979036096841, 31.275955393542983, 37.67008704616599, 0.10000000000000069, 50.0, 365, 862976, 1095, 12.737280699999246
1096, 5.2941037651086065, 31.17719350781357, 37.5064318612305, 0.10000000000000057, 90.0, 684, 863660, 1096, 23.06956100000025
1097, 2.8082070737158324, 31.281937744917883, 37.545788445357665, 0.1000000000000007, 35.0, 373, 864033, 1097, 12.186421600003086
1098, 4.943173417223602, 31.14107819244641, 37.428494961522205, 0.10000000000000096, 160.0, 595, 864628, 1098, 20.118350500000815
1099, 5.6475052317462815, 31.324540428250852, 37.663487847088376, 0.10000000000000057, 160.0, 684, 865312, 1099, 22.83661679999932
1100, 3.674628042767139, 31.13959795933265, 37.429409897172604, 0.09999999999999779, 280.0, 1232, 866544, 1100, 40.77122869999948
1101, 4.49978523123865, 31.276403184639392, 37.60985917675403, 0.10000000000000095, 50.0, 645, 867189, 1101, 21.71316289999959
1102, 5.270016560607379, 31.132045946839035, 37.459218989136396, 0.09999999999999891, 130.0, 930, 868119, 1102, 31.49028360000011
1103, 4.9126193373546485, 31.21311581584051, 37.54106409940461, 0.09999999999999806, 225.0, 1141, 869260, 1103, 37.893001899999945
1104, 5.179462198985786, 31.1373626621416, 37.45223784754574, 0.10000000000000045, 100.0, 697, 869957, 1104, 23.546407000001636
1105, 5.064110099477893, 31.199253614368356, 37.49561639507441, 0.09999999999999891, 220.0, 932, 870889, 1105, 33.280244599998696
1106, 5.237719273508827, 31.132763842892984, 37.48337003689207, 0.09999999999999896, 95.0, 919, 871808, 1106, 34.148672299998
1107, 5.077861454352274, 31.09758760393128, 37.42364437635555, 0.1000000000000009, 130.0, 516, 872324, 1107, 18.659820699998818
1108, 8.449223401625439, 31.155328442035778, 37.5118771717389, 0.09999999999999933, 280.0, 853, 873177, 1108, 31.858535300001677
1109, 4.493379860929899, 31.137484999042254, 37.41660288482787, 0.09999999999999995, 150.0, 759, 873936, 1109, 27.983361999999033
1110, 4.588190861785265, 31.210295000232634, 37.51766527988872, 0.09999999999999783, 395.0, 1220, 875156, 1110, 44.76973559999897
1111, 3.370883424423243, 31.142344444282777, 37.413558881226216, 0.09999999999999873, 510.0, 969, 876125, 1111, 35.54566810000324
1112, 4.441535090979567, 31.246197015996767, 37.631123283745126, 0.10000000000000081, 130.0, 659, 876784, 1112, 24.586157699999603
1113, 3.8724750593813964, 31.088443980104145, 37.38402947535335, 0.09999999999999806, 535.0, 1141, 877925, 1113, 41.471955299999536
1114, 6.8293151758699375, 31.17443703476494, 37.56107587080736, 0.10000000000000064, 110.0, 676, 878601, 1114, 25.080307000000175
1115, 3.3884571386463453, 31.117444410085394, 37.38049648998747, 0.09999999999999941, 240.0, 839, 879440, 1115, 30.93517730000167
1116, 3.4969909320504238, 30.979978747245593, 37.235404755029926, 0.0999999999999987, 235.0, 975, 880415, 1116, 36.72969849999936
1117, 7.96829332717767, 30.891443795909836, 37.24884850251759, 0.09999999999999937, 185.0, 846, 881261, 1117, 30.407188199998927
1118, 6.418529385575729, 30.83765362250409, 37.109027224889104, 0.09999999999999748, 305.0, 1355, 882616, 1118, 50.94605060000322
1119, 6.172485828895821, 30.889738093297034, 37.16763170941948, 0.09999999999999898, 275.0, 916, 883532, 1119, 35.07511229999727
1120, 3.0076490809585135, 30.868255390420597, 37.08381744720202, 0.09999999999999831, 505.0, 1069, 884601, 1120, 40.382530200000474
1121, 6.166861646687733, 30.840362477612185, 37.140950543539866, 0.10000000000000098, 95.0, 616, 885217, 1121, 23.48228019999806
1122, 6.441153468781791, 30.832201415019984, 37.09485599882505, 0.10000000000000081, 205.0, 659, 885876, 1122, 24.595027800001844
1123, 7.176437433469662, 30.849661382578187, 37.11227516400612, 0.09999999999999885, 435.0, 944, 886820, 1123, 34.93334729999697
1124, 3.456389000769613, 30.909846128266434, 37.093902897952226, 0.09999999999999853, 295.0, 1015, 887835, 1124, 34.19718590000048
1125, 5.7856163698957905, 30.782671191710435, 37.019203642724264, 0.09999999999999895, 325.0, 923, 888758, 1125, 31.441733999999997
1126, 7.449567600813779, 30.842645171194366, 37.1572053157922, 0.10000000000000088, 70.0, 495, 889253, 1126, 17.341508299999987
1127, 5.5859782138734255, 30.819757161594783, 37.07188344950151, 0.09999999999999827, 375.0, 1081, 890334, 1127, 39.32522620000236
1128, 7.064329136783878, 30.740253087915022, 37.00686047548129, 0.09999999999999763, 385.0, 1296, 891630, 1128, 48.69931599999836
1129, 5.067735923133138, 30.70227401838874, 36.92831527077108, 0.09999999999999826, 185.0, 1085, 892715, 1129, 40.090130300002784
1130, 6.388126195565213, 30.78190593453341, 37.043095735062, 0.0999999999999983, 210.0, 1075, 893790, 1130, 40.622544200003176
1131, 4.364904046458545, 30.607608269836945, 36.84595658415455, 0.10000000000000035, 155.0, 708, 894498, 1131, 26.571981900000537
1132, 5.6320719845084986, 30.793185488382974, 37.06792727672693, 0.09999999999999756, 265.0, 1320, 895818, 1132, 49.15175629999794
1133, 5.194299751645829, 30.787159043622303, 37.07204180165946, 0.10000000000000075, 155.0, 664, 896482, 1133, 25.185435100000177
1134, 5.317000113350271, 30.80940108730043, 37.057663991815204, 0.09999999999999876, 375.0, 963, 897445, 1134, 36.24891480000224
1135, 6.017501462715374, 30.866824865973598, 37.20475739699144, 0.1000000000000007, 85.0, 377, 897822, 1135, 14.052664800001367
1136, 2.528598960282074, 30.65978377325493, 36.827054648371465, 0.10000000000000057, 115.0, 684, 898506, 1136, 25.606423100001848
1137, 6.844637328796006, 30.769813404379292, 37.03995264395906, 0.09999999999999906, 155.0, 902, 899408, 1137, 34.54990720000205
1138, 7.925263652611719, 30.72509914109755, 37.04702418960068, 0.09999999999999887, 150.0, 939, 900347, 1138, 35.05449270000099
1139, 2.8920374581619552, 30.62128687903519, 36.770139097543286, 0.09999999999999991, 215.0, 764, 901111, 1139, 28.84668529999908
1140, 5.517672105732934, 30.574769383576683, 36.781314895458195, 0.10000000000000034, 130.0, 711, 901822, 1140, 26.88468009999997
1141, 7.393829228973588, 30.547268539938884, 36.79375531970549, 0.10000000000000081, 195.0, 658, 902480, 1141, 24.967351299997972
1142, 6.195411837225601, 30.68039960623636, 36.90584998622908, 0.10000000000000094, 80.0, 562, 903042, 1142, 21.6415851999991
1143, 7.167731795290446, 30.649326444112067, 36.89861783007707, 0.09999999999999958, 170.0, 813, 903855, 1143, 30.432615399997303
1144, 7.563532158686775, 30.55906504328729, 36.736041932157136, 0.10000000000000087, 125.0, 653, 904508, 1144, 25.669070200001443
1145, 4.846761853389227, 30.630038687653865, 36.81092817300386, 0.10000000000000099, 190.0, 622, 905130, 1145, 23.433320600001025
1146, 5.501758187510601, 30.673514767894595, 36.88319809230294, 0.1000000000000009, 95.0, 508, 905638, 1146, 19.393266000002768
1147, 6.137743970142241, 30.542210890793022, 36.722057198124354, 0.09999999999999881, 240.0, 951, 906589, 1147, 32.55770179999672
1148, 5.886563769879255, 30.61553353944597, 36.88692344185013, 0.09999999999999981, 240.0, 778, 907367, 1148, 26.997426500001893
1149, 4.9356016496016135, 30.56450596676078, 36.74294770148493, 0.09999999999999891, 200.0, 930, 908297, 1149, 32.19378760000109
1150, 5.80104332442918, 30.50238194124113, 36.70914866463877, 0.09999999999999819, 465.0, 1103, 909400, 1150, 38.821961499998
1151, 4.118718840584925, 30.639767298513537, 36.81080398353185, 0.09999999999999817, 500.0, 1109, 910509, 1151, 38.01507010000205
1152, 4.520220453301752, 30.624819261613844, 36.83030245191227, 0.0999999999999974, 400.0, 1394, 911903, 1152, 48.33550649999961
1153, 9.897157089412213, 30.803661827191913, 37.119411849975585, 0.10000000000000069, 75.0, 365, 912268, 1153, 12.41118120000101
1154, 5.418296697512349, 30.596816100991916, 36.8252212520299, 0.09999999999999892, 335.0, 927, 913195, 1154, 33.17528040000252
1155, 5.633065207666074, 30.638547913273275, 36.825749240323916, 0.09999999999999788, 415.0, 1197, 914392, 1155, 41.0646224000011
1156, 5.1223024652037825, 30.693420900873175, 36.89996115097977, 0.09999999999999833, 320.0, 1065, 915457, 1156, 36.92342610000196
1157, 4.291207791605721, 30.578980769281802, 36.76458993283858, 0.09999999999999963, 135.0, 805, 916262, 1157, 28.26525969999784
1158, 3.5261543015062453, 30.46660983278638, 36.56992422399067, 0.10000000000000069, 145.0, 672, 916934, 1158, 23.49478259999887
1159, 6.184662193944208, 30.617015809723824, 36.87019414371915, 0.09999999999999971, 395.0, 792, 917726, 1159, 27.618350400000054
1160, 7.024897757171121, 30.554280777577098, 36.73801765179587, 0.09999999999999852, 405.0, 1018, 918744, 1160, 35.392214700001205
1161, 6.464959800751874, 30.478485871493287, 36.68291454428381, 0.10000000000000066, 330.0, 674, 919418, 1161, 23.72892850000062
1162, 6.495503532831105, 30.80741406373472, 37.08173506868674, 0.09999999999999666, 675.0, 1829, 921247, 1162, 69.7789832999988
1163, 5.389653208675651, 30.896739306005117, 37.154105951884304, 0.09999999999999895, 135.0, 922, 922169, 1163, 36.19564200000241
1164, 4.381936384236765, 30.861286014680438, 37.08831636143117, 0.09999999999999865, 270.0, 988, 923157, 1164, 38.50872619999791
1165, 5.978365617414442, 30.929645443876712, 37.18867846418874, 0.10000000000000099, 155.0, 626, 923783, 1165, 24.227455599997484
1166, 5.22530637280656, 30.961737517550457, 37.23383962172797, 0.09999999999999964, 115.0, 803, 924586, 1166, 31.0378383999996
1167, 3.5818239952493833, 30.917913402753655, 37.14526378708398, 0.0999999999999991, 210.0, 894, 925480, 1167, 35.31149070000174
1168, 5.812118382429754, 30.97763440106366, 37.239316841331686, 0.09999999999999894, 305.0, 925, 926405, 1168, 35.67140010000003
1169, 5.380662726500451, 30.89808981622284, 37.12827421312955, 0.09999999999999969, 245.0, 796, 927201, 1169, 30.939982500000042
1170, 7.470236215171517, 30.920171775578456, 37.23596677620541, 0.09999999999999878, 220.0, 956, 928157, 1170, 36.91692129999865
1171, 3.5589890924947603, 30.905313224616688, 37.12977443114953, 0.09999999999999826, 400.0, 1085, 929242, 1171, 42.62115529999937
1172, 4.134637707798753, 30.772919986956417, 36.984482867776144, 0.09999999999999887, 160.0, 939, 930181, 1172, 36.24879839999994
1173, 4.847451991949239, 30.691745634907306, 36.91409375354201, 0.09999999999999762, 365.0, 1301, 931482, 1173, 50.86943940000128
1174, 5.3920687424487, 30.644878700969013, 36.85776467982796, 0.09999999999999742, 350.0, 1381, 932863, 1174, 54.70551290000003
1175, 2.722806380953265, 30.596705441752437, 36.765803438015084, 0.10000000000000071, 60.0, 378, 933241, 1175, 14.628992300000391
1176, 7.445228025552473, 30.597135431963697, 36.87848550036438, 0.10000000000000074, 160.0, 665, 933906, 1176, 26.16849899999943
1177, 5.351512500353015, 30.706438772205605, 36.90736169144034, 0.09999999999999888, 215.0, 938, 934844, 1177, 37.229787600001146
1178, 7.043069548417697, 30.682500668880092, 36.922933310793155, 0.10000000000000099, 140.0, 627, 935471, 1178, 23.53953399999955
1179, 6.174931125934205, 30.66595353471472, 36.90793401239979, 0.09999999999999827, 230.0, 1081, 936552, 1179, 38.11718040000051
1180, 4.725272720588108, 30.667341311349187, 36.89132303087721, 0.09999999999999686, 645.0, 1689, 938241, 1180, 60.90798849999919
1181, 3.467307069662167, 30.701269280725192, 36.9283676863952, 0.09999999999999985, 195.0, 772, 939013, 1181, 27.67448130000048
1182, 9.541181333908764, 30.77771553758014, 37.121876726592426, 0.10000000000000071, 290.0, 669, 939682, 1182, 24.00085560000298
1183, 7.275792660308418, 30.594939735754213, 36.84902068180824, 0.1000000000000007, 160.0, 670, 940352, 1183, 24.11932639999941
1184, 5.317392759456901, 30.42564111313654, 36.566566545669346, 0.09999999999999883, 295.0, 949, 941301, 1184, 33.743191800000204
1185, 4.62909526839802, 30.420848865766782, 36.63196308548386, 0.10000000000000096, 55.0, 592, 941893, 1185, 21.50678269999844
1186, 3.3573614520937305, 30.417625656734124, 36.520518977309194, 0.09999999999999917, 200.0, 881, 942774, 1186, 31.27870989999792
1187, 3.8346445216121627, 30.333635300281, 36.47590204500685, 0.1000000000000009, 115.0, 510, 943284, 1187, 18.70201050000105
1188, 4.682082260458153, 30.41179956783185, 36.54321527807233, 0.10000000000000017, 290.0, 731, 944015, 1188, 29.027947599999607
1189, 4.86711992134383, 30.377135778074155, 36.55112686455509, 0.09999999999999803, 290.0, 1151, 945166, 1189, 45.72869619999983
1190, 4.818535890782208, 30.44456045646367, 36.622118868790274, 0.09999999999999769, 555.0, 1270, 946436, 1190, 49.87699889999931
1191, 6.650012819689197, 30.340976223333495, 36.5094990879458, 0.09999999999999892, 485.0, 927, 947363, 1191, 36.60241289999976
1192, 5.5981272036438865, 30.24355545104114, 36.342419088826944, 0.10000000000000099, 140.0, 634, 947997, 1192, 25.77773779999916
1193, 5.383265075869077, 30.397102902819228, 36.57261399755945, 0.1000000000000003, 155.0, 715, 948712, 1193, 28.6388829000025
1194, 7.8110997433617655, 30.345040743058288, 36.52282729165915, 0.09999999999999941, 320.0, 839, 949551, 1194, 33.21360830000049
1195, 6.080613406125842, 30.33838831671353, 36.49643869071171, 0.10000000000000021, 135.0, 725, 950276, 1195, 29.094038200000796
1196, 7.169493238691773, 30.26263592856271, 36.44991988045829, 0.10000000000000042, 85.0, 700, 950976, 1196, 28.60552699999971
1197, 5.994931425784177, 30.122875821493505, 36.26594530431236, 0.10000000000000098, 170.0, 615, 951591, 1197, 24.253263599999627
1198, 6.6776258171650404, 30.198896589733305, 36.30534807601967, 0.09999999999999967, 180.0, 798, 952389, 1198, 32.47562130000006
1199, 4.745363578677385, 30.17821675656977, 36.28382402360092, 0.0999999999999993, 340.0, 859, 953248, 1199, 34.652991900002235
1200, 6.528743311374005, 30.179527474838554, 36.30277520938984, 0.0999999999999995, 155.0, 824, 954072, 1200, 32.8478643999988
1201, 5.472183273588814, 30.24172753626757, 36.42947785846471, 0.10000000000000098, 90.0, 606, 954678, 1201, 24.503524100000504
1202, 5.512743748466059, 30.119434105867594, 36.21020202140588, 0.10000000000000049, 85.0, 692, 955370, 1202, 27.89783759999773
1203, 4.477799228280117, 30.099371388487953, 36.17726683296852, 0.10000000000000069, 100.0, 671, 956041, 1203, 26.832552099996974
1204, 3.4886789461743644, 30.21129374536092, 36.320135093108654, 0.0999999999999991, 310.0, 894, 956935, 1204, 35.93115640000178
1205, 5.828881124356635, 30.198404484225396, 36.37202609929823, 0.09999999999999834, 240.0, 1064, 957999, 1205, 43.29417409999951
1206, 5.743071888082515, 30.062865680779893, 36.218621936469034, 0.10000000000000099, 125.0, 626, 958625, 1206, 24.359260100001848
1207, 3.894155277399988, 30.201933025771098, 36.286376898133156, 0.10000000000000081, 250.0, 659, 959284, 1207, 24.08548670000164
1208, 8.151094488455813, 30.167079472135278, 36.34931469441895, 0.0999999999999986, 225.0, 997, 960281, 1208, 37.03307029999996
1209, 7.810787531252138, 30.09665274129483, 36.2314491468202, 0.10000000000000087, 50.0, 486, 960767, 1209, 18.038498199999594
1210, 4.5128073085292675, 29.980795293639638, 36.02767953707805, 0.0999999999999982, 275.0, 1099, 961866, 1210, 39.664391300000716
1211, 4.65689003510263, 30.035991542119966, 36.12896426734522, 0.10000000000000077, 260.0, 663, 962529, 1211, 23.4490509999996
1212, 4.778506457970248, 29.991795220132293, 36.04316764193928, 0.09999999999999842, 345.0, 1041, 963570, 1212, 39.50887739999962
1213, 10.596407811746609, 30.104556677292805, 36.331610874253876, 0.10000000000000073, 70.0, 392, 963962, 1213, 16.24432049999814
1214, 4.7428431221011, 29.95609954102286, 35.99820918050305, 0.09999999999999892, 485.0, 928, 964890, 1214, 37.877956399999675
1215, 4.029825657856937, 30.049784292088876, 36.12610707046962, 0.10000000000000088, 20.0, 505, 965395, 1215, 20.593190399999003
1216, 3.8241859148580652, 29.96659837639986, 36.0222087113414, 0.09999999999999781, 440.0, 1221, 966616, 1216, 48.44284740000148
1217, 5.734166522676735, 30.131252961479593, 36.244801202672264, 0.09999999999999928, 205.0, 862, 967478, 1217, 35.63406749999922
1218, 3.844318081813505, 30.028318024928275, 36.088045444363864, 0.10000000000000098, 120.0, 612, 968090, 1218, 24.54786559999775
1219, 5.267721271996989, 29.92443699275746, 36.06522300103131, 0.1000000000000006, 225.0, 680, 968770, 1219, 27.61393179999868
1220, 2.7770354160739488, 30.06975097422578, 36.104938620995235, 0.10000000000000087, 75.0, 653, 969423, 1220, 26.845948899997893
1221, 4.818551185498795, 30.000730819086876, 36.081194394634615, 0.10000000000000099, 135.0, 620, 970043, 1221, 25.51944889999868
1222, 5.306134920865895, 29.884617503515944, 35.95491831670543, 0.0999999999999986, 200.0, 998, 971041, 1222, 41.25532490000114
1223, 5.254594082819112, 29.81908031975552, 35.90716130186469, 0.09999999999999895, 220.0, 924, 971965, 1223, 38.57097140000042
1224, 9.073377169920253, 29.886593043339715, 36.01016777335823, 0.10000000000000071, 40.0, 385, 972350, 1224, 15.455561599999783
1225, 7.976296851984092, 29.916651166643415, 36.0125192326137, 0.0999999999999992, 160.0, 875, 973225, 1225, 36.17607049999788
1226, 4.352668208436888, 29.824818593181977, 35.84554043044783, 0.09999999999999798, 395.0, 1168, 974393, 1226, 48.01939180000045
1227, 4.374765822476266, 29.854335016349022, 35.909288333733485, 0.09999999999999958, 215.0, 814, 975207, 1227, 33.75477259999752
1228, 4.787371660415837, 29.845792219128914, 35.900162211732365, 0.10000000000000049, 115.0, 692, 975899, 1228, 28.667238500001986
1229, 4.437799425314593, 29.84625640010202, 35.8903405170567, 0.09999999999999716, 495.0, 1510, 977409, 1229, 62.682536600001185
1230, 4.287456593631651, 29.79579175042089, 35.87903513363942, 0.09999999999999969, 240.0, 797, 978206, 1230, 32.560037100000045
1231, 6.436244631227784, 29.856775524517218, 35.91656693711448, 0.10000000000000099, 160.0, 626, 978832, 1231, 23.48405719999937
1232, 5.5642015744537, 29.855048851280362, 35.93139130410517, 0.1000000000000009, 100.0, 514, 979346, 1232, 18.533339699999487
1233, 4.927197988830452, 29.720879552416815, 35.73275793910318, 0.09999999999999955, 300.0, 818, 980164, 1233, 31.04885749999812
1234, 6.43776962114498, 29.933548399380275, 36.02830487773532, 0.10000000000000069, 180.0, 672, 980836, 1234, 24.283197600001586
1235, 5.448965985050871, 29.79963143141145, 35.809052577688675, 0.10000000000000021, 150.0, 726, 981562, 1235, 26.89550849999796
1236, 5.63605733755898, 29.839859078618773, 35.89337812008718, 0.09999999999999878, 195.0, 956, 982518, 1236, 36.14992160000111
1237, 6.107019018001084, 29.757397488849918, 35.7967403491615, 0.09999999999999928, 255.0, 861, 983379, 1237, 32.066389999999956
1238, 2.6422854820770376, 29.818875736909753, 35.831157547445855, 0.09999999999999935, 445.0, 850, 984229, 1238, 31.43327549999958
1239, 4.675230138090967, 29.83529828166404, 35.86773312998097, 0.10000000000000063, 30.0, 342, 984571, 1239, 13.31916899999851
1240, 9.23192621732867, 29.833171303882157, 35.951452022375065, 0.10000000000000053, 100.0, 688, 985259, 1240, 30.488182299999607
1241, 6.1895784269985485, 29.874697976221693, 35.93120634997332, 0.09999999999999809, 325.0, 1134, 986393, 1241, 46.36147710000296
1242, 4.6199835689899675, 29.836605959311, 35.861793424156204, 0.10000000000000096, 125.0, 589, 986982, 1242, 24.523439900000085
1243, 5.128186283338111, 29.7087872949555, 35.70573276295038, 0.0999999999999976, 770.0, 1307, 988289, 1243, 54.445342600000004
1244, 6.128789989087153, 29.77873427797072, 35.86660004291598, 0.09999999999999784, 460.0, 1212, 989501, 1244, 50.9650572999999
1245, 7.400030391903331, 29.76981424591952, 35.80930265004203, 0.0999999999999991, 190.0, 894, 990395, 1245, 37.297631500001444
1246, 4.393343413288177, 29.398035145210578, 35.332808231531814, 0.09999999999999735, 740.0, 1414, 991809, 1246, 58.252835200000845
1247, 5.538591344805573, 29.482671651502525, 35.485036631061334, 0.09999999999999953, 225.0, 819, 992628, 1247, 34.66932050000105
1248, 5.665749981604819, 29.476955422731205, 35.43475430925316, 0.10000000000000098, 70.0, 642, 993270, 1248, 26.98941339999874
1249, 3.4009494357788657, 29.44101787324454, 35.397894345505335, 0.09999999999999856, 410.0, 1006, 994276, 1249, 41.75444869999774
1250, 2.6497998113781764, 29.433017685668496, 35.34474948305925, 0.09999999999999748, 320.0, 1355, 995631, 1250, 56.94128890000138
1251, 4.787254975990181, 29.60656003976293, 35.62393960637294, 0.10000000000000073, 105.0, 393, 996024, 1251, 16.3153530999989
1252, 4.969249643582125, 29.55567197831157, 35.500399872808174, 0.10000000000000098, 100.0, 606, 996630, 1252, 25.618845100001636
1253, 8.572004572737137, 29.580415131741724, 35.61072890006456, 0.10000000000000006, 210.0, 745, 997375, 1253, 31.915842800000974
1254, 4.363537141459717, 29.546904526092934, 35.51209261273848, 0.1000000000000006, 135.0, 681, 998056, 1254, 28.132983900002728
1255, 4.57112794094739, 29.52914460454473, 35.53946873242065, 0.10000000000000045, 140.0, 697, 998753, 1255, 29.04995450000206
1256, 4.799529430099896, 29.43703610447475, 35.40151633998326, 0.0999999999999992, 155.0, 875, 999628, 1256, 36.938612199999625
